GEOID10,FID,BDNAME,BDNUM,TEXT_NBR,GEO_ID,NAME_x,P003001,P003002,P003003,P003004,P003005,P003006,P003007,P003008,P005001,P005002,P005003,P005004,P005005,P005006,P005007,P005008,P005009,P005010,P005011,P005012,P005013,P005014,P005015,P005016,P005017
270531260003016,1,Phillips West,90,90,1000000US270531260003016,"Block 3016, Block Group 3, Census Tract 1260, Hennepin County, Minnesota",8,1,6,0,0,0,1,0,8,7,1,6,0,0,0,0,0,1,0,0,0,0,0,1,0
270531260003001,1,Phillips West,90,90,1000000US270531260003001,"Block 3001, Block Group 3, Census Tract 1260, Hennepin County, Minnesota",0,0,0,0,0,0,0,0,0,0,0,0,0,0,0,0,0,0,0,0,0,0,0,0,0
270531260002001,1,Phillips West,90,90,1000000US270531260002001,"Block 2001, Block Group 2, Census Tract 1260, Hennepin County, Minnesota",47,6,11,29,0,0,1,0,47,44,6,10,27,0,0,1,0,3,0,1,2,0,0,0,0
270531260001000,1,Phillips West,90,90,1000000US270531260001000,"Block 1000, Block Group 1, Census Tract 1260, Hennepin County, Minnesota",256,116,84,4,17,0,20,15,256,198,84,84,3,17,0,0,10,58,32,0,1,0,0,20,5
270531260002006,1,Phillips West,90,90,1000000US270531260002006,"Block 2006, Block Group 2, Census Tract 1260, Hennepin County, Minnesota",25,16,7,0,2,0,0,0,25,24,15,7,0,2,0,0,0,1,1,0,0,0,0,0,0
270531260003006,1,Phillips West,90,90,1000000US270531260003006,"Block 3006, Block Group 3, Census Tract 1260, Hennepin County, Minnesota",0,0,0,0,0,0,0,0,0,0,0,0,0,0,0,0,0,0,0,0,0,0,0,0,0
270531260003007,1,Phillips West,90,90,1000000US270531260003007,"Block 3007, Block Group 3, Census Tract 1260, Hennepin County, Minnesota",0,0,0,0,0,0,0,0,0,0,0,0,0,0,0,0,0,0,0,0,0,0,0,0,0
270531260004003,1,Phillips West,90,90,1000000US270531260004003,"Block 4003, Block Group 4, Census Tract 1260, Hennepin County, Minnesota",135,20,96,14,0,0,3,2,135,125,19,96,8,0,0,0,2,10,1,0,6,0,0,3,0
270531260004000,1,Phillips West,90,90,1000000US270531260004000,"Block 4000, Block Group 4, Census Tract 1260, Hennepin County, Minnesota",174,73,45,6,13,0,30,7,174,117,47,45,6,13,0,0,6,57,26,0,0,0,0,30,1
270531260003003,1,Phillips West,90,90,1000000US270531260003003,"Block 3003, Block Group 3, Census Tract 1260, Hennepin County, Minnesota",455,62,345,9,8,0,20,11,455,416,56,344,1,8,0,0,7,39,6,1,8,0,0,20,4
270531260002002,1,Phillips West,90,90,1000000US270531260002002,"Block 2002, Block Group 2, Census Tract 1260, Hennepin County, Minnesota",101,25,57,15,2,0,0,2,101,85,13,57,13,2,0,0,0,16,12,0,2,0,0,0,2
270531260003012,1,Phillips West,90,90,1000000US270531260003012,"Block 3012, Block Group 3, Census Tract 1260, Hennepin County, Minnesota",0,0,0,0,0,0,0,0,0,0,0,0,0,0,0,0,0,0,0,0,0,0,0,0,0
270531260003004,1,Phillips West,90,90,1000000US270531260003004,"Block 3004, Block Group 3, Census Tract 1260, Hennepin County, Minnesota",202,63,47,1,5,0,69,17,202,104,31,47,1,5,0,4,16,98,32,0,0,0,0,65,1
270531260002009,1,Phillips West,90,90,1000000US270531260002009,"Block 2009, Block Group 2, Census Tract 1260, Hennepin County, Minnesota",12,12,0,0,0,0,0,0,12,12,12,0,0,0,0,0,0,0,0,0,0,0,0,0,0
270531260002008,1,Phillips West,90,90,1000000US270531260002008,"Block 2008, Block Group 2, Census Tract 1260, Hennepin County, Minnesota",0,0,0,0,0,0,0,0,0,0,0,0,0,0,0,0,0,0,0,0,0,0,0,0,0
270531260003013,1,Phillips West,90,90,1000000US270531260003013,"Block 3013, Block Group 3, Census Tract 1260, Hennepin County, Minnesota",0,0,0,0,0,0,0,0,0,0,0,0,0,0,0,0,0,0,0,0,0,0,0,0,0
270531260001002,1,Phillips West,90,90,1000000US270531260001002,"Block 1002, Block Group 1, Census Tract 1260, Hennepin County, Minnesota",0,0,0,0,0,0,0,0,0,0,0,0,0,0,0,0,0,0,0,0,0,0,0,0,0
270531260004005,1,Phillips West,90,90,1000000US270531260004005,"Block 4005, Block Group 4, Census Tract 1260, Hennepin County, Minnesota",115,29,27,11,0,1,32,15,115,66,15,26,11,0,1,0,13,49,14,1,0,0,0,32,2
270531260004006,1,Phillips West,90,90,1000000US270531260004006,"Block 4006, Block Group 4, Census Tract 1260, Hennepin County, Minnesota",211,46,129,4,4,0,19,9,211,182,42,124,4,4,0,0,8,29,4,5,0,0,0,19,1
270531260001003,1,Phillips West,90,90,1000000US270531260001003,"Block 1003, Block Group 1, Census Tract 1260, Hennepin County, Minnesota",139,26,93,0,6,0,0,14,139,138,25,93,0,6,0,0,14,1,1,0,0,0,0,0,0
270531260003010,1,Phillips West,90,90,1000000US270531260003010,"Block 3010, Block Group 3, Census Tract 1260, Hennepin County, Minnesota",132,9,112,0,0,0,9,2,132,122,8,112,0,0,0,0,2,10,1,0,0,0,0,9,0
270531260002005,1,Phillips West,90,90,1000000US270531260002005,"Block 2005, Block Group 2, Census Tract 1260, Hennepin County, Minnesota",50,31,10,0,0,0,5,4,50,44,30,10,0,0,0,0,4,6,1,0,0,0,0,5,0
270531260002011,1,Phillips West,90,90,1000000US270531260002011,"Block 2011, Block Group 2, Census Tract 1260, Hennepin County, Minnesota",315,203,96,8,2,0,3,3,315,306,199,95,8,1,0,0,3,9,4,1,0,1,0,3,0
270531260003005,1,Phillips West,90,90,1000000US270531260003005,"Block 3005, Block Group 3, Census Tract 1260, Hennepin County, Minnesota",99,33,32,0,14,0,16,4,99,83,33,32,0,14,0,0,4,16,0,0,0,0,0,16,0
270531260004004,1,Phillips West,90,90,1000000US270531260004004,"Block 4004, Block Group 4, Census Tract 1260, Hennepin County, Minnesota",88,34,11,0,0,0,39,4,88,17,6,11,0,0,0,0,0,71,28,0,0,0,0,39,4
270531260003018,1,Phillips West,90,90,1000000US270531260003018,"Block 3018, Block Group 3, Census Tract 1260, Hennepin County, Minnesota",0,0,0,0,0,0,0,0,0,0,0,0,0,0,0,0,0,0,0,0,0,0,0,0,0
270531260002000,1,Phillips West,90,90,1000000US270531260002000,"Block 2000, Block Group 2, Census Tract 1260, Hennepin County, Minnesota",52,43,7,0,0,1,0,1,52,50,42,6,0,0,1,0,1,2,1,1,0,0,0,0,0
270531260002010,1,Phillips West,90,90,1000000US270531260002010,"Block 2010, Block Group 2, Census Tract 1260, Hennepin County, Minnesota",0,0,0,0,0,0,0,0,0,0,0,0,0,0,0,0,0,0,0,0,0,0,0,0,0
270531260003024,1,Phillips West,90,90,1000000US270531260003024,"Block 3024, Block Group 3, Census Tract 1260, Hennepin County, Minnesota",123,30,31,9,0,0,47,6,123,59,18,31,1,0,0,6,3,64,12,0,8,0,0,41,3
270531260004011,1,Phillips West,90,90,1000000US270531260004011,"Block 4011, Block Group 4, Census Tract 1260, Hennepin County, Minnesota",24,6,0,0,1,0,17,0,24,7,6,0,0,1,0,0,0,17,0,0,0,0,0,17,0
270531260003020,1,Phillips West,90,90,1000000US270531260003020,"Block 3020, Block Group 3, Census Tract 1260, Hennepin County, Minnesota",0,0,0,0,0,0,0,0,0,0,0,0,0,0,0,0,0,0,0,0,0,0,0,0,0
270531260003015,1,Phillips West,90,90,1000000US270531260003015,"Block 3015, Block Group 3, Census Tract 1260, Hennepin County, Minnesota",0,0,0,0,0,0,0,0,0,0,0,0,0,0,0,0,0,0,0,0,0,0,0,0,0
270531260003023,1,Phillips West,90,90,1000000US270531260003023,"Block 3023, Block Group 3, Census Tract 1260, Hennepin County, Minnesota",0,0,0,0,0,0,0,0,0,0,0,0,0,0,0,0,0,0,0,0,0,0,0,0,0
270531260003022,1,Phillips West,90,90,1000000US270531260003022,"Block 3022, Block Group 3, Census Tract 1260, Hennepin County, Minnesota",0,0,0,0,0,0,0,0,0,0,0,0,0,0,0,0,0,0,0,0,0,0,0,0,0
270531260003009,1,Phillips West,90,90,1000000US270531260003009,"Block 3009, Block Group 3, Census Tract 1260, Hennepin County, Minnesota",60,13,21,0,0,0,25,1,60,29,6,21,0,0,0,1,1,31,7,0,0,0,0,24,0
270531260004009,1,Phillips West,90,90,1000000US270531260004009,"Block 4009, Block Group 4, Census Tract 1260, Hennepin County, Minnesota",103,29,19,0,21,0,23,11,103,59,11,19,0,21,0,0,8,44,18,0,0,0,0,23,3
270531260003002,1,Phillips West,90,90,1000000US270531260003002,"Block 3002, Block Group 3, Census Tract 1260, Hennepin County, Minnesota",14,8,0,0,1,0,5,0,14,8,7,0,0,1,0,0,0,6,1,0,0,0,0,5,0
270531260003000,1,Phillips West,90,90,1000000US270531260003000,"Block 3000, Block Group 3, Census Tract 1260, Hennepin County, Minnesota",297,51,90,15,6,0,109,26,297,135,33,84,3,6,0,0,9,162,18,6,12,0,0,109,17
270531260003017,1,Phillips West,90,90,1000000US270531260003017,"Block 3017, Block Group 3, Census Tract 1260, Hennepin County, Minnesota",94,58,4,1,1,0,20,10,94,57,48,3,0,1,0,1,4,37,10,1,1,0,0,19,6
270531260003008,1,Phillips West,90,90,1000000US270531260003008,"Block 3008, Block Group 3, Census Tract 1260, Hennepin County, Minnesota",109,11,74,0,0,0,6,18,109,99,10,74,0,0,0,0,15,10,1,0,0,0,0,6,3
270531260003011,1,Phillips West,90,90,1000000US270531260003011,"Block 3011, Block Group 3, Census Tract 1260, Hennepin County, Minnesota",0,0,0,0,0,0,0,0,0,0,0,0,0,0,0,0,0,0,0,0,0,0,0,0,0
270531260002004,1,Phillips West,90,90,1000000US270531260002004,"Block 2004, Block Group 2, Census Tract 1260, Hennepin County, Minnesota",183,3,153,12,5,0,0,10,183,179,3,150,12,5,0,0,9,4,0,3,0,0,0,0,1
270531260004002,1,Phillips West,90,90,1000000US270531260004002,"Block 4002, Block Group 4, Census Tract 1260, Hennepin County, Minnesota",214,144,56,3,2,0,3,6,214,199,133,55,2,2,0,1,6,15,11,1,1,0,0,2,0
270531260003019,1,Phillips West,90,90,1000000US270531260003019,"Block 3019, Block Group 3, Census Tract 1260, Hennepin County, Minnesota",0,0,0,0,0,0,0,0,0,0,0,0,0,0,0,0,0,0,0,0,0,0,0,0,0
270531260004008,1,Phillips West,90,90,1000000US270531260004008,"Block 4008, Block Group 4, Census Tract 1260, Hennepin County, Minnesota",77,21,5,0,2,0,49,0,77,24,17,5,0,2,0,0,0,53,4,0,0,0,0,49,0
270531260002007,1,Phillips West,90,90,1000000US270531260002007,"Block 2007, Block Group 2, Census Tract 1260, Hennepin County, Minnesota",25,2,4,5,0,0,9,5,25,12,2,4,4,0,0,0,2,13,0,0,1,0,0,9,3
270531260003014,1,Phillips West,90,90,1000000US270531260003014,"Block 3014, Block Group 3, Census Tract 1260, Hennepin County, Minnesota",0,0,0,0,0,0,0,0,0,0,0,0,0,0,0,0,0,0,0,0,0,0,0,0,0
270531260002003,1,Phillips West,90,90,1000000US270531260002003,"Block 2003, Block Group 2, Census Tract 1260, Hennepin County, Minnesota",169,9,136,10,0,0,7,7,169,153,4,134,8,0,0,1,6,16,5,2,2,0,0,6,1
270531260001001,1,Phillips West,90,90,1000000US270531260001001,"Block 1001, Block Group 1, Census Tract 1260, Hennepin County, Minnesota",182,148,23,1,5,0,1,4,182,181,148,23,1,5,0,0,4,1,0,0,0,0,0,1,0
270531260004001,1,Phillips West,90,90,1000000US270531260004001,"Block 4001, Block Group 4, Census Tract 1260, Hennepin County, Minnesota",95,43,25,0,9,0,11,7,95,76,38,24,0,9,0,0,5,19,5,1,0,0,0,11,2
270531260003021,1,Phillips West,90,90,1000000US270531260003021,"Block 3021, Block Group 3, Census Tract 1260, Hennepin County, Minnesota",112,19,23,0,0,0,70,0,112,23,0,23,0,0,0,0,0,89,19,0,0,0,0,70,0
270531260004007,1,Phillips West,90,90,1000000US270531260004007,"Block 4007, Block Group 4, Census Tract 1260, Hennepin County, Minnesota",0,0,0,0,0,0,0,0,0,0,0,0,0,0,0,0,0,0,0,0,0,0,0,0,0
270531260004010,1,Phillips West,90,90,1000000US270531260004010,"Block 4010, Block Group 4, Census Tract 1260, Hennepin County, Minnesota",230,32,170,0,0,0,14,14,230,204,27,170,0,0,0,0,7,26,5,0,0,0,0,14,7
270531044001005,2,Downtown West,87,87,1000000US270531044001005,"Block 1005, Block Group 1, Census Tract 1044, Hennepin County, Minnesota",131,39,83,1,0,0,0,8,131,130,39,83,1,0,0,0,7,1,0,0,0,0,0,0,1
270531261003005,2,Downtown West,87,87,1000000US270531261003005,"Block 3005, Block Group 3, Census Tract 1261, Hennepin County, Minnesota",0,0,0,0,0,0,0,0,0,0,0,0,0,0,0,0,0,0,0,0,0,0,0,0,0
270531261003007,2,Downtown West,87,87,1000000US270531261003007,"Block 3007, Block Group 3, Census Tract 1261, Hennepin County, Minnesota",4,4,0,0,0,0,0,0,4,4,4,0,0,0,0,0,0,0,0,0,0,0,0,0,0
270531261003044,2,Downtown West,87,87,1000000US270531261003044,"Block 3044, Block Group 3, Census Tract 1261, Hennepin County, Minnesota",0,0,0,0,0,0,0,0,0,0,0,0,0,0,0,0,0,0,0,0,0,0,0,0,0
270531261003009,2,Downtown West,87,87,1000000US270531261003009,"Block 3009, Block Group 3, Census Tract 1261, Hennepin County, Minnesota",0,0,0,0,0,0,0,0,0,0,0,0,0,0,0,0,0,0,0,0,0,0,0,0,0
270531261003020,2,Downtown West,87,87,1000000US270531261003020,"Block 3020, Block Group 3, Census Tract 1261, Hennepin County, Minnesota",0,0,0,0,0,0,0,0,0,0,0,0,0,0,0,0,0,0,0,0,0,0,0,0,0
270531261002004,2,Downtown West,87,87,1000000US270531261002004,"Block 2004, Block Group 2, Census Tract 1261, Hennepin County, Minnesota",0,0,0,0,0,0,0,0,0,0,0,0,0,0,0,0,0,0,0,0,0,0,0,0,0
270531261002006,2,Downtown West,87,87,1000000US270531261002006,"Block 2006, Block Group 2, Census Tract 1261, Hennepin County, Minnesota",0,0,0,0,0,0,0,0,0,0,0,0,0,0,0,0,0,0,0,0,0,0,0,0,0
270531261002010,2,Downtown West,87,87,1000000US270531261002010,"Block 2010, Block Group 2, Census Tract 1261, Hennepin County, Minnesota",33,32,0,1,0,0,0,0,33,32,31,0,1,0,0,0,0,1,1,0,0,0,0,0,0
270531261002005,2,Downtown West,87,87,1000000US270531261002005,"Block 2005, Block Group 2, Census Tract 1261, Hennepin County, Minnesota",0,0,0,0,0,0,0,0,0,0,0,0,0,0,0,0,0,0,0,0,0,0,0,0,0
270531044002034,2,Downtown West,87,87,1000000US270531044002034,"Block 2034, Block Group 2, Census Tract 1044, Hennepin County, Minnesota",0,0,0,0,0,0,0,0,0,0,0,0,0,0,0,0,0,0,0,0,0,0,0,0,0
270531044002024,2,Downtown West,87,87,1000000US270531044002024,"Block 2024, Block Group 2, Census Tract 1044, Hennepin County, Minnesota",84,36,36,7,2,0,2,1,84,81,35,36,7,2,0,0,1,3,1,0,0,0,0,2,0
270531044002022,2,Downtown West,87,87,1000000US270531044002022,"Block 2022, Block Group 2, Census Tract 1044, Hennepin County, Minnesota",9,9,0,0,0,0,0,0,9,9,9,0,0,0,0,0,0,0,0,0,0,0,0,0,0
270531044002032,2,Downtown West,87,87,1000000US270531044002032,"Block 2032, Block Group 2, Census Tract 1044, Hennepin County, Minnesota",46,41,1,0,2,2,0,0,46,46,41,1,0,2,2,0,0,0,0,0,0,0,0,0,0
270531261003038,2,Downtown West,87,87,1000000US270531261003038,"Block 3038, Block Group 3, Census Tract 1261, Hennepin County, Minnesota",362,140,183,23,14,0,0,2,362,334,113,183,23,14,0,0,1,28,27,0,0,0,0,0,1
270531044001011,2,Downtown West,87,87,1000000US270531044001011,"Block 1011, Block Group 1, Census Tract 1044, Hennepin County, Minnesota",390,133,192,11,9,2,17,26,390,349,125,186,11,9,2,1,15,41,8,6,0,0,0,16,11
270531044001001,2,Downtown West,87,87,1000000US270531044001001,"Block 1001, Block Group 1, Census Tract 1044, Hennepin County, Minnesota",0,0,0,0,0,0,0,0,0,0,0,0,0,0,0,0,0,0,0,0,0,0,0,0,0
270531261003011,2,Downtown West,87,87,1000000US270531261003011,"Block 3011, Block Group 3, Census Tract 1261, Hennepin County, Minnesota",0,0,0,0,0,0,0,0,0,0,0,0,0,0,0,0,0,0,0,0,0,0,0,0,0
270531261003003,2,Downtown West,87,87,1000000US270531261003003,"Block 3003, Block Group 3, Census Tract 1261, Hennepin County, Minnesota",0,0,0,0,0,0,0,0,0,0,0,0,0,0,0,0,0,0,0,0,0,0,0,0,0
270531044001004,2,Downtown West,87,87,1000000US270531044001004,"Block 1004, Block Group 1, Census Tract 1044, Hennepin County, Minnesota",94,35,51,4,2,0,0,2,94,90,31,51,4,2,0,0,2,4,4,0,0,0,0,0,0
270531044001006,2,Downtown West,87,87,1000000US270531044001006,"Block 1006, Block Group 1, Census Tract 1044, Hennepin County, Minnesota",0,0,0,0,0,0,0,0,0,0,0,0,0,0,0,0,0,0,0,0,0,0,0,0,0
270531261003012,2,Downtown West,87,87,1000000US270531261003012,"Block 3012, Block Group 3, Census Tract 1261, Hennepin County, Minnesota",0,0,0,0,0,0,0,0,0,0,0,0,0,0,0,0,0,0,0,0,0,0,0,0,0
270531261003016,2,Downtown West,87,87,1000000US270531261003016,"Block 3016, Block Group 3, Census Tract 1261, Hennepin County, Minnesota",23,14,1,0,4,0,0,4,23,22,14,0,0,4,0,0,4,1,0,1,0,0,0,0,0
270531261002001,2,Downtown West,87,87,1000000US270531261002001,"Block 2001, Block Group 2, Census Tract 1261, Hennepin County, Minnesota",0,0,0,0,0,0,0,0,0,0,0,0,0,0,0,0,0,0,0,0,0,0,0,0,0
270531261002007,2,Downtown West,87,87,1000000US270531261002007,"Block 2007, Block Group 2, Census Tract 1261, Hennepin County, Minnesota",1,1,0,0,0,0,0,0,1,1,1,0,0,0,0,0,0,0,0,0,0,0,0,0,0
270531261003014,2,Downtown West,87,87,1000000US270531261003014,"Block 3014, Block Group 3, Census Tract 1261, Hennepin County, Minnesota",0,0,0,0,0,0,0,0,0,0,0,0,0,0,0,0,0,0,0,0,0,0,0,0,0
270531261003006,2,Downtown West,87,87,1000000US270531261003006,"Block 3006, Block Group 3, Census Tract 1261, Hennepin County, Minnesota",0,0,0,0,0,0,0,0,0,0,0,0,0,0,0,0,0,0,0,0,0,0,0,0,0
270531261003001,2,Downtown West,87,87,1000000US270531261003001,"Block 3001, Block Group 3, Census Tract 1261, Hennepin County, Minnesota",29,25,1,0,2,0,1,0,29,28,25,1,0,2,0,0,0,1,0,0,0,0,0,1,0
270531261003015,2,Downtown West,87,87,1000000US270531261003015,"Block 3015, Block Group 3, Census Tract 1261, Hennepin County, Minnesota",0,0,0,0,0,0,0,0,0,0,0,0,0,0,0,0,0,0,0,0,0,0,0,0,0
270531261002002,2,Downtown West,87,87,1000000US270531261002002,"Block 2002, Block Group 2, Census Tract 1261, Hennepin County, Minnesota",0,0,0,0,0,0,0,0,0,0,0,0,0,0,0,0,0,0,0,0,0,0,0,0,0
270531261003029,2,Downtown West,87,87,1000000US270531261003029,"Block 3029, Block Group 3, Census Tract 1261, Hennepin County, Minnesota",0,0,0,0,0,0,0,0,0,0,0,0,0,0,0,0,0,0,0,0,0,0,0,0,0
270531261003019,2,Downtown West,87,87,1000000US270531261003019,"Block 3019, Block Group 3, Census Tract 1261, Hennepin County, Minnesota",0,0,0,0,0,0,0,0,0,0,0,0,0,0,0,0,0,0,0,0,0,0,0,0,0
270531261003031,2,Downtown West,87,87,1000000US270531261003031,"Block 3031, Block Group 3, Census Tract 1261, Hennepin County, Minnesota",0,0,0,0,0,0,0,0,0,0,0,0,0,0,0,0,0,0,0,0,0,0,0,0,0
270531261003035,2,Downtown West,87,87,1000000US270531261003035,"Block 3035, Block Group 3, Census Tract 1261, Hennepin County, Minnesota",0,0,0,0,0,0,0,0,0,0,0,0,0,0,0,0,0,0,0,0,0,0,0,0,0
270531261002008,2,Downtown West,87,87,1000000US270531261002008,"Block 2008, Block Group 2, Census Tract 1261, Hennepin County, Minnesota",499,445,15,3,31,0,1,4,499,490,437,15,2,31,0,1,4,9,8,0,1,0,0,0,0
270531044001010,2,Downtown West,87,87,1000000US270531044001010,"Block 1010, Block Group 1, Census Tract 1044, Hennepin County, Minnesota",0,0,0,0,0,0,0,0,0,0,0,0,0,0,0,0,0,0,0,0,0,0,0,0,0
270531044001009,2,Downtown West,87,87,1000000US270531044001009,"Block 1009, Block Group 1, Census Tract 1044, Hennepin County, Minnesota",0,0,0,0,0,0,0,0,0,0,0,0,0,0,0,0,0,0,0,0,0,0,0,0,0
270531044002013,2,Downtown West,87,87,1000000US270531044002013,"Block 2013, Block Group 2, Census Tract 1044, Hennepin County, Minnesota",0,0,0,0,0,0,0,0,0,0,0,0,0,0,0,0,0,0,0,0,0,0,0,0,0
270531261004002,2,Downtown West,87,87,1000000US270531261004002,"Block 4002, Block Group 4, Census Tract 1261, Hennepin County, Minnesota",0,0,0,0,0,0,0,0,0,0,0,0,0,0,0,0,0,0,0,0,0,0,0,0,0
270531261002000,2,Downtown West,87,87,1000000US270531261002000,"Block 2000, Block Group 2, Census Tract 1261, Hennepin County, Minnesota",0,0,0,0,0,0,0,0,0,0,0,0,0,0,0,0,0,0,0,0,0,0,0,0,0
270531261003023,2,Downtown West,87,87,1000000US270531261003023,"Block 3023, Block Group 3, Census Tract 1261, Hennepin County, Minnesota",0,0,0,0,0,0,0,0,0,0,0,0,0,0,0,0,0,0,0,0,0,0,0,0,0
270531044001016,2,Downtown West,87,87,1000000US270531044001016,"Block 1016, Block Group 1, Census Tract 1044, Hennepin County, Minnesota",249,195,5,0,39,0,4,6,249,239,187,5,0,39,0,3,5,10,8,0,0,0,0,1,1
270531044002015,2,Downtown West,87,87,1000000US270531044002015,"Block 2015, Block Group 2, Census Tract 1044, Hennepin County, Minnesota",0,0,0,0,0,0,0,0,0,0,0,0,0,0,0,0,0,0,0,0,0,0,0,0,0
270531261003017,2,Downtown West,87,87,1000000US270531261003017,"Block 3017, Block Group 3, Census Tract 1261, Hennepin County, Minnesota",339,101,195,6,18,0,0,19,339,332,99,193,6,18,0,0,16,7,2,2,0,0,0,0,3
270531261003032,2,Downtown West,87,87,1000000US270531261003032,"Block 3032, Block Group 3, Census Tract 1261, Hennepin County, Minnesota",0,0,0,0,0,0,0,0,0,0,0,0,0,0,0,0,0,0,0,0,0,0,0,0,0
270531261003042,2,Downtown West,87,87,1000000US270531261003042,"Block 3042, Block Group 3, Census Tract 1261, Hennepin County, Minnesota",0,0,0,0,0,0,0,0,0,0,0,0,0,0,0,0,0,0,0,0,0,0,0,0,0
270531261004000,2,Downtown West,87,87,1000000US270531261004000,"Block 4000, Block Group 4, Census Tract 1261, Hennepin County, Minnesota",494,290,23,5,154,0,6,16,494,479,283,23,5,154,0,3,11,15,7,0,0,0,0,3,5
270531261003024,2,Downtown West,87,87,1000000US270531261003024,"Block 3024, Block Group 3, Census Tract 1261, Hennepin County, Minnesota",0,0,0,0,0,0,0,0,0,0,0,0,0,0,0,0,0,0,0,0,0,0,0,0,0
270531044001014,2,Downtown West,87,87,1000000US270531044001014,"Block 1014, Block Group 1, Census Tract 1044, Hennepin County, Minnesota",0,0,0,0,0,0,0,0,0,0,0,0,0,0,0,0,0,0,0,0,0,0,0,0,0
270531044001008,2,Downtown West,87,87,1000000US270531044001008,"Block 1008, Block Group 1, Census Tract 1044, Hennepin County, Minnesota",0,0,0,0,0,0,0,0,0,0,0,0,0,0,0,0,0,0,0,0,0,0,0,0,0
270531044002012,2,Downtown West,87,87,1000000US270531044002012,"Block 2012, Block Group 2, Census Tract 1044, Hennepin County, Minnesota",0,0,0,0,0,0,0,0,0,0,0,0,0,0,0,0,0,0,0,0,0,0,0,0,0
270531044002006,2,Downtown West,87,87,1000000US270531044002006,"Block 2006, Block Group 2, Census Tract 1044, Hennepin County, Minnesota",113,65,8,0,37,0,0,3,113,111,63,8,0,37,0,0,3,2,2,0,0,0,0,0,0
270531044002010,2,Downtown West,87,87,1000000US270531044002010,"Block 2010, Block Group 2, Census Tract 1044, Hennepin County, Minnesota",0,0,0,0,0,0,0,0,0,0,0,0,0,0,0,0,0,0,0,0,0,0,0,0,0
270531261003022,2,Downtown West,87,87,1000000US270531261003022,"Block 3022, Block Group 3, Census Tract 1261, Hennepin County, Minnesota",0,0,0,0,0,0,0,0,0,0,0,0,0,0,0,0,0,0,0,0,0,0,0,0,0
270531261003028,2,Downtown West,87,87,1000000US270531261003028,"Block 3028, Block Group 3, Census Tract 1261, Hennepin County, Minnesota",0,0,0,0,0,0,0,0,0,0,0,0,0,0,0,0,0,0,0,0,0,0,0,0,0
270531044001015,2,Downtown West,87,87,1000000US270531044001015,"Block 1015, Block Group 1, Census Tract 1044, Hennepin County, Minnesota",0,0,0,0,0,0,0,0,0,0,0,0,0,0,0,0,0,0,0,0,0,0,0,0,0
270531044002005,2,Downtown West,87,87,1000000US270531044002005,"Block 2005, Block Group 2, Census Tract 1044, Hennepin County, Minnesota",0,0,0,0,0,0,0,0,0,0,0,0,0,0,0,0,0,0,0,0,0,0,0,0,0
270531261003050,2,Downtown West,87,87,1000000US270531261003050,"Block 3050, Block Group 3, Census Tract 1261, Hennepin County, Minnesota",0,0,0,0,0,0,0,0,0,0,0,0,0,0,0,0,0,0,0,0,0,0,0,0,0
270531044002018,2,Downtown West,87,87,1000000US270531044002018,"Block 2018, Block Group 2, Census Tract 1044, Hennepin County, Minnesota",101,41,49,4,4,0,0,3,101,101,41,49,4,4,0,0,3,0,0,0,0,0,0,0,0
270531044002027,2,Downtown West,87,87,1000000US270531044002027,"Block 2027, Block Group 2, Census Tract 1044, Hennepin County, Minnesota",1,0,0,0,0,0,1,0,1,0,0,0,0,0,0,0,0,1,0,0,0,0,0,1,0
270531044002016,2,Downtown West,87,87,1000000US270531044002016,"Block 2016, Block Group 2, Census Tract 1044, Hennepin County, Minnesota",0,0,0,0,0,0,0,0,0,0,0,0,0,0,0,0,0,0,0,0,0,0,0,0,0
270531261003051,2,Downtown West,87,87,1000000US270531261003051,"Block 3051, Block Group 3, Census Tract 1261, Hennepin County, Minnesota",19,18,0,0,1,0,0,0,19,19,18,0,0,1,0,0,0,0,0,0,0,0,0,0,0
270531044002019,2,Downtown West,87,87,1000000US270531044002019,"Block 2019, Block Group 2, Census Tract 1044, Hennepin County, Minnesota",27,18,6,0,0,0,1,2,27,25,18,6,0,0,0,0,1,2,0,0,0,0,0,1,1
270531261003040,2,Downtown West,87,87,1000000US270531261003040,"Block 3040, Block Group 3, Census Tract 1261, Hennepin County, Minnesota",0,0,0,0,0,0,0,0,0,0,0,0,0,0,0,0,0,0,0,0,0,0,0,0,0
270531044002026,2,Downtown West,87,87,1000000US270531044002026,"Block 2026, Block Group 2, Census Tract 1044, Hennepin County, Minnesota",53,33,17,3,0,0,0,0,53,48,30,17,1,0,0,0,0,5,3,0,2,0,0,0,0
270531044002033,2,Downtown West,87,87,1000000US270531044002033,"Block 2033, Block Group 2, Census Tract 1044, Hennepin County, Minnesota",340,209,14,0,107,0,2,8,340,334,205,14,0,107,0,0,8,6,4,0,0,0,0,2,0
270531044002020,2,Downtown West,87,87,1000000US270531044002020,"Block 2020, Block Group 2, Census Tract 1044, Hennepin County, Minnesota",0,0,0,0,0,0,0,0,0,0,0,0,0,0,0,0,0,0,0,0,0,0,0,0,0
270531044002009,2,Downtown West,87,87,1000000US270531044002009,"Block 2009, Block Group 2, Census Tract 1044, Hennepin County, Minnesota",0,0,0,0,0,0,0,0,0,0,0,0,0,0,0,0,0,0,0,0,0,0,0,0,0
270531044002023,2,Downtown West,87,87,1000000US270531044002023,"Block 2023, Block Group 2, Census Tract 1044, Hennepin County, Minnesota",0,0,0,0,0,0,0,0,0,0,0,0,0,0,0,0,0,0,0,0,0,0,0,0,0
270531261003043,2,Downtown West,87,87,1000000US270531261003043,"Block 3043, Block Group 3, Census Tract 1261, Hennepin County, Minnesota",0,0,0,0,0,0,0,0,0,0,0,0,0,0,0,0,0,0,0,0,0,0,0,0,0
270531044002008,2,Downtown West,87,87,1000000US270531044002008,"Block 2008, Block Group 2, Census Tract 1044, Hennepin County, Minnesota",108,71,7,0,24,0,0,6,108,103,66,7,0,24,0,0,6,5,5,0,0,0,0,0,0
270531044002031,2,Downtown West,87,87,1000000US270531044002031,"Block 2031, Block Group 2, Census Tract 1044, Hennepin County, Minnesota",0,0,0,0,0,0,0,0,0,0,0,0,0,0,0,0,0,0,0,0,0,0,0,0,0
270531044002017,2,Downtown West,87,87,1000000US270531044002017,"Block 2017, Block Group 2, Census Tract 1044, Hennepin County, Minnesota",0,0,0,0,0,0,0,0,0,0,0,0,0,0,0,0,0,0,0,0,0,0,0,0,0
270531261003049,2,Downtown West,87,87,1000000US270531261003049,"Block 3049, Block Group 3, Census Tract 1261, Hennepin County, Minnesota",0,0,0,0,0,0,0,0,0,0,0,0,0,0,0,0,0,0,0,0,0,0,0,0,0
270531261003048,2,Downtown West,87,87,1000000US270531261003048,"Block 3048, Block Group 3, Census Tract 1261, Hennepin County, Minnesota",0,0,0,0,0,0,0,0,0,0,0,0,0,0,0,0,0,0,0,0,0,0,0,0,0
270531261003026,2,Downtown West,87,87,1000000US270531261003026,"Block 3026, Block Group 3, Census Tract 1261, Hennepin County, Minnesota",0,0,0,0,0,0,0,0,0,0,0,0,0,0,0,0,0,0,0,0,0,0,0,0,0
270531044002030,2,Downtown West,87,87,1000000US270531044002030,"Block 2030, Block Group 2, Census Tract 1044, Hennepin County, Minnesota",0,0,0,0,0,0,0,0,0,0,0,0,0,0,0,0,0,0,0,0,0,0,0,0,0
270531261003046,2,Downtown West,87,87,1000000US270531261003046,"Block 3046, Block Group 3, Census Tract 1261, Hennepin County, Minnesota",0,0,0,0,0,0,0,0,0,0,0,0,0,0,0,0,0,0,0,0,0,0,0,0,0
270531044002001,2,Downtown West,87,87,1000000US270531044002001,"Block 2001, Block Group 2, Census Tract 1044, Hennepin County, Minnesota",0,0,0,0,0,0,0,0,0,0,0,0,0,0,0,0,0,0,0,0,0,0,0,0,0
270531044002000,2,Downtown West,87,87,1000000US270531044002000,"Block 2000, Block Group 2, Census Tract 1044, Hennepin County, Minnesota",309,258,10,2,30,0,1,8,309,301,251,10,2,30,0,0,8,8,7,0,0,0,0,1,0
270531044002029,2,Downtown West,87,87,1000000US270531044002029,"Block 2029, Block Group 2, Census Tract 1044, Hennepin County, Minnesota",0,0,0,0,0,0,0,0,0,0,0,0,0,0,0,0,0,0,0,0,0,0,0,0,0
270531261003047,2,Downtown West,87,87,1000000US270531261003047,"Block 3047, Block Group 3, Census Tract 1261, Hennepin County, Minnesota",0,0,0,0,0,0,0,0,0,0,0,0,0,0,0,0,0,0,0,0,0,0,0,0,0
270531044001000,2,Downtown West,87,87,1000000US270531044001000,"Block 1000, Block Group 1, Census Tract 1044, Hennepin County, Minnesota",0,0,0,0,0,0,0,0,0,0,0,0,0,0,0,0,0,0,0,0,0,0,0,0,0
270531261003000,2,Downtown West,87,87,1000000US270531261003000,"Block 3000, Block Group 3, Census Tract 1261, Hennepin County, Minnesota",0,0,0,0,0,0,0,0,0,0,0,0,0,0,0,0,0,0,0,0,0,0,0,0,0
270531261003002,2,Downtown West,87,87,1000000US270531261003002,"Block 3002, Block Group 3, Census Tract 1261, Hennepin County, Minnesota",0,0,0,0,0,0,0,0,0,0,0,0,0,0,0,0,0,0,0,0,0,0,0,0,0
270531044002028,2,Downtown West,87,87,1000000US270531044002028,"Block 2028, Block Group 2, Census Tract 1044, Hennepin County, Minnesota",0,0,0,0,0,0,0,0,0,0,0,0,0,0,0,0,0,0,0,0,0,0,0,0,0
270531261003004,2,Downtown West,87,87,1000000US270531261003004,"Block 3004, Block Group 3, Census Tract 1261, Hennepin County, Minnesota",0,0,0,0,0,0,0,0,0,0,0,0,0,0,0,0,0,0,0,0,0,0,0,0,0
270531261003008,2,Downtown West,87,87,1000000US270531261003008,"Block 3008, Block Group 3, Census Tract 1261, Hennepin County, Minnesota",8,5,0,0,2,0,0,1,8,8,5,0,0,2,0,0,1,0,0,0,0,0,0,0,0
270531261003033,2,Downtown West,87,87,1000000US270531261003033,"Block 3033, Block Group 3, Census Tract 1261, Hennepin County, Minnesota",0,0,0,0,0,0,0,0,0,0,0,0,0,0,0,0,0,0,0,0,0,0,0,0,0
270531261003036,2,Downtown West,87,87,1000000US270531261003036,"Block 3036, Block Group 3, Census Tract 1261, Hennepin County, Minnesota",0,0,0,0,0,0,0,0,0,0,0,0,0,0,0,0,0,0,0,0,0,0,0,0,0
270531261003027,2,Downtown West,87,87,1000000US270531261003027,"Block 3027, Block Group 3, Census Tract 1261, Hennepin County, Minnesota",0,0,0,0,0,0,0,0,0,0,0,0,0,0,0,0,0,0,0,0,0,0,0,0,0
270531261003025,2,Downtown West,87,87,1000000US270531261003025,"Block 3025, Block Group 3, Census Tract 1261, Hennepin County, Minnesota",0,0,0,0,0,0,0,0,0,0,0,0,0,0,0,0,0,0,0,0,0,0,0,0,0
270531044002014,2,Downtown West,87,87,1000000US270531044002014,"Block 2014, Block Group 2, Census Tract 1044, Hennepin County, Minnesota",0,0,0,0,0,0,0,0,0,0,0,0,0,0,0,0,0,0,0,0,0,0,0,0,0
270531044002011,2,Downtown West,87,87,1000000US270531044002011,"Block 2011, Block Group 2, Census Tract 1044, Hennepin County, Minnesota",0,0,0,0,0,0,0,0,0,0,0,0,0,0,0,0,0,0,0,0,0,0,0,0,0
270531044001003,2,Downtown West,87,87,1000000US270531044001003,"Block 1003, Block Group 1, Census Tract 1044, Hennepin County, Minnesota",0,0,0,0,0,0,0,0,0,0,0,0,0,0,0,0,0,0,0,0,0,0,0,0,0
270531044001007,2,Downtown West,87,87,1000000US270531044001007,"Block 1007, Block Group 1, Census Tract 1044, Hennepin County, Minnesota",42,32,4,0,1,0,1,4,42,39,31,4,0,1,0,1,2,3,1,0,0,0,0,0,2
270531044001013,2,Downtown West,87,87,1000000US270531044001013,"Block 1013, Block Group 1, Census Tract 1044, Hennepin County, Minnesota",0,0,0,0,0,0,0,0,0,0,0,0,0,0,0,0,0,0,0,0,0,0,0,0,0
270531044002004,2,Downtown West,87,87,1000000US270531044002004,"Block 2004, Block Group 2, Census Tract 1044, Hennepin County, Minnesota",0,0,0,0,0,0,0,0,0,0,0,0,0,0,0,0,0,0,0,0,0,0,0,0,0
270531044002021,2,Downtown West,87,87,1000000US270531044002021,"Block 2021, Block Group 2, Census Tract 1044, Hennepin County, Minnesota",0,0,0,0,0,0,0,0,0,0,0,0,0,0,0,0,0,0,0,0,0,0,0,0,0
270531044002002,2,Downtown West,87,87,1000000US270531044002002,"Block 2002, Block Group 2, Census Tract 1044, Hennepin County, Minnesota",0,0,0,0,0,0,0,0,0,0,0,0,0,0,0,0,0,0,0,0,0,0,0,0,0
270531044002025,2,Downtown West,87,87,1000000US270531044002025,"Block 2025, Block Group 2, Census Tract 1044, Hennepin County, Minnesota",0,0,0,0,0,0,0,0,0,0,0,0,0,0,0,0,0,0,0,0,0,0,0,0,0
270531261003037,2,Downtown West,87,87,1000000US270531261003037,"Block 3037, Block Group 3, Census Tract 1261, Hennepin County, Minnesota",290,49,226,11,2,0,1,1,290,270,30,226,11,2,0,0,1,20,19,0,0,0,0,1,0
270531261003039,2,Downtown West,87,87,1000000US270531261003039,"Block 3039, Block Group 3, Census Tract 1261, Hennepin County, Minnesota",0,0,0,0,0,0,0,0,0,0,0,0,0,0,0,0,0,0,0,0,0,0,0,0,0
270531261003013,2,Downtown West,87,87,1000000US270531261003013,"Block 3013, Block Group 3, Census Tract 1261, Hennepin County, Minnesota",0,0,0,0,0,0,0,0,0,0,0,0,0,0,0,0,0,0,0,0,0,0,0,0,0
270531261003045,2,Downtown West,87,87,1000000US270531261003045,"Block 3045, Block Group 3, Census Tract 1261, Hennepin County, Minnesota",0,0,0,0,0,0,0,0,0,0,0,0,0,0,0,0,0,0,0,0,0,0,0,0,0
270531261003034,2,Downtown West,87,87,1000000US270531261003034,"Block 3034, Block Group 3, Census Tract 1261, Hennepin County, Minnesota",0,0,0,0,0,0,0,0,0,0,0,0,0,0,0,0,0,0,0,0,0,0,0,0,0
270531261003018,2,Downtown West,87,87,1000000US270531261003018,"Block 3018, Block Group 3, Census Tract 1261, Hennepin County, Minnesota",0,0,0,0,0,0,0,0,0,0,0,0,0,0,0,0,0,0,0,0,0,0,0,0,0
270531261004001,2,Downtown West,87,87,1000000US270531261004001,"Block 4001, Block Group 4, Census Tract 1261, Hennepin County, Minnesota",535,452,15,1,47,0,7,13,535,522,448,15,1,47,0,0,11,13,4,0,0,0,0,7,2
270531044002007,2,Downtown West,87,87,1000000US270531044002007,"Block 2007, Block Group 2, Census Tract 1044, Hennepin County, Minnesota",0,0,0,0,0,0,0,0,0,0,0,0,0,0,0,0,0,0,0,0,0,0,0,0,0
270531261003021,2,Downtown West,87,87,1000000US270531261003021,"Block 3021, Block Group 3, Census Tract 1261, Hennepin County, Minnesota",369,321,7,2,29,1,3,6,369,353,310,7,1,29,1,0,5,16,11,0,1,0,0,3,1
270531261003030,2,Downtown West,87,87,1000000US270531261003030,"Block 3030, Block Group 3, Census Tract 1261, Hennepin County, Minnesota",0,0,0,0,0,0,0,0,0,0,0,0,0,0,0,0,0,0,0,0,0,0,0,0,0
270531261003041,2,Downtown West,87,87,1000000US270531261003041,"Block 3041, Block Group 3, Census Tract 1261, Hennepin County, Minnesota",0,0,0,0,0,0,0,0,0,0,0,0,0,0,0,0,0,0,0,0,0,0,0,0,0
270531261002003,2,Downtown West,87,87,1000000US270531261002003,"Block 2003, Block Group 2, Census Tract 1261, Hennepin County, Minnesota",648,471,24,1,132,1,1,18,648,625,452,22,1,132,1,0,17,23,19,2,0,0,0,1,1
270531261002009,2,Downtown West,87,87,1000000US270531261002009,"Block 2009, Block Group 2, Census Tract 1261, Hennepin County, Minnesota",31,31,0,0,0,0,0,0,31,31,31,0,0,0,0,0,0,0,0,0,0,0,0,0,0
270531044002003,2,Downtown West,87,87,1000000US270531044002003,"Block 2003, Block Group 2, Census Tract 1044, Hennepin County, Minnesota",0,0,0,0,0,0,0,0,0,0,0,0,0,0,0,0,0,0,0,0,0,0,0,0,0
270531261003010,2,Downtown West,87,87,1000000US270531261003010,"Block 3010, Block Group 3, Census Tract 1261, Hennepin County, Minnesota",0,0,0,0,0,0,0,0,0,0,0,0,0,0,0,0,0,0,0,0,0,0,0,0,0
270531044001012,2,Downtown West,87,87,1000000US270531044001012,"Block 1012, Block Group 1, Census Tract 1044, Hennepin County, Minnesota",0,0,0,0,0,0,0,0,0,0,0,0,0,0,0,0,0,0,0,0,0,0,0,0,0
270531044001002,2,Downtown West,87,87,1000000US270531044001002,"Block 1002, Block Group 1, Census Tract 1044, Hennepin County, Minnesota",0,0,0,0,0,0,0,0,0,0,0,0,0,0,0,0,0,0,0,0,0,0,0,0,0
270531261001019,3,Downtown East,88,88,1000000US270531261001019,"Block 1019, Block Group 1, Census Tract 1261, Hennepin County, Minnesota",0,0,0,0,0,0,0,0,0,0,0,0,0,0,0,0,0,0,0,0,0,0,0,0,0
270531261001018,3,Downtown East,88,88,1000000US270531261001018,"Block 1018, Block Group 1, Census Tract 1261, Hennepin County, Minnesota",0,0,0,0,0,0,0,0,0,0,0,0,0,0,0,0,0,0,0,0,0,0,0,0,0
270531261001002,3,Downtown East,88,88,1000000US270531261001002,"Block 1002, Block Group 1, Census Tract 1261, Hennepin County, Minnesota",2,1,0,0,0,0,1,0,2,1,1,0,0,0,0,0,0,1,0,0,0,0,0,1,0
270531261001014,3,Downtown East,88,88,1000000US270531261001014,"Block 1014, Block Group 1, Census Tract 1261, Hennepin County, Minnesota",0,0,0,0,0,0,0,0,0,0,0,0,0,0,0,0,0,0,0,0,0,0,0,0,0
270531054001000,3,Downtown East,88,88,1000000US270531054001000,"Block 1000, Block Group 1, Census Tract 1054, Hennepin County, Minnesota",0,0,0,0,0,0,0,0,0,0,0,0,0,0,0,0,0,0,0,0,0,0,0,0,0
270531261001032,3,Downtown East,88,88,1000000US270531261001032,"Block 1032, Block Group 1, Census Tract 1261, Hennepin County, Minnesota",0,0,0,0,0,0,0,0,0,0,0,0,0,0,0,0,0,0,0,0,0,0,0,0,0
270531261001034,3,Downtown East,88,88,1000000US270531261001034,"Block 1034, Block Group 1, Census Tract 1261, Hennepin County, Minnesota",1,1,0,0,0,0,0,0,1,1,1,0,0,0,0,0,0,0,0,0,0,0,0,0,0
270531261001004,3,Downtown East,88,88,1000000US270531261001004,"Block 1004, Block Group 1, Census Tract 1261, Hennepin County, Minnesota",116,80,18,0,6,0,3,9,116,110,77,18,0,6,0,0,9,6,3,0,0,0,0,3,0
270531261001006,3,Downtown East,88,88,1000000US270531261001006,"Block 1006, Block Group 1, Census Tract 1261, Hennepin County, Minnesota",57,52,1,0,4,0,0,0,57,57,52,1,0,4,0,0,0,0,0,0,0,0,0,0,0
270531261001021,3,Downtown East,88,88,1000000US270531261001021,"Block 1021, Block Group 1, Census Tract 1261, Hennepin County, Minnesota",0,0,0,0,0,0,0,0,0,0,0,0,0,0,0,0,0,0,0,0,0,0,0,0,0
270531261001017,3,Downtown East,88,88,1000000US270531261001017,"Block 1017, Block Group 1, Census Tract 1261, Hennepin County, Minnesota",0,0,0,0,0,0,0,0,0,0,0,0,0,0,0,0,0,0,0,0,0,0,0,0,0
270531261001016,3,Downtown East,88,88,1000000US270531261001016,"Block 1016, Block Group 1, Census Tract 1261, Hennepin County, Minnesota",0,0,0,0,0,0,0,0,0,0,0,0,0,0,0,0,0,0,0,0,0,0,0,0,0
270531261001020,3,Downtown East,88,88,1000000US270531261001020,"Block 1020, Block Group 1, Census Tract 1261, Hennepin County, Minnesota",0,0,0,0,0,0,0,0,0,0,0,0,0,0,0,0,0,0,0,0,0,0,0,0,0
270531261001003,3,Downtown East,88,88,1000000US270531261001003,"Block 1003, Block Group 1, Census Tract 1261, Hennepin County, Minnesota",189,176,2,0,7,0,2,2,189,187,175,2,0,7,0,1,2,2,1,0,0,0,0,1,0
270531261001033,3,Downtown East,88,88,1000000US270531261001033,"Block 1033, Block Group 1, Census Tract 1261, Hennepin County, Minnesota",0,0,0,0,0,0,0,0,0,0,0,0,0,0,0,0,0,0,0,0,0,0,0,0,0
270531261001025,3,Downtown East,88,88,1000000US270531261001025,"Block 1025, Block Group 1, Census Tract 1261, Hennepin County, Minnesota",0,0,0,0,0,0,0,0,0,0,0,0,0,0,0,0,0,0,0,0,0,0,0,0,0
270531261001022,3,Downtown East,88,88,1000000US270531261001022,"Block 1022, Block Group 1, Census Tract 1261, Hennepin County, Minnesota",0,0,0,0,0,0,0,0,0,0,0,0,0,0,0,0,0,0,0,0,0,0,0,0,0
270531261001009,3,Downtown East,88,88,1000000US270531261001009,"Block 1009, Block Group 1, Census Tract 1261, Hennepin County, Minnesota",0,0,0,0,0,0,0,0,0,0,0,0,0,0,0,0,0,0,0,0,0,0,0,0,0
270531261001008,3,Downtown East,88,88,1000000US270531261001008,"Block 1008, Block Group 1, Census Tract 1261, Hennepin County, Minnesota",0,0,0,0,0,0,0,0,0,0,0,0,0,0,0,0,0,0,0,0,0,0,0,0,0
270531261001030,3,Downtown East,88,88,1000000US270531261001030,"Block 1030, Block Group 1, Census Tract 1261, Hennepin County, Minnesota",0,0,0,0,0,0,0,0,0,0,0,0,0,0,0,0,0,0,0,0,0,0,0,0,0
270531261001024,3,Downtown East,88,88,1000000US270531261001024,"Block 1024, Block Group 1, Census Tract 1261, Hennepin County, Minnesota",0,0,0,0,0,0,0,0,0,0,0,0,0,0,0,0,0,0,0,0,0,0,0,0,0
270531261001023,3,Downtown East,88,88,1000000US270531261001023,"Block 1023, Block Group 1, Census Tract 1261, Hennepin County, Minnesota",0,0,0,0,0,0,0,0,0,0,0,0,0,0,0,0,0,0,0,0,0,0,0,0,0
270531261001015,3,Downtown East,88,88,1000000US270531261001015,"Block 1015, Block Group 1, Census Tract 1261, Hennepin County, Minnesota",0,0,0,0,0,0,0,0,0,0,0,0,0,0,0,0,0,0,0,0,0,0,0,0,0
270531261001027,3,Downtown East,88,88,1000000US270531261001027,"Block 1027, Block Group 1, Census Tract 1261, Hennepin County, Minnesota",14,13,0,0,1,0,0,0,14,14,13,0,0,1,0,0,0,0,0,0,0,0,0,0,0
270531261001026,3,Downtown East,88,88,1000000US270531261001026,"Block 1026, Block Group 1, Census Tract 1261, Hennepin County, Minnesota",0,0,0,0,0,0,0,0,0,0,0,0,0,0,0,0,0,0,0,0,0,0,0,0,0
270531261001011,3,Downtown East,88,88,1000000US270531261001011,"Block 1011, Block Group 1, Census Tract 1261, Hennepin County, Minnesota",342,307,8,0,21,0,2,4,342,330,298,8,0,21,0,0,3,12,9,0,0,0,0,2,1
270531261001029,3,Downtown East,88,88,1000000US270531261001029,"Block 1029, Block Group 1, Census Tract 1261, Hennepin County, Minnesota",0,0,0,0,0,0,0,0,0,0,0,0,0,0,0,0,0,0,0,0,0,0,0,0,0
270531261001010,3,Downtown East,88,88,1000000US270531261001010,"Block 1010, Block Group 1, Census Tract 1261, Hennepin County, Minnesota",0,0,0,0,0,0,0,0,0,0,0,0,0,0,0,0,0,0,0,0,0,0,0,0,0
270531261001000,3,Downtown East,88,88,1000000US270531261001000,"Block 1000, Block Group 1, Census Tract 1261, Hennepin County, Minnesota",0,0,0,0,0,0,0,0,0,0,0,0,0,0,0,0,0,0,0,0,0,0,0,0,0
270531261001001,3,Downtown East,88,88,1000000US270531261001001,"Block 1001, Block Group 1, Census Tract 1261, Hennepin County, Minnesota",0,0,0,0,0,0,0,0,0,0,0,0,0,0,0,0,0,0,0,0,0,0,0,0,0
270531261001013,3,Downtown East,88,88,1000000US270531261001013,"Block 1013, Block Group 1, Census Tract 1261, Hennepin County, Minnesota",3,3,0,0,0,0,0,0,3,3,3,0,0,0,0,0,0,0,0,0,0,0,0,0,0
270531261001012,3,Downtown East,88,88,1000000US270531261001012,"Block 1012, Block Group 1, Census Tract 1261, Hennepin County, Minnesota",49,42,1,0,6,0,0,0,49,49,42,1,0,6,0,0,0,0,0,0,0,0,0,0,0
270531261001028,3,Downtown East,88,88,1000000US270531261001028,"Block 1028, Block Group 1, Census Tract 1261, Hennepin County, Minnesota",0,0,0,0,0,0,0,0,0,0,0,0,0,0,0,0,0,0,0,0,0,0,0,0,0
270531261001007,3,Downtown East,88,88,1000000US270531261001007,"Block 1007, Block Group 1, Census Tract 1261, Hennepin County, Minnesota",481,172,213,32,16,0,21,27,481,450,165,208,28,16,0,7,26,31,7,5,4,0,0,14,1
270531261001031,3,Downtown East,88,88,1000000US270531261001031,"Block 1031, Block Group 1, Census Tract 1261, Hennepin County, Minnesota",0,0,0,0,0,0,0,0,0,0,0,0,0,0,0,0,0,0,0,0,0,0,0,0,0
270531261001005,3,Downtown East,88,88,1000000US270531261001005,"Block 1005, Block Group 1, Census Tract 1261, Hennepin County, Minnesota",0,0,0,0,0,0,0,0,0,0,0,0,0,0,0,0,0,0,0,0,0,0,0,0,0
270531060003002,4,Ventura Village,89,89,1000000US270531060003002,"Block 3002, Block Group 3, Census Tract 1060, Hennepin County, Minnesota",363,19,324,1,9,0,6,4,363,356,17,322,1,9,0,4,3,7,2,2,0,0,0,2,1
270530059021001,4,Ventura Village,89,89,1000000US270530059021001,"Block 1001, Block Group 1, Census Tract 59.02, Hennepin County, Minnesota",0,0,0,0,0,0,0,0,0,0,0,0,0,0,0,0,0,0,0,0,0,0,0,0,0
270530059021002,4,Ventura Village,89,89,1000000US270530059021002,"Block 1002, Block Group 1, Census Tract 59.02, Hennepin County, Minnesota",0,0,0,0,0,0,0,0,0,0,0,0,0,0,0,0,0,0,0,0,0,0,0,0,0
270530059021012,4,Ventura Village,89,89,1000000US270530059021012,"Block 1012, Block Group 1, Census Tract 59.02, Hennepin County, Minnesota",0,0,0,0,0,0,0,0,0,0,0,0,0,0,0,0,0,0,0,0,0,0,0,0,0
270530059022000,4,Ventura Village,89,89,1000000US270530059022000,"Block 2000, Block Group 2, Census Tract 59.02, Hennepin County, Minnesota",17,6,11,0,0,0,0,0,17,17,6,11,0,0,0,0,0,0,0,0,0,0,0,0,0
270530059022007,4,Ventura Village,89,89,1000000US270530059022007,"Block 2007, Block Group 2, Census Tract 59.02, Hennepin County, Minnesota",217,68,111,5,3,0,17,13,217,184,58,111,4,3,0,3,5,33,10,0,1,0,0,14,8
270531060001008,4,Ventura Village,89,89,1000000US270531060001008,"Block 1008, Block Group 1, Census Tract 1060, Hennepin County, Minnesota",0,0,0,0,0,0,0,0,0,0,0,0,0,0,0,0,0,0,0,0,0,0,0,0,0
270531060002002,4,Ventura Village,89,89,1000000US270531060002002,"Block 2002, Block Group 2, Census Tract 1060, Hennepin County, Minnesota",41,11,14,5,0,0,10,1,41,26,6,14,5,0,0,0,1,15,5,0,0,0,0,10,0
270531060002013,4,Ventura Village,89,89,1000000US270531060002013,"Block 2013, Block Group 2, Census Tract 1060, Hennepin County, Minnesota",139,38,32,3,8,0,46,12,139,77,28,31,3,8,0,0,7,62,10,1,0,0,0,46,5
270531060002012,4,Ventura Village,89,89,1000000US270531060002012,"Block 2012, Block Group 2, Census Tract 1060, Hennepin County, Minnesota",77,29,38,5,4,0,0,1,77,61,16,38,2,4,0,0,1,16,13,0,3,0,0,0,0
270531060003001,4,Ventura Village,89,89,1000000US270531060003001,"Block 3001, Block Group 3, Census Tract 1060, Hennepin County, Minnesota",0,0,0,0,0,0,0,0,0,0,0,0,0,0,0,0,0,0,0,0,0,0,0,0,0
270531060001004,4,Ventura Village,89,89,1000000US270531060001004,"Block 1004, Block Group 1, Census Tract 1060, Hennepin County, Minnesota",108,46,23,5,17,0,10,7,108,81,36,23,5,17,0,0,0,27,10,0,0,0,0,10,7
270530059022006,4,Ventura Village,89,89,1000000US270530059022006,"Block 2006, Block Group 2, Census Tract 59.02, Hennepin County, Minnesota",0,0,0,0,0,0,0,0,0,0,0,0,0,0,0,0,0,0,0,0,0,0,0,0,0
270530059021014,4,Ventura Village,89,89,1000000US270530059021014,"Block 1014, Block Group 1, Census Tract 59.02, Hennepin County, Minnesota",398,139,228,11,7,0,3,10,398,388,138,223,10,7,0,0,10,10,1,5,1,0,0,3,0
270530059022005,4,Ventura Village,89,89,1000000US270530059022005,"Block 2005, Block Group 2, Census Tract 59.02, Hennepin County, Minnesota",310,78,106,1,1,0,98,26,310,144,21,104,1,1,0,1,16,166,57,2,0,0,0,97,10
270530059021004,4,Ventura Village,89,89,1000000US270530059021004,"Block 1004, Block Group 1, Census Tract 59.02, Hennepin County, Minnesota",89,11,70,1,0,0,2,5,89,80,4,70,1,0,0,0,5,9,7,0,0,0,0,2,0
270530059021003,4,Ventura Village,89,89,1000000US270530059021003,"Block 1003, Block Group 1, Census Tract 59.02, Hennepin County, Minnesota",82,36,12,6,2,0,21,5,82,50,26,12,5,2,0,1,4,32,10,0,1,0,0,20,1
270530059021005,4,Ventura Village,89,89,1000000US270530059021005,"Block 1005, Block Group 1, Census Tract 59.02, Hennepin County, Minnesota",0,0,0,0,0,0,0,0,0,0,0,0,0,0,0,0,0,0,0,0,0,0,0,0,0
270530059021013,4,Ventura Village,89,89,1000000US270530059021013,"Block 1013, Block Group 1, Census Tract 59.02, Hennepin County, Minnesota",357,162,78,10,23,0,54,30,357,261,140,75,8,23,0,0,15,96,22,3,2,0,0,54,15
270530059022001,4,Ventura Village,89,89,1000000US270530059022001,"Block 2001, Block Group 2, Census Tract 59.02, Hennepin County, Minnesota",97,10,81,0,1,0,1,4,97,97,10,81,0,1,0,1,4,0,0,0,0,0,0,0,0
270530059022008,4,Ventura Village,89,89,1000000US270530059022008,"Block 2008, Block Group 2, Census Tract 59.02, Hennepin County, Minnesota",63,6,39,18,0,0,0,0,63,59,3,38,18,0,0,0,0,4,3,1,0,0,0,0,0
270530059021006,4,Ventura Village,89,89,1000000US270530059021006,"Block 1006, Block Group 1, Census Tract 59.02, Hennepin County, Minnesota",116,40,54,9,1,0,1,11,116,112,40,53,9,1,0,0,9,4,0,1,0,0,0,1,2
270530059021008,4,Ventura Village,89,89,1000000US270530059021008,"Block 1008, Block Group 1, Census Tract 59.02, Hennepin County, Minnesota",221,49,153,0,6,0,9,4,221,209,49,151,0,6,0,0,3,12,0,2,0,0,0,9,1
270530059022004,4,Ventura Village,89,89,1000000US270530059022004,"Block 2004, Block Group 2, Census Tract 59.02, Hennepin County, Minnesota",201,42,126,5,2,0,6,20,201,182,32,126,5,2,0,2,15,19,10,0,0,0,0,4,5
270530059021000,4,Ventura Village,89,89,1000000US270530059021000,"Block 1000, Block Group 1, Census Tract 59.02, Hennepin County, Minnesota",0,0,0,0,0,0,0,0,0,0,0,0,0,0,0,0,0,0,0,0,0,0,0,0,0
270530059022009,4,Ventura Village,89,89,1000000US270530059022009,"Block 2009, Block Group 2, Census Tract 59.02, Hennepin County, Minnesota",136,52,45,19,0,1,12,7,136,111,47,35,15,0,1,6,7,25,5,10,4,0,0,6,0
270530059021010,4,Ventura Village,89,89,1000000US270530059021010,"Block 1010, Block Group 1, Census Tract 59.02, Hennepin County, Minnesota",34,20,6,0,0,0,3,5,34,30,19,6,0,0,0,0,5,4,1,0,0,0,0,3,0
270530059021009,4,Ventura Village,89,89,1000000US270530059021009,"Block 1009, Block Group 1, Census Tract 59.02, Hennepin County, Minnesota",109,68,10,7,0,0,24,0,109,63,47,10,6,0,0,0,0,46,21,0,1,0,0,24,0
270530059022010,4,Ventura Village,89,89,1000000US270530059022010,"Block 2010, Block Group 2, Census Tract 59.02, Hennepin County, Minnesota",58,23,12,2,1,0,19,1,58,28,13,12,2,1,0,0,0,30,10,0,0,0,0,19,1
270531060001003,4,Ventura Village,89,89,1000000US270531060001003,"Block 1003, Block Group 1, Census Tract 1060, Hennepin County, Minnesota",247,18,167,33,0,0,19,10,247,214,11,167,30,0,0,0,6,33,7,0,3,0,0,19,4
270531060002003,4,Ventura Village,89,89,1000000US270531060002003,"Block 2003, Block Group 2, Census Tract 1060, Hennepin County, Minnesota",80,26,9,3,0,0,35,7,80,33,19,5,1,0,0,1,7,47,7,4,2,0,0,34,0
270531060002005,4,Ventura Village,89,89,1000000US270531060002005,"Block 2005, Block Group 2, Census Tract 1060, Hennepin County, Minnesota",71,24,38,0,1,0,7,1,71,62,22,38,0,1,0,0,1,9,2,0,0,0,0,7,0
270531060003005,4,Ventura Village,89,89,1000000US270531060003005,"Block 3005, Block Group 3, Census Tract 1060, Hennepin County, Minnesota",264,62,24,0,12,0,161,5,264,58,29,16,0,12,0,1,0,206,33,8,0,0,0,160,5
270530059022002,4,Ventura Village,89,89,1000000US270530059022002,"Block 2002, Block Group 2, Census Tract 59.02, Hennepin County, Minnesota",0,0,0,0,0,0,0,0,0,0,0,0,0,0,0,0,0,0,0,0,0,0,0,0,0
270531060002004,4,Ventura Village,89,89,1000000US270531060002004,"Block 2004, Block Group 2, Census Tract 1060, Hennepin County, Minnesota",31,9,3,9,0,0,10,0,31,22,8,3,9,0,0,2,0,9,1,0,0,0,0,8,0
270531060001013,4,Ventura Village,89,89,1000000US270531060001013,"Block 1013, Block Group 1, Census Tract 1060, Hennepin County, Minnesota",108,7,91,0,1,0,5,4,108,100,7,90,0,1,0,0,2,8,0,1,0,0,0,5,2
270531060002000,4,Ventura Village,89,89,1000000US270531060002000,"Block 2000, Block Group 2, Census Tract 1060, Hennepin County, Minnesota",1,1,0,0,0,0,0,0,1,1,1,0,0,0,0,0,0,0,0,0,0,0,0,0,0
270530059012013,4,Ventura Village,89,89,1000000US270530059012013,"Block 2013, Block Group 2, Census Tract 59.01, Hennepin County, Minnesota",0,0,0,0,0,0,0,0,0,0,0,0,0,0,0,0,0,0,0,0,0,0,0,0,0
270531060001002,4,Ventura Village,89,89,1000000US270531060001002,"Block 1002, Block Group 1, Census Tract 1060, Hennepin County, Minnesota",0,0,0,0,0,0,0,0,0,0,0,0,0,0,0,0,0,0,0,0,0,0,0,0,0
270531060001010,4,Ventura Village,89,89,1000000US270531060001010,"Block 1010, Block Group 1, Census Tract 1060, Hennepin County, Minnesota",75,60,11,0,0,1,3,0,75,71,60,10,0,0,1,0,0,4,0,1,0,0,0,3,0
270531060001011,4,Ventura Village,89,89,1000000US270531060001011,"Block 1011, Block Group 1, Census Tract 1060, Hennepin County, Minnesota",53,25,7,8,0,0,13,0,53,27,14,5,8,0,0,0,0,26,11,2,0,0,0,13,0
270531060001006,4,Ventura Village,89,89,1000000US270531060001006,"Block 1006, Block Group 1, Census Tract 1060, Hennepin County, Minnesota",117,31,8,33,0,0,23,22,117,66,29,7,18,0,0,0,12,51,2,1,15,0,0,23,10
270531060001005,4,Ventura Village,89,89,1000000US270531060001005,"Block 1005, Block Group 1, Census Tract 1060, Hennepin County, Minnesota",190,29,95,56,1,0,1,8,190,157,10,95,43,1,0,0,8,33,19,0,13,0,0,1,0
270531060003003,4,Ventura Village,89,89,1000000US270531060003003,"Block 3003, Block Group 3, Census Tract 1060, Hennepin County, Minnesota",59,11,14,16,0,0,13,5,59,43,11,14,13,0,0,0,5,16,0,0,3,0,0,13,0
270531060002001,4,Ventura Village,89,89,1000000US270531060002001,"Block 2001, Block Group 2, Census Tract 1060, Hennepin County, Minnesota",0,0,0,0,0,0,0,0,0,0,0,0,0,0,0,0,0,0,0,0,0,0,0,0,0
270531060002007,4,Ventura Village,89,89,1000000US270531060002007,"Block 2007, Block Group 2, Census Tract 1060, Hennepin County, Minnesota",32,10,8,11,0,0,0,3,32,30,10,8,9,0,0,0,3,2,0,0,2,0,0,0,0
270531060002010,4,Ventura Village,89,89,1000000US270531060002010,"Block 2010, Block Group 2, Census Tract 1060, Hennepin County, Minnesota",278,11,171,79,5,0,0,12,278,270,10,171,73,5,0,0,11,8,1,0,6,0,0,0,1
270531060003000,4,Ventura Village,89,89,1000000US270531060003000,"Block 3000, Block Group 3, Census Tract 1060, Hennepin County, Minnesota",0,0,0,0,0,0,0,0,0,0,0,0,0,0,0,0,0,0,0,0,0,0,0,0,0
270531060003004,4,Ventura Village,89,89,1000000US270531060003004,"Block 3004, Block Group 3, Census Tract 1060, Hennepin County, Minnesota",146,40,49,20,0,0,20,17,146,105,27,49,12,0,0,0,17,41,13,0,8,0,0,20,0
270531060001001,4,Ventura Village,89,89,1000000US270531060001001,"Block 1001, Block Group 1, Census Tract 1060, Hennepin County, Minnesota",0,0,0,0,0,0,0,0,0,0,0,0,0,0,0,0,0,0,0,0,0,0,0,0,0
270531060002008,4,Ventura Village,89,89,1000000US270531060002008,"Block 2008, Block Group 2, Census Tract 1060, Hennepin County, Minnesota",134,25,68,29,7,0,1,4,134,126,23,67,27,7,0,0,2,8,2,1,2,0,0,1,2
270530059022003,4,Ventura Village,89,89,1000000US270530059022003,"Block 2003, Block Group 2, Census Tract 59.02, Hennepin County, Minnesota",186,90,49,6,2,0,27,12,186,136,68,48,5,2,0,2,11,50,22,1,1,0,0,25,1
270531060001009,4,Ventura Village,89,89,1000000US270531060001009,"Block 1009, Block Group 1, Census Tract 1060, Hennepin County, Minnesota",119,57,36,9,1,0,6,10,119,111,55,36,9,1,0,1,9,8,2,0,0,0,0,5,1
270531060001012,4,Ventura Village,89,89,1000000US270531060001012,"Block 1012, Block Group 1, Census Tract 1060, Hennepin County, Minnesota",51,18,15,10,0,0,0,8,51,48,18,15,9,0,0,0,6,3,0,0,1,0,0,0,2
270531060002011,4,Ventura Village,89,89,1000000US270531060002011,"Block 2011, Block Group 2, Census Tract 1060, Hennepin County, Minnesota",136,16,89,8,0,0,20,3,136,107,7,89,8,0,0,0,3,29,9,0,0,0,0,20,0
270531060002014,4,Ventura Village,89,89,1000000US270531060002014,"Block 2014, Block Group 2, Census Tract 1060, Hennepin County, Minnesota",47,8,18,2,9,0,7,3,47,40,8,18,2,9,0,0,3,7,0,0,0,0,0,7,0
270531060001007,4,Ventura Village,89,89,1000000US270531060001007,"Block 1007, Block Group 1, Census Tract 1060, Hennepin County, Minnesota",140,51,62,8,0,0,15,4,140,117,46,61,8,0,0,1,1,23,5,1,0,0,0,14,3
270531060002006,4,Ventura Village,89,89,1000000US270531060002006,"Block 2006, Block Group 2, Census Tract 1060, Hennepin County, Minnesota",119,35,16,1,0,0,67,0,119,39,22,16,1,0,0,0,0,80,13,0,0,0,0,67,0
270531060001000,4,Ventura Village,89,89,1000000US270531060001000,"Block 1000, Block Group 1, Census Tract 1060, Hennepin County, Minnesota",0,0,0,0,0,0,0,0,0,0,0,0,0,0,0,0,0,0,0,0,0,0,0,0,0
270530059021011,4,Ventura Village,89,89,1000000US270530059021011,"Block 1011, Block Group 1, Census Tract 59.02, Hennepin County, Minnesota",495,203,114,31,6,0,103,38,495,299,131,112,20,5,0,1,30,196,72,2,11,1,0,102,8
270530059021007,4,Ventura Village,89,89,1000000US270530059021007,"Block 1007, Block Group 1, Census Tract 59.02, Hennepin County, Minnesota",12,7,3,0,0,0,2,0,12,10,7,3,0,0,0,0,0,2,0,0,0,0,0,2,0
270531060002009,4,Ventura Village,89,89,1000000US270531060002009,"Block 2009, Block Group 2, Census Tract 1060, Hennepin County, Minnesota",113,26,52,8,7,0,19,1,113,80,15,49,8,7,0,0,1,33,11,3,0,0,0,19,0
270531034002010,5,Sumner - Glenwood,29,29,1000000US270531034002010,"Block 2010, Block Group 2, Census Tract 1034, Hennepin County, Minnesota",162,6,127,5,15,0,0,9,162,161,6,126,5,15,0,0,9,1,0,1,0,0,0,0,0
270531034002005,5,Sumner - Glenwood,29,29,1000000US270531034002005,"Block 2005, Block Group 2, Census Tract 1034, Hennepin County, Minnesota",87,4,78,0,0,0,0,5,87,83,4,76,0,0,0,0,3,4,0,2,0,0,0,0,2
270531034002012,5,Sumner - Glenwood,29,29,1000000US270531034002012,"Block 2012, Block Group 2, Census Tract 1034, Hennepin County, Minnesota",0,0,0,0,0,0,0,0,0,0,0,0,0,0,0,0,0,0,0,0,0,0,0,0,0
270531034002007,5,Sumner - Glenwood,29,29,1000000US270531034002007,"Block 2007, Block Group 2, Census Tract 1034, Hennepin County, Minnesota",44,4,37,0,1,0,0,2,44,40,4,33,0,1,0,0,2,4,0,4,0,0,0,0,0
270531034002013,5,Sumner - Glenwood,29,29,1000000US270531034002013,"Block 2013, Block Group 2, Census Tract 1034, Hennepin County, Minnesota",102,0,83,0,14,0,0,5,102,99,0,81,0,14,0,0,4,3,0,2,0,0,0,0,1
270531034003009,5,Sumner - Glenwood,29,29,1000000US270531034003009,"Block 3009, Block Group 3, Census Tract 1034, Hennepin County, Minnesota",110,30,60,4,15,0,1,0,110,100,23,57,4,15,0,1,0,10,7,3,0,0,0,0,0
270531034002000,5,Sumner - Glenwood,29,29,1000000US270531034002000,"Block 2000, Block Group 2, Census Tract 1034, Hennepin County, Minnesota",9,0,9,0,0,0,0,0,9,9,0,9,0,0,0,0,0,0,0,0,0,0,0,0,0
270531034003008,5,Sumner - Glenwood,29,29,1000000US270531034003008,"Block 3008, Block Group 3, Census Tract 1034, Hennepin County, Minnesota",0,0,0,0,0,0,0,0,0,0,0,0,0,0,0,0,0,0,0,0,0,0,0,0,0
270531034002011,5,Sumner - Glenwood,29,29,1000000US270531034002011,"Block 2011, Block Group 2, Census Tract 1034, Hennepin County, Minnesota",66,24,33,0,3,0,0,6,66,66,24,33,0,3,0,0,6,0,0,0,0,0,0,0,0
270531034003006,5,Sumner - Glenwood,29,29,1000000US270531034003006,"Block 3006, Block Group 3, Census Tract 1034, Hennepin County, Minnesota",0,0,0,0,0,0,0,0,0,0,0,0,0,0,0,0,0,0,0,0,0,0,0,0,0
270531034002003,5,Sumner - Glenwood,29,29,1000000US270531034002003,"Block 2003, Block Group 2, Census Tract 1034, Hennepin County, Minnesota",52,0,47,1,3,0,0,1,52,51,0,47,1,3,0,0,0,1,0,0,0,0,0,0,1
270531034003007,5,Sumner - Glenwood,29,29,1000000US270531034003007,"Block 3007, Block Group 3, Census Tract 1034, Hennepin County, Minnesota",133,118,3,0,7,0,2,3,133,128,116,3,0,7,0,1,1,5,2,0,0,0,0,1,2
270531034003000,5,Sumner - Glenwood,29,29,1000000US270531034003000,"Block 3000, Block Group 3, Census Tract 1034, Hennepin County, Minnesota",0,0,0,0,0,0,0,0,0,0,0,0,0,0,0,0,0,0,0,0,0,0,0,0,0
270531034002014,5,Sumner - Glenwood,29,29,1000000US270531034002014,"Block 2014, Block Group 2, Census Tract 1034, Hennepin County, Minnesota",0,0,0,0,0,0,0,0,0,0,0,0,0,0,0,0,0,0,0,0,0,0,0,0,0
270531034003004,5,Sumner - Glenwood,29,29,1000000US270531034003004,"Block 3004, Block Group 3, Census Tract 1034, Hennepin County, Minnesota",17,0,17,0,0,0,0,0,17,17,0,17,0,0,0,0,0,0,0,0,0,0,0,0,0
270531034002008,5,Sumner - Glenwood,29,29,1000000US270531034002008,"Block 2008, Block Group 2, Census Tract 1034, Hennepin County, Minnesota",0,0,0,0,0,0,0,0,0,0,0,0,0,0,0,0,0,0,0,0,0,0,0,0,0
270531034002001,5,Sumner - Glenwood,29,29,1000000US270531034002001,"Block 2001, Block Group 2, Census Tract 1034, Hennepin County, Minnesota",24,0,24,0,0,0,0,0,24,24,0,24,0,0,0,0,0,0,0,0,0,0,0,0,0
270531034002006,5,Sumner - Glenwood,29,29,1000000US270531034002006,"Block 2006, Block Group 2, Census Tract 1034, Hennepin County, Minnesota",52,6,29,0,17,0,0,0,52,52,6,29,0,17,0,0,0,0,0,0,0,0,0,0,0
270531034003003,5,Sumner - Glenwood,29,29,1000000US270531034003003,"Block 3003, Block Group 3, Census Tract 1034, Hennepin County, Minnesota",92,2,76,0,8,0,0,6,92,91,2,75,0,8,0,0,6,1,0,1,0,0,0,0,0
270531034002009,5,Sumner - Glenwood,29,29,1000000US270531034002009,"Block 2009, Block Group 2, Census Tract 1034, Hennepin County, Minnesota",0,0,0,0,0,0,0,0,0,0,0,0,0,0,0,0,0,0,0,0,0,0,0,0,0
270531034003002,5,Sumner - Glenwood,29,29,1000000US270531034003002,"Block 3002, Block Group 3, Census Tract 1034, Hennepin County, Minnesota",63,5,52,0,2,0,1,3,63,63,5,52,0,2,0,1,3,0,0,0,0,0,0,0,0
270531034003005,5,Sumner - Glenwood,29,29,1000000US270531034003005,"Block 3005, Block Group 3, Census Tract 1034, Hennepin County, Minnesota",0,0,0,0,0,0,0,0,0,0,0,0,0,0,0,0,0,0,0,0,0,0,0,0,0
270531034002002,5,Sumner - Glenwood,29,29,1000000US270531034002002,"Block 2002, Block Group 2, Census Tract 1034, Hennepin County, Minnesota",172,3,156,4,3,0,1,5,172,169,3,153,4,3,0,1,5,3,0,3,0,0,0,0,0
270531034002004,5,Sumner - Glenwood,29,29,1000000US270531034002004,"Block 2004, Block Group 2, Census Tract 1034, Hennepin County, Minnesota",0,0,0,0,0,0,0,0,0,0,0,0,0,0,0,0,0,0,0,0,0,0,0,0,0
270531034001008,5,Sumner - Glenwood,29,29,1000000US270531034001008,"Block 1008, Block Group 1, Census Tract 1034, Hennepin County, Minnesota",0,0,0,0,0,0,0,0,0,0,0,0,0,0,0,0,0,0,0,0,0,0,0,0,0
270531034003001,5,Sumner - Glenwood,29,29,1000000US270531034003001,"Block 3001, Block Group 3, Census Tract 1034, Hennepin County, Minnesota",290,17,233,0,18,0,2,20,290,273,12,231,0,18,0,0,12,17,5,2,0,0,0,2,8
270530001014005,6,Shingle Creek,1,1,1000000US270530001014005,"Block 4005, Block Group 4, Census Tract 1.01, Hennepin County, Minnesota",65,38,26,1,0,0,0,0,65,62,35,26,1,0,0,0,0,3,3,0,0,0,0,0,0
270530001014003,6,Shingle Creek,1,1,1000000US270530001014003,"Block 4003, Block Group 4, Census Tract 1.01, Hennepin County, Minnesota",77,38,20,0,19,0,0,0,77,75,36,20,0,19,0,0,0,2,2,0,0,0,0,0,0
270530001011019,6,Shingle Creek,1,1,1000000US270530001011019,"Block 1019, Block Group 1, Census Tract 1.01, Hennepin County, Minnesota",0,0,0,0,0,0,0,0,0,0,0,0,0,0,0,0,0,0,0,0,0,0,0,0,0
270530001011022,6,Shingle Creek,1,1,1000000US270530001011022,"Block 1022, Block Group 1, Census Tract 1.01, Hennepin County, Minnesota",0,0,0,0,0,0,0,0,0,0,0,0,0,0,0,0,0,0,0,0,0,0,0,0,0
270530001011023,6,Shingle Creek,1,1,1000000US270530001011023,"Block 1023, Block Group 1, Census Tract 1.01, Hennepin County, Minnesota",0,0,0,0,0,0,0,0,0,0,0,0,0,0,0,0,0,0,0,0,0,0,0,0,0
270530001011015,6,Shingle Creek,1,1,1000000US270530001011015,"Block 1015, Block Group 1, Census Tract 1.01, Hennepin County, Minnesota",0,0,0,0,0,0,0,0,0,0,0,0,0,0,0,0,0,0,0,0,0,0,0,0,0
270530001012002,6,Shingle Creek,1,1,1000000US270530001012002,"Block 2002, Block Group 2, Census Tract 1.01, Hennepin County, Minnesota",74,47,23,0,1,0,2,1,74,62,38,22,0,1,0,0,1,12,9,1,0,0,0,2,0
270530001011009,6,Shingle Creek,1,1,1000000US270530001011009,"Block 1009, Block Group 1, Census Tract 1.01, Hennepin County, Minnesota",35,17,11,0,3,0,0,4,35,30,16,11,0,3,0,0,0,5,1,0,0,0,0,0,4
270530001012000,6,Shingle Creek,1,1,1000000US270530001012000,"Block 2000, Block Group 2, Census Tract 1.01, Hennepin County, Minnesota",20,3,4,0,0,0,10,3,20,8,3,4,0,0,0,0,1,12,0,0,0,0,0,10,2
270530001013007,6,Shingle Creek,1,1,1000000US270530001013007,"Block 3007, Block Group 3, Census Tract 1.01, Hennepin County, Minnesota",71,29,17,0,19,0,0,6,71,71,29,17,0,19,0,0,6,0,0,0,0,0,0,0,0
270530001013013,6,Shingle Creek,1,1,1000000US270530001013013,"Block 3013, Block Group 3, Census Tract 1.01, Hennepin County, Minnesota",56,15,29,0,7,0,2,3,56,52,15,27,0,7,0,0,3,4,0,2,0,0,0,2,0
270530001013008,6,Shingle Creek,1,1,1000000US270530001013008,"Block 3008, Block Group 3, Census Tract 1.01, Hennepin County, Minnesota",74,41,3,0,25,0,3,2,74,62,33,3,0,25,0,0,1,12,8,0,0,0,0,3,1
270530001014007,6,Shingle Creek,1,1,1000000US270530001014007,"Block 4007, Block Group 4, Census Tract 1.01, Hennepin County, Minnesota",105,25,31,1,38,0,0,10,105,105,25,31,1,38,0,0,10,0,0,0,0,0,0,0,0
270530001011017,6,Shingle Creek,1,1,1000000US270530001011017,"Block 1017, Block Group 1, Census Tract 1.01, Hennepin County, Minnesota",0,0,0,0,0,0,0,0,0,0,0,0,0,0,0,0,0,0,0,0,0,0,0,0,0
270530001014008,6,Shingle Creek,1,1,1000000US270530001014008,"Block 4008, Block Group 4, Census Tract 1.01, Hennepin County, Minnesota",90,32,18,1,28,0,1,10,90,81,27,18,1,28,0,0,7,9,5,0,0,0,0,1,3
270530001011010,6,Shingle Creek,1,1,1000000US270530001011010,"Block 1010, Block Group 1, Census Tract 1.01, Hennepin County, Minnesota",52,22,13,0,0,0,6,11,52,51,22,13,0,0,0,5,11,1,0,0,0,0,0,1,0
270530001014004,6,Shingle Creek,1,1,1000000US270530001014004,"Block 4004, Block Group 4, Census Tract 1.01, Hennepin County, Minnesota",80,40,20,0,6,0,8,6,80,71,40,20,0,6,0,0,5,9,0,0,0,0,0,8,1
270530001013003,6,Shingle Creek,1,1,1000000US270530001013003,"Block 3003, Block Group 3, Census Tract 1.01, Hennepin County, Minnesota",41,25,10,0,2,0,0,4,41,40,25,9,0,2,0,0,4,1,0,1,0,0,0,0,0
270530001011018,6,Shingle Creek,1,1,1000000US270530001011018,"Block 1018, Block Group 1, Census Tract 1.01, Hennepin County, Minnesota",0,0,0,0,0,0,0,0,0,0,0,0,0,0,0,0,0,0,0,0,0,0,0,0,0
270530001013005,6,Shingle Creek,1,1,1000000US270530001013005,"Block 3005, Block Group 3, Census Tract 1.01, Hennepin County, Minnesota",55,27,11,0,12,0,0,5,55,51,26,11,0,12,0,0,2,4,1,0,0,0,0,0,3
270530001013006,6,Shingle Creek,1,1,1000000US270530001013006,"Block 3006, Block Group 3, Census Tract 1.01, Hennepin County, Minnesota",55,22,12,0,15,0,4,2,55,51,22,12,0,15,0,0,2,4,0,0,0,0,0,4,0
270530001013011,6,Shingle Creek,1,1,1000000US270530001013011,"Block 3011, Block Group 3, Census Tract 1.01, Hennepin County, Minnesota",59,33,15,0,5,0,0,6,59,56,30,15,0,5,0,0,6,3,3,0,0,0,0,0,0
270530001014006,6,Shingle Creek,1,1,1000000US270530001014006,"Block 4006, Block Group 4, Census Tract 1.01, Hennepin County, Minnesota",80,40,17,3,5,0,14,1,80,66,40,17,3,5,0,0,1,14,0,0,0,0,0,14,0
270530001014002,6,Shingle Creek,1,1,1000000US270530001014002,"Block 4002, Block Group 4, Census Tract 1.01, Hennepin County, Minnesota",47,34,3,1,8,0,0,1,47,46,34,3,0,8,0,0,1,1,0,0,1,0,0,0,0
270530001014001,6,Shingle Creek,1,1,1000000US270530001014001,"Block 4001, Block Group 4, Census Tract 1.01, Hennepin County, Minnesota",78,27,11,0,33,0,4,3,78,70,22,11,0,33,0,1,3,8,5,0,0,0,0,3,0
270530001011005,6,Shingle Creek,1,1,1000000US270530001011005,"Block 1005, Block Group 1, Census Tract 1.01, Hennepin County, Minnesota",58,24,27,0,6,0,0,1,58,48,14,27,0,6,0,0,1,10,10,0,0,0,0,0,0
270530001012003,6,Shingle Creek,1,1,1000000US270530001012003,"Block 2003, Block Group 2, Census Tract 1.01, Hennepin County, Minnesota",62,37,12,6,0,0,0,7,62,62,37,12,6,0,0,0,7,0,0,0,0,0,0,0,0
270530001011003,6,Shingle Creek,1,1,1000000US270530001011003,"Block 1003, Block Group 1, Census Tract 1.01, Hennepin County, Minnesota",53,20,16,2,14,0,0,1,53,53,20,16,2,14,0,0,1,0,0,0,0,0,0,0,0
270530001011012,6,Shingle Creek,1,1,1000000US270530001011012,"Block 1012, Block Group 1, Census Tract 1.01, Hennepin County, Minnesota",87,33,16,1,22,0,4,11,87,73,33,16,1,22,0,0,1,14,0,0,0,0,0,4,10
270530001011000,6,Shingle Creek,1,1,1000000US270530001011000,"Block 1000, Block Group 1, Census Tract 1.01, Hennepin County, Minnesota",74,40,13,0,7,0,8,6,74,63,37,13,0,7,0,0,6,11,3,0,0,0,0,8,0
270530001011014,6,Shingle Creek,1,1,1000000US270530001011014,"Block 1014, Block Group 1, Census Tract 1.01, Hennepin County, Minnesota",0,0,0,0,0,0,0,0,0,0,0,0,0,0,0,0,0,0,0,0,0,0,0,0,0
270530001011004,6,Shingle Creek,1,1,1000000US270530001011004,"Block 1004, Block Group 1, Census Tract 1.01, Hennepin County, Minnesota",60,17,26,0,11,0,0,6,60,60,17,26,0,11,0,0,6,0,0,0,0,0,0,0,0
270530001012010,6,Shingle Creek,1,1,1000000US270530001012010,"Block 2010, Block Group 2, Census Tract 1.01, Hennepin County, Minnesota",47,39,7,0,0,0,1,0,47,41,34,7,0,0,0,0,0,6,5,0,0,0,0,1,0
270530001012008,6,Shingle Creek,1,1,1000000US270530001012008,"Block 2008, Block Group 2, Census Tract 1.01, Hennepin County, Minnesota",52,34,16,1,0,0,0,1,52,46,28,16,1,0,0,0,1,6,6,0,0,0,0,0,0
270530001012005,6,Shingle Creek,1,1,1000000US270530001012005,"Block 2005, Block Group 2, Census Tract 1.01, Hennepin County, Minnesota",42,29,5,0,0,0,0,8,42,41,28,5,0,0,0,0,8,1,1,0,0,0,0,0,0
270530001011001,6,Shingle Creek,1,1,1000000US270530001011001,"Block 1001, Block Group 1, Census Tract 1.01, Hennepin County, Minnesota",99,31,25,1,18,0,13,11,99,77,24,25,1,18,0,0,9,22,7,0,0,0,0,13,2
270530001011016,6,Shingle Creek,1,1,1000000US270530001011016,"Block 1016, Block Group 1, Census Tract 1.01, Hennepin County, Minnesota",88,26,45,0,4,0,3,10,88,81,26,45,0,4,0,0,6,7,0,0,0,0,0,3,4
270530001011020,6,Shingle Creek,1,1,1000000US270530001011020,"Block 1020, Block Group 1, Census Tract 1.01, Hennepin County, Minnesota",0,0,0,0,0,0,0,0,0,0,0,0,0,0,0,0,0,0,0,0,0,0,0,0,0
270530001011021,6,Shingle Creek,1,1,1000000US270530001011021,"Block 1021, Block Group 1, Census Tract 1.01, Hennepin County, Minnesota",0,0,0,0,0,0,0,0,0,0,0,0,0,0,0,0,0,0,0,0,0,0,0,0,0
270530001011013,6,Shingle Creek,1,1,1000000US270530001011013,"Block 1013, Block Group 1, Census Tract 1.01, Hennepin County, Minnesota",76,12,39,0,19,0,2,4,76,72,12,37,0,19,0,0,4,4,0,2,0,0,0,2,0
270530001012001,6,Shingle Creek,1,1,1000000US270530001012001,"Block 2001, Block Group 2, Census Tract 1.01, Hennepin County, Minnesota",51,24,9,0,14,0,0,4,51,50,23,9,0,14,0,0,4,1,1,0,0,0,0,0,0
270530001011008,6,Shingle Creek,1,1,1000000US270530001011008,"Block 1008, Block Group 1, Census Tract 1.01, Hennepin County, Minnesota",45,23,17,0,4,0,1,0,45,44,23,17,0,4,0,0,0,1,0,0,0,0,0,1,0
270530001013012,6,Shingle Creek,1,1,1000000US270530001013012,"Block 3012, Block Group 3, Census Tract 1.01, Hennepin County, Minnesota",37,36,0,0,0,0,0,1,37,37,36,0,0,0,0,0,1,0,0,0,0,0,0,0,0
270530001011011,6,Shingle Creek,1,1,1000000US270530001011011,"Block 1011, Block Group 1, Census Tract 1.01, Hennepin County, Minnesota",65,44,15,0,3,0,0,3,65,56,35,15,0,3,0,0,3,9,9,0,0,0,0,0,0
270530001012011,6,Shingle Creek,1,1,1000000US270530001012011,"Block 2011, Block Group 2, Census Tract 1.01, Hennepin County, Minnesota",64,14,14,0,25,0,11,0,64,53,14,14,0,25,0,0,0,11,0,0,0,0,0,11,0
270530001013014,6,Shingle Creek,1,1,1000000US270530001013014,"Block 3014, Block Group 3, Census Tract 1.01, Hennepin County, Minnesota",48,25,11,0,4,0,8,0,48,39,21,11,0,4,0,3,0,9,4,0,0,0,0,5,0
270530001013010,6,Shingle Creek,1,1,1000000US270530001013010,"Block 3010, Block Group 3, Census Tract 1.01, Hennepin County, Minnesota",52,30,6,0,13,0,2,1,52,51,29,6,0,13,0,2,1,1,1,0,0,0,0,0,0
270530001011007,6,Shingle Creek,1,1,1000000US270530001011007,"Block 1007, Block Group 1, Census Tract 1.01, Hennepin County, Minnesota",46,20,21,0,0,0,0,5,46,41,20,21,0,0,0,0,0,5,0,0,0,0,0,0,5
270530001011006,6,Shingle Creek,1,1,1000000US270530001011006,"Block 1006, Block Group 1, Census Tract 1.01, Hennepin County, Minnesota",73,27,14,2,26,0,4,0,73,66,24,14,2,26,0,0,0,7,3,0,0,0,0,4,0
270530001012007,6,Shingle Creek,1,1,1000000US270530001012007,"Block 2007, Block Group 2, Census Tract 1.01, Hennepin County, Minnesota",88,30,26,5,23,0,0,4,88,82,24,26,5,23,0,0,4,6,6,0,0,0,0,0,0
270530001012006,6,Shingle Creek,1,1,1000000US270530001012006,"Block 2006, Block Group 2, Census Tract 1.01, Hennepin County, Minnesota",0,0,0,0,0,0,0,0,0,0,0,0,0,0,0,0,0,0,0,0,0,0,0,0,0
270530001013004,6,Shingle Creek,1,1,1000000US270530001013004,"Block 3004, Block Group 3, Census Tract 1.01, Hennepin County, Minnesota",59,24,11,0,5,0,18,1,59,41,24,11,0,5,0,0,1,18,0,0,0,0,0,18,0
270530001012009,6,Shingle Creek,1,1,1000000US270530001012009,"Block 2009, Block Group 2, Census Tract 1.01, Hennepin County, Minnesota",64,24,17,0,18,0,2,3,64,59,24,17,0,18,0,0,0,5,0,0,0,0,0,2,3
270530001012004,6,Shingle Creek,1,1,1000000US270530001012004,"Block 2004, Block Group 2, Census Tract 1.01, Hennepin County, Minnesota",77,21,23,11,16,0,0,6,77,69,14,22,11,16,0,0,6,8,7,1,0,0,0,0,0
270530001011002,6,Shingle Creek,1,1,1000000US270530001011002,"Block 1002, Block Group 1, Census Tract 1.01, Hennepin County, Minnesota",54,28,5,5,7,0,2,7,54,49,25,5,5,7,0,0,7,5,3,0,0,0,0,2,0
270530001014000,6,Shingle Creek,1,1,1000000US270530001014000,"Block 4000, Block Group 4, Census Tract 1.01, Hennepin County, Minnesota",121,67,11,0,25,0,8,10,121,105,64,11,0,23,0,0,7,16,3,0,0,2,0,8,3
270530001013009,6,Shingle Creek,1,1,1000000US270530001013009,"Block 3009, Block Group 3, Census Tract 1.01, Hennepin County, Minnesota",75,48,12,0,7,0,5,3,75,62,40,12,0,7,0,0,3,13,8,0,0,0,0,5,0
270530001021005,7,Lind - Bohanon,2,2,1000000US270530001021005,"Block 1005, Block Group 1, Census Tract 1.02, Hennepin County, Minnesota",88,73,10,5,0,0,0,0,88,88,73,10,5,0,0,0,0,0,0,0,0,0,0,0,0
270530001022009,7,Lind - Bohanon,2,2,1000000US270530001022009,"Block 2009, Block Group 2, Census Tract 1.02, Hennepin County, Minnesota",0,0,0,0,0,0,0,0,0,0,0,0,0,0,0,0,0,0,0,0,0,0,0,0,0
270530001022008,7,Lind - Bohanon,2,2,1000000US270530001022008,"Block 2008, Block Group 2, Census Tract 1.02, Hennepin County, Minnesota",7,7,0,0,0,0,0,0,7,7,7,0,0,0,0,0,0,0,0,0,0,0,0,0,0
270530001021010,7,Lind - Bohanon,2,2,1000000US270530001021010,"Block 1010, Block Group 1, Census Tract 1.02, Hennepin County, Minnesota",112,10,51,0,40,0,4,7,112,108,10,51,0,40,0,0,7,4,0,0,0,0,0,4,0
270530001025006,7,Lind - Bohanon,2,2,1000000US270530001025006,"Block 5006, Block Group 5, Census Tract 1.02, Hennepin County, Minnesota",87,27,24,1,24,0,0,11,87,79,24,24,0,24,0,0,7,8,3,0,1,0,0,0,4
270530001025004,7,Lind - Bohanon,2,2,1000000US270530001025004,"Block 5004, Block Group 5, Census Tract 1.02, Hennepin County, Minnesota",117,62,19,7,17,0,1,11,117,116,62,19,7,17,0,0,11,1,0,0,0,0,0,1,0
270530001024002,7,Lind - Bohanon,2,2,1000000US270530001024002,"Block 4002, Block Group 4, Census Tract 1.02, Hennepin County, Minnesota",0,0,0,0,0,0,0,0,0,0,0,0,0,0,0,0,0,0,0,0,0,0,0,0,0
270530001023011,7,Lind - Bohanon,2,2,1000000US270530001023011,"Block 3011, Block Group 3, Census Tract 1.02, Hennepin County, Minnesota",71,44,18,0,5,0,1,3,71,66,40,18,0,5,0,0,3,5,4,0,0,0,0,1,0
270530001022006,7,Lind - Bohanon,2,2,1000000US270530001022006,"Block 2006, Block Group 2, Census Tract 1.02, Hennepin County, Minnesota",102,67,27,0,0,0,1,7,102,97,67,26,0,0,0,1,3,5,0,1,0,0,0,0,4
270530001022013,7,Lind - Bohanon,2,2,1000000US270530001022013,"Block 2013, Block Group 2, Census Tract 1.02, Hennepin County, Minnesota",61,17,36,0,8,0,0,0,61,61,17,36,0,8,0,0,0,0,0,0,0,0,0,0,0
270530001021024,7,Lind - Bohanon,2,2,1000000US270530001021024,"Block 1024, Block Group 1, Census Tract 1.02, Hennepin County, Minnesota",28,9,10,8,0,0,0,1,28,28,9,10,8,0,0,0,1,0,0,0,0,0,0,0,0
270530001023007,7,Lind - Bohanon,2,2,1000000US270530001023007,"Block 3007, Block Group 3, Census Tract 1.02, Hennepin County, Minnesota",57,39,11,1,4,0,0,2,57,56,39,11,0,4,0,0,2,1,0,0,1,0,0,0,0
270530001021001,7,Lind - Bohanon,2,2,1000000US270530001021001,"Block 1001, Block Group 1, Census Tract 1.02, Hennepin County, Minnesota",0,0,0,0,0,0,0,0,0,0,0,0,0,0,0,0,0,0,0,0,0,0,0,0,0
270530001025011,7,Lind - Bohanon,2,2,1000000US270530001025011,"Block 5011, Block Group 5, Census Tract 1.02, Hennepin County, Minnesota",60,36,5,1,15,0,0,3,60,57,35,5,1,15,0,0,1,3,1,0,0,0,0,0,2
270530001025001,7,Lind - Bohanon,2,2,1000000US270530001025001,"Block 5001, Block Group 5, Census Tract 1.02, Hennepin County, Minnesota",62,31,10,8,12,0,0,1,62,57,26,10,8,12,0,0,1,5,5,0,0,0,0,0,0
270530001024004,7,Lind - Bohanon,2,2,1000000US270530001024004,"Block 4004, Block Group 4, Census Tract 1.02, Hennepin County, Minnesota",48,27,14,1,0,0,5,1,48,41,25,14,1,0,0,0,1,7,2,0,0,0,0,5,0
270530001023009,7,Lind - Bohanon,2,2,1000000US270530001023009,"Block 3009, Block Group 3, Census Tract 1.02, Hennepin County, Minnesota",74,41,13,1,12,0,2,5,74,71,40,13,1,12,0,0,5,3,1,0,0,0,0,2,0
270530001023010,7,Lind - Bohanon,2,2,1000000US270530001023010,"Block 3010, Block Group 3, Census Tract 1.02, Hennepin County, Minnesota",36,25,9,0,0,0,0,2,36,35,24,9,0,0,0,0,2,1,1,0,0,0,0,0,0
270530001025013,7,Lind - Bohanon,2,2,1000000US270530001025013,"Block 5013, Block Group 5, Census Tract 1.02, Hennepin County, Minnesota",70,33,25,2,9,0,0,1,70,70,33,25,2,9,0,0,1,0,0,0,0,0,0,0,0
270530001021007,7,Lind - Bohanon,2,2,1000000US270530001021007,"Block 1007, Block Group 1, Census Tract 1.02, Hennepin County, Minnesota",75,29,18,0,18,0,10,0,75,65,29,18,0,18,0,0,0,10,0,0,0,0,0,10,0
270530001024000,7,Lind - Bohanon,2,2,1000000US270530001024000,"Block 4000, Block Group 4, Census Tract 1.02, Hennepin County, Minnesota",61,37,17,0,6,0,0,1,61,61,37,17,0,6,0,0,1,0,0,0,0,0,0,0,0
270530001023013,7,Lind - Bohanon,2,2,1000000US270530001023013,"Block 3013, Block Group 3, Census Tract 1.02, Hennepin County, Minnesota",76,32,21,4,0,0,11,8,76,62,32,21,4,0,0,0,5,14,0,0,0,0,0,11,3
270530001023015,7,Lind - Bohanon,2,2,1000000US270530001023015,"Block 3015, Block Group 3, Census Tract 1.02, Hennepin County, Minnesota",66,26,27,6,1,0,0,6,66,57,22,27,2,1,0,0,5,9,4,0,4,0,0,0,1
270530001021002,7,Lind - Bohanon,2,2,1000000US270530001021002,"Block 1002, Block Group 1, Census Tract 1.02, Hennepin County, Minnesota",0,0,0,0,0,0,0,0,0,0,0,0,0,0,0,0,0,0,0,0,0,0,0,0,0
270530001024008,7,Lind - Bohanon,2,2,1000000US270530001024008,"Block 4008, Block Group 4, Census Tract 1.02, Hennepin County, Minnesota",50,23,27,0,0,0,0,0,50,49,22,27,0,0,0,0,0,1,1,0,0,0,0,0,0
270530001024009,7,Lind - Bohanon,2,2,1000000US270530001024009,"Block 4009, Block Group 4, Census Tract 1.02, Hennepin County, Minnesota",50,27,16,0,3,0,0,4,50,38,15,16,0,3,0,0,4,12,12,0,0,0,0,0,0
270530001021003,7,Lind - Bohanon,2,2,1000000US270530001021003,"Block 1003, Block Group 1, Census Tract 1.02, Hennepin County, Minnesota",74,22,18,0,27,0,6,1,74,67,21,18,0,27,0,0,1,7,1,0,0,0,0,6,0
270530001021006,7,Lind - Bohanon,2,2,1000000US270530001021006,"Block 1006, Block Group 1, Census Tract 1.02, Hennepin County, Minnesota",63,36,14,6,5,0,0,2,63,62,35,14,6,5,0,0,2,1,1,0,0,0,0,0,0
270530001024012,7,Lind - Bohanon,2,2,1000000US270530001024012,"Block 4012, Block Group 4, Census Tract 1.02, Hennepin County, Minnesota",78,47,13,1,11,0,0,6,78,74,47,11,0,11,0,0,5,4,0,2,1,0,0,0,1
270530001021011,7,Lind - Bohanon,2,2,1000000US270530001021011,"Block 1011, Block Group 1, Census Tract 1.02, Hennepin County, Minnesota",52,21,23,0,2,0,0,6,52,50,21,23,0,2,0,0,4,2,0,0,0,0,0,0,2
270530001021022,7,Lind - Bohanon,2,2,1000000US270530001021022,"Block 1022, Block Group 1, Census Tract 1.02, Hennepin County, Minnesota",71,21,30,0,3,0,15,2,71,56,21,30,0,3,0,0,2,15,0,0,0,0,0,15,0
270530001021017,7,Lind - Bohanon,2,2,1000000US270530001021017,"Block 1017, Block Group 1, Census Tract 1.02, Hennepin County, Minnesota",30,3,25,0,0,0,0,2,30,30,3,25,0,0,0,0,2,0,0,0,0,0,0,0,0
270530001022007,7,Lind - Bohanon,2,2,1000000US270530001022007,"Block 2007, Block Group 2, Census Tract 1.02, Hennepin County, Minnesota",7,7,0,0,0,0,0,0,7,3,3,0,0,0,0,0,0,4,4,0,0,0,0,0,0
270530001022016,7,Lind - Bohanon,2,2,1000000US270530001022016,"Block 2016, Block Group 2, Census Tract 1.02, Hennepin County, Minnesota",72,10,38,2,15,0,2,5,72,70,10,38,2,15,0,0,5,2,0,0,0,0,0,2,0
270530001024005,7,Lind - Bohanon,2,2,1000000US270530001024005,"Block 4005, Block Group 4, Census Tract 1.02, Hennepin County, Minnesota",73,26,30,0,4,0,4,9,73,63,19,30,0,4,0,1,9,10,7,0,0,0,0,3,0
270530001021013,7,Lind - Bohanon,2,2,1000000US270530001021013,"Block 1013, Block Group 1, Census Tract 1.02, Hennepin County, Minnesota",82,34,32,0,4,0,8,4,82,64,28,31,0,4,0,0,1,18,6,1,0,0,0,8,3
270530001022002,7,Lind - Bohanon,2,2,1000000US270530001022002,"Block 2002, Block Group 2, Census Tract 1.02, Hennepin County, Minnesota",79,21,39,1,14,0,0,4,79,79,21,39,1,14,0,0,4,0,0,0,0,0,0,0,0
270530001025009,7,Lind - Bohanon,2,2,1000000US270530001025009,"Block 5009, Block Group 5, Census Tract 1.02, Hennepin County, Minnesota",52,26,15,0,5,0,0,6,52,51,25,15,0,5,0,0,6,1,1,0,0,0,0,0,0
270530001025003,7,Lind - Bohanon,2,2,1000000US270530001025003,"Block 5003, Block Group 5, Census Tract 1.02, Hennepin County, Minnesota",68,37,21,1,6,0,3,0,68,65,37,21,1,6,0,0,0,3,0,0,0,0,0,3,0
270530001025012,7,Lind - Bohanon,2,2,1000000US270530001025012,"Block 5012, Block Group 5, Census Tract 1.02, Hennepin County, Minnesota",79,28,33,1,4,0,13,0,79,65,27,33,1,4,0,0,0,14,1,0,0,0,0,13,0
270530001023012,7,Lind - Bohanon,2,2,1000000US270530001023012,"Block 3012, Block Group 3, Census Tract 1.02, Hennepin County, Minnesota",63,34,9,0,5,0,6,9,63,56,33,9,0,5,0,0,9,7,1,0,0,0,0,6,0
270530001021008,7,Lind - Bohanon,2,2,1000000US270530001021008,"Block 1008, Block Group 1, Census Tract 1.02, Hennepin County, Minnesota",71,47,8,1,12,0,3,0,71,64,43,8,1,12,0,0,0,7,4,0,0,0,0,3,0
270530001024011,7,Lind - Bohanon,2,2,1000000US270530001024011,"Block 4011, Block Group 4, Census Tract 1.02, Hennepin County, Minnesota",65,45,11,0,2,0,1,6,65,56,41,11,0,2,0,0,2,9,4,0,0,0,0,1,4
270530001023000,7,Lind - Bohanon,2,2,1000000US270530001023000,"Block 3000, Block Group 3, Census Tract 1.02, Hennepin County, Minnesota",66,26,25,0,8,0,0,7,66,66,26,25,0,8,0,0,7,0,0,0,0,0,0,0,0
270530001022003,7,Lind - Bohanon,2,2,1000000US270530001022003,"Block 2003, Block Group 2, Census Tract 1.02, Hennepin County, Minnesota",62,38,16,0,0,0,8,0,62,54,38,16,0,0,0,0,0,8,0,0,0,0,0,8,0
270530001022000,7,Lind - Bohanon,2,2,1000000US270530001022000,"Block 2000, Block Group 2, Census Tract 1.02, Hennepin County, Minnesota",69,36,20,0,6,0,2,5,69,63,32,20,0,6,0,0,5,6,4,0,0,0,0,2,0
270530001023006,7,Lind - Bohanon,2,2,1000000US270530001023006,"Block 3006, Block Group 3, Census Tract 1.02, Hennepin County, Minnesota",47,27,17,0,0,0,0,3,47,47,27,17,0,0,0,0,3,0,0,0,0,0,0,0,0
270530001023004,7,Lind - Bohanon,2,2,1000000US270530001023004,"Block 3004, Block Group 3, Census Tract 1.02, Hennepin County, Minnesota",73,43,13,4,5,0,4,4,73,72,43,12,4,5,0,4,4,1,0,1,0,0,0,0,0
270530001025015,7,Lind - Bohanon,2,2,1000000US270530001025015,"Block 5015, Block Group 5, Census Tract 1.02, Hennepin County, Minnesota",67,21,19,0,11,0,12,4,67,51,18,19,0,11,0,0,3,16,3,0,0,0,0,12,1
270530001023014,7,Lind - Bohanon,2,2,1000000US270530001023014,"Block 3014, Block Group 3, Census Tract 1.02, Hennepin County, Minnesota",57,32,15,2,4,0,0,4,57,48,25,15,2,4,0,0,2,9,7,0,0,0,0,0,2
270530001021014,7,Lind - Bohanon,2,2,1000000US270530001021014,"Block 1014, Block Group 1, Census Tract 1.02, Hennepin County, Minnesota",83,32,24,0,16,0,8,3,83,70,28,23,0,16,0,0,3,13,4,1,0,0,0,8,0
270530001022011,7,Lind - Bohanon,2,2,1000000US270530001022011,"Block 2011, Block Group 2, Census Tract 1.02, Hennepin County, Minnesota",49,19,23,3,0,0,4,0,49,41,17,21,3,0,0,0,0,8,2,2,0,0,0,4,0
270530001022012,7,Lind - Bohanon,2,2,1000000US270530001022012,"Block 2012, Block Group 2, Census Tract 1.02, Hennepin County, Minnesota",60,32,20,1,4,0,0,3,60,52,26,18,1,4,0,0,3,8,6,2,0,0,0,0,0
270530001022001,7,Lind - Bohanon,2,2,1000000US270530001022001,"Block 2001, Block Group 2, Census Tract 1.02, Hennepin County, Minnesota",69,25,27,1,0,0,4,12,69,64,24,27,1,0,0,0,12,5,1,0,0,0,0,4,0
270530001021023,7,Lind - Bohanon,2,2,1000000US270530001021023,"Block 1023, Block Group 1, Census Tract 1.02, Hennepin County, Minnesota",193,47,86,15,19,0,6,20,193,180,46,82,15,19,0,0,18,13,1,4,0,0,0,6,2
270530001022005,7,Lind - Bohanon,2,2,1000000US270530001022005,"Block 2005, Block Group 2, Census Tract 1.02, Hennepin County, Minnesota",48,37,7,0,0,0,4,0,48,44,37,7,0,0,0,0,0,4,0,0,0,0,0,4,0
270530001021000,7,Lind - Bohanon,2,2,1000000US270530001021000,"Block 1000, Block Group 1, Census Tract 1.02, Hennepin County, Minnesota",0,0,0,0,0,0,0,0,0,0,0,0,0,0,0,0,0,0,0,0,0,0,0,0,0
270530001025000,7,Lind - Bohanon,2,2,1000000US270530001025000,"Block 5000, Block Group 5, Census Tract 1.02, Hennepin County, Minnesota",58,34,12,1,10,0,0,1,58,57,33,12,1,10,0,0,1,1,1,0,0,0,0,0,0
270530001025007,7,Lind - Bohanon,2,2,1000000US270530001025007,"Block 5007, Block Group 5, Census Tract 1.02, Hennepin County, Minnesota",81,36,33,0,5,0,0,7,81,80,35,33,0,5,0,0,7,1,1,0,0,0,0,0,0
270530001025008,7,Lind - Bohanon,2,2,1000000US270530001025008,"Block 5008, Block Group 5, Census Tract 1.02, Hennepin County, Minnesota",64,34,24,0,2,0,0,4,64,62,34,22,0,2,0,0,4,2,0,2,0,0,0,0,0
270530001023008,7,Lind - Bohanon,2,2,1000000US270530001023008,"Block 3008, Block Group 3, Census Tract 1.02, Hennepin County, Minnesota",48,33,11,2,0,0,0,2,48,48,33,11,2,0,0,0,2,0,0,0,0,0,0,0,0
270530001025005,7,Lind - Bohanon,2,2,1000000US270530001025005,"Block 5005, Block Group 5, Census Tract 1.02, Hennepin County, Minnesota",70,41,16,1,3,0,6,3,70,63,40,16,1,3,0,0,3,7,1,0,0,0,0,6,0
270530001023005,7,Lind - Bohanon,2,2,1000000US270530001023005,"Block 3005, Block Group 3, Census Tract 1.02, Hennepin County, Minnesota",49,29,16,0,4,0,0,0,49,49,29,16,0,4,0,0,0,0,0,0,0,0,0,0,0
270530001023002,7,Lind - Bohanon,2,2,1000000US270530001023002,"Block 3002, Block Group 3, Census Tract 1.02, Hennepin County, Minnesota",61,49,4,0,3,0,4,1,61,56,48,4,0,3,0,0,1,5,1,0,0,0,0,4,0
270530001025014,7,Lind - Bohanon,2,2,1000000US270530001025014,"Block 5014, Block Group 5, Census Tract 1.02, Hennepin County, Minnesota",60,25,18,1,4,0,6,6,60,50,24,17,1,4,0,0,4,10,1,1,0,0,0,6,2
270530001021009,7,Lind - Bohanon,2,2,1000000US270530001021009,"Block 1009, Block Group 1, Census Tract 1.02, Hennepin County, Minnesota",21,6,4,0,9,0,2,0,21,16,3,4,0,9,0,0,0,5,3,0,0,0,0,2,0
270530001024001,7,Lind - Bohanon,2,2,1000000US270530001024001,"Block 4001, Block Group 4, Census Tract 1.02, Hennepin County, Minnesota",56,31,9,0,5,0,0,11,56,51,30,5,0,5,0,0,11,5,1,4,0,0,0,0,0
270530001023001,7,Lind - Bohanon,2,2,1000000US270530001023001,"Block 3001, Block Group 3, Census Tract 1.02, Hennepin County, Minnesota",55,32,7,3,7,0,2,4,55,48,28,6,3,7,0,0,4,7,4,1,0,0,0,2,0
270530001021012,7,Lind - Bohanon,2,2,1000000US270530001021012,"Block 1012, Block Group 1, Census Tract 1.02, Hennepin County, Minnesota",61,11,14,6,19,0,9,2,61,50,11,13,6,19,0,0,1,11,0,1,0,0,0,9,1
270530001022017,7,Lind - Bohanon,2,2,1000000US270530001022017,"Block 2017, Block Group 2, Census Tract 1.02, Hennepin County, Minnesota",0,0,0,0,0,0,0,0,0,0,0,0,0,0,0,0,0,0,0,0,0,0,0,0,0
270530001022015,7,Lind - Bohanon,2,2,1000000US270530001022015,"Block 2015, Block Group 2, Census Tract 1.02, Hennepin County, Minnesota",0,0,0,0,0,0,0,0,0,0,0,0,0,0,0,0,0,0,0,0,0,0,0,0,0
270530001022014,7,Lind - Bohanon,2,2,1000000US270530001022014,"Block 2014, Block Group 2, Census Tract 1.02, Hennepin County, Minnesota",64,23,33,0,5,0,0,3,64,62,22,33,0,5,0,0,2,2,1,0,0,0,0,0,1
270530001025002,7,Lind - Bohanon,2,2,1000000US270530001025002,"Block 5002, Block Group 5, Census Tract 1.02, Hennepin County, Minnesota",55,45,5,0,2,0,0,3,55,52,42,5,0,2,0,0,3,3,3,0,0,0,0,0,0
270530001022010,7,Lind - Bohanon,2,2,1000000US270530001022010,"Block 2010, Block Group 2, Census Tract 1.02, Hennepin County, Minnesota",11,6,3,0,0,0,1,1,11,10,6,3,0,0,0,1,0,1,0,0,0,0,0,0,1
270530001025010,7,Lind - Bohanon,2,2,1000000US270530001025010,"Block 5010, Block Group 5, Census Tract 1.02, Hennepin County, Minnesota",8,0,7,0,1,0,0,0,8,8,0,7,0,1,0,0,0,0,0,0,0,0,0,0,0
270530001024003,7,Lind - Bohanon,2,2,1000000US270530001024003,"Block 4003, Block Group 4, Census Tract 1.02, Hennepin County, Minnesota",35,23,4,0,5,0,0,3,35,35,23,4,0,5,0,0,3,0,0,0,0,0,0,0,0
270530001024010,7,Lind - Bohanon,2,2,1000000US270530001024010,"Block 4010, Block Group 4, Census Tract 1.02, Hennepin County, Minnesota",54,26,19,0,0,0,0,9,54,54,26,19,0,0,0,0,9,0,0,0,0,0,0,0,0
270530001023003,7,Lind - Bohanon,2,2,1000000US270530001023003,"Block 3003, Block Group 3, Census Tract 1.02, Hennepin County, Minnesota",57,47,10,0,0,0,0,0,57,57,47,10,0,0,0,0,0,0,0,0,0,0,0,0,0
270530001021004,7,Lind - Bohanon,2,2,1000000US270530001021004,"Block 1004, Block Group 1, Census Tract 1.02, Hennepin County, Minnesota",36,8,4,0,24,0,0,0,36,34,6,4,0,24,0,0,0,2,2,0,0,0,0,0,0
270530001022004,7,Lind - Bohanon,2,2,1000000US270530001022004,"Block 2004, Block Group 2, Census Tract 1.02, Hennepin County, Minnesota",66,34,19,0,9,0,0,4,66,65,33,19,0,9,0,0,4,1,1,0,0,0,0,0,0
270530001024007,7,Lind - Bohanon,2,2,1000000US270530001024007,"Block 4007, Block Group 4, Census Tract 1.02, Hennepin County, Minnesota",4,0,4,0,0,0,0,0,4,4,0,4,0,0,0,0,0,0,0,0,0,0,0,0,0
270530001024006,7,Lind - Bohanon,2,2,1000000US270530001024006,"Block 4006, Block Group 4, Census Tract 1.02, Hennepin County, Minnesota",15,8,0,0,5,0,1,1,15,14,8,0,0,5,0,0,1,1,0,0,0,0,0,1,0
270531002002025,8,Webber - Camden,4,4,1000000US270531002002025,"Block 2025, Block Group 2, Census Tract 1002, Hennepin County, Minnesota",91,22,54,0,11,0,4,0,91,83,22,50,0,11,0,0,0,8,0,4,0,0,0,4,0
270531004003005,8,Webber - Camden,4,4,1000000US270531004003005,"Block 3005, Block Group 3, Census Tract 1004, Hennepin County, Minnesota",56,42,11,1,2,0,0,0,56,54,40,11,1,2,0,0,0,2,2,0,0,0,0,0,0
270531002003011,8,Webber - Camden,4,4,1000000US270531002003011,"Block 3011, Block Group 3, Census Tract 1002, Hennepin County, Minnesota",86,33,29,3,7,0,8,6,86,76,33,29,3,7,0,0,4,10,0,0,0,0,0,8,2
270531002003003,8,Webber - Camden,4,4,1000000US270531002003003,"Block 3003, Block Group 3, Census Tract 1002, Hennepin County, Minnesota",39,21,18,0,0,0,0,0,39,39,21,18,0,0,0,0,0,0,0,0,0,0,0,0,0
270531002003006,8,Webber - Camden,4,4,1000000US270531002003006,"Block 3006, Block Group 3, Census Tract 1002, Hennepin County, Minnesota",14,5,6,3,0,0,0,0,14,14,5,6,3,0,0,0,0,0,0,0,0,0,0,0,0
270531004001008,8,Webber - Camden,4,4,1000000US270531004001008,"Block 1008, Block Group 1, Census Tract 1004, Hennepin County, Minnesota",135,19,80,0,30,0,0,6,135,133,17,80,0,30,0,0,6,2,2,0,0,0,0,0,0
270531004002004,8,Webber - Camden,4,4,1000000US270531004002004,"Block 2004, Block Group 2, Census Tract 1004, Hennepin County, Minnesota",90,31,42,2,7,0,0,8,90,86,31,39,1,7,0,0,8,4,0,3,1,0,0,0,0
270531004002003,8,Webber - Camden,4,4,1000000US270531004002003,"Block 2003, Block Group 2, Census Tract 1004, Hennepin County, Minnesota",62,32,24,0,3,0,0,3,62,51,24,23,0,3,0,0,1,11,8,1,0,0,0,0,2
270531004002002,8,Webber - Camden,4,4,1000000US270531004002002,"Block 2002, Block Group 2, Census Tract 1004, Hennepin County, Minnesota",86,33,51,0,0,0,2,0,86,80,29,51,0,0,0,0,0,6,4,0,0,0,0,2,0
270531004002009,8,Webber - Camden,4,4,1000000US270531004002009,"Block 2009, Block Group 2, Census Tract 1004, Hennepin County, Minnesota",52,38,5,0,7,0,0,2,52,46,33,5,0,7,0,0,1,6,5,0,0,0,0,0,1
270531004002011,8,Webber - Camden,4,4,1000000US270531004002011,"Block 2011, Block Group 2, Census Tract 1004, Hennepin County, Minnesota",93,44,30,0,15,0,0,4,93,85,36,30,0,15,0,0,4,8,8,0,0,0,0,0,0
270531004001015,8,Webber - Camden,4,4,1000000US270531004001015,"Block 1015, Block Group 1, Census Tract 1004, Hennepin County, Minnesota",65,29,27,0,0,0,1,8,65,60,28,27,0,0,0,0,5,5,1,0,0,0,0,1,3
270531002002008,8,Webber - Camden,4,4,1000000US270531002002008,"Block 2008, Block Group 2, Census Tract 1002, Hennepin County, Minnesota",0,0,0,0,0,0,0,0,0,0,0,0,0,0,0,0,0,0,0,0,0,0,0,0,0
270531002002019,8,Webber - Camden,4,4,1000000US270531002002019,"Block 2019, Block Group 2, Census Tract 1002, Hennepin County, Minnesota",0,0,0,0,0,0,0,0,0,0,0,0,0,0,0,0,0,0,0,0,0,0,0,0,0
270531004003013,8,Webber - Camden,4,4,1000000US270531004003013,"Block 3013, Block Group 3, Census Tract 1004, Hennepin County, Minnesota",77,28,17,4,19,0,5,4,77,70,28,17,2,19,0,0,4,7,0,0,2,0,0,5,0
270531002002015,8,Webber - Camden,4,4,1000000US270531002002015,"Block 2015, Block Group 2, Census Tract 1002, Hennepin County, Minnesota",30,23,4,0,0,0,0,3,30,27,20,4,0,0,0,0,3,3,3,0,0,0,0,0,0
270531002003002,8,Webber - Camden,4,4,1000000US270531002003002,"Block 3002, Block Group 3, Census Tract 1002, Hennepin County, Minnesota",235,72,136,4,14,0,0,9,235,235,72,136,4,14,0,0,9,0,0,0,0,0,0,0,0
270531004003012,8,Webber - Camden,4,4,1000000US270531004003012,"Block 3012, Block Group 3, Census Tract 1004, Hennepin County, Minnesota",67,39,21,0,0,0,2,5,67,62,36,21,0,0,0,0,5,5,3,0,0,0,0,2,0
270531002003010,8,Webber - Camden,4,4,1000000US270531002003010,"Block 3010, Block Group 3, Census Tract 1002, Hennepin County, Minnesota",73,30,40,0,0,0,0,3,73,73,30,40,0,0,0,0,3,0,0,0,0,0,0,0,0
270531002002001,8,Webber - Camden,4,4,1000000US270531002002001,"Block 2001, Block Group 2, Census Tract 1002, Hennepin County, Minnesota",37,23,6,3,0,0,4,1,37,33,23,6,3,0,0,0,1,4,0,0,0,0,0,4,0
270531002003013,8,Webber - Camden,4,4,1000000US270531002003013,"Block 3013, Block Group 3, Census Tract 1002, Hennepin County, Minnesota",60,40,16,0,0,0,0,4,60,56,38,16,0,0,0,0,2,4,2,0,0,0,0,0,2
270531002003014,8,Webber - Camden,4,4,1000000US270531002003014,"Block 3014, Block Group 3, Census Tract 1002, Hennepin County, Minnesota",95,47,35,3,0,0,8,2,95,85,44,35,3,0,0,1,2,10,3,0,0,0,0,7,0
270531004003009,8,Webber - Camden,4,4,1000000US270531004003009,"Block 3009, Block Group 3, Census Tract 1004, Hennepin County, Minnesota",88,19,48,0,6,0,0,15,88,82,19,43,0,6,0,0,14,6,0,5,0,0,0,0,1
270531004001004,8,Webber - Camden,4,4,1000000US270531004001004,"Block 1004, Block Group 1, Census Tract 1004, Hennepin County, Minnesota",45,7,20,0,18,0,0,0,45,45,7,20,0,18,0,0,0,0,0,0,0,0,0,0,0
270531004001003,8,Webber - Camden,4,4,1000000US270531004001003,"Block 1003, Block Group 1, Census Tract 1004, Hennepin County, Minnesota",0,0,0,0,0,0,0,0,0,0,0,0,0,0,0,0,0,0,0,0,0,0,0,0,0
270531002003012,8,Webber - Camden,4,4,1000000US270531002003012,"Block 3012, Block Group 3, Census Tract 1002, Hennepin County, Minnesota",87,36,39,0,9,0,1,2,87,85,35,39,0,9,0,0,2,2,1,0,0,0,0,1,0
270531004003016,8,Webber - Camden,4,4,1000000US270531004003016,"Block 3016, Block Group 3, Census Tract 1004, Hennepin County, Minnesota",46,22,9,1,9,0,4,1,46,42,22,9,1,9,0,0,1,4,0,0,0,0,0,4,0
270531004003001,8,Webber - Camden,4,4,1000000US270531004003001,"Block 3001, Block Group 3, Census Tract 1004, Hennepin County, Minnesota",45,15,26,4,0,0,0,0,45,45,15,26,4,0,0,0,0,0,0,0,0,0,0,0,0
270531004003007,8,Webber - Camden,4,4,1000000US270531004003007,"Block 3007, Block Group 3, Census Tract 1004, Hennepin County, Minnesota",58,29,20,1,1,0,0,7,58,53,28,20,0,1,0,0,4,5,1,0,1,0,0,0,3
270531002003005,8,Webber - Camden,4,4,1000000US270531002003005,"Block 3005, Block Group 3, Census Tract 1002, Hennepin County, Minnesota",0,0,0,0,0,0,0,0,0,0,0,0,0,0,0,0,0,0,0,0,0,0,0,0,0
270531004003003,8,Webber - Camden,4,4,1000000US270531004003003,"Block 3003, Block Group 3, Census Tract 1004, Hennepin County, Minnesota",60,16,29,1,10,0,0,4,60,56,16,29,1,10,0,0,0,4,0,0,0,0,0,0,4
270531004001009,8,Webber - Camden,4,4,1000000US270531004001009,"Block 1009, Block Group 1, Census Tract 1004, Hennepin County, Minnesota",15,12,0,3,0,0,0,0,15,15,12,0,3,0,0,0,0,0,0,0,0,0,0,0,0
270531004003006,8,Webber - Camden,4,4,1000000US270531004003006,"Block 3006, Block Group 3, Census Tract 1004, Hennepin County, Minnesota",0,0,0,0,0,0,0,0,0,0,0,0,0,0,0,0,0,0,0,0,0,0,0,0,0
270531004003017,8,Webber - Camden,4,4,1000000US270531004003017,"Block 3017, Block Group 3, Census Tract 1004, Hennepin County, Minnesota",85,22,32,4,21,0,5,1,85,83,22,32,4,21,0,4,0,2,0,0,0,0,0,1,1
270531004001007,8,Webber - Camden,4,4,1000000US270531004001007,"Block 1007, Block Group 1, Census Tract 1004, Hennepin County, Minnesota",97,21,44,0,0,0,24,8,97,74,19,44,0,0,0,3,8,23,2,0,0,0,0,21,0
270531002003000,8,Webber - Camden,4,4,1000000US270531002003000,"Block 3000, Block Group 3, Census Tract 1002, Hennepin County, Minnesota",0,0,0,0,0,0,0,0,0,0,0,0,0,0,0,0,0,0,0,0,0,0,0,0,0
270531004003004,8,Webber - Camden,4,4,1000000US270531004003004,"Block 3004, Block Group 3, Census Tract 1004, Hennepin County, Minnesota",79,22,41,0,9,0,0,7,79,78,22,41,0,9,0,0,6,1,0,0,0,0,0,0,1
270531002003007,8,Webber - Camden,4,4,1000000US270531002003007,"Block 3007, Block Group 3, Census Tract 1002, Hennepin County, Minnesota",0,0,0,0,0,0,0,0,0,0,0,0,0,0,0,0,0,0,0,0,0,0,0,0,0
270531002003016,8,Webber - Camden,4,4,1000000US270531002003016,"Block 3016, Block Group 3, Census Tract 1002, Hennepin County, Minnesota",75,23,44,2,0,0,0,6,75,68,20,43,2,0,0,0,3,7,3,1,0,0,0,0,3
270531002002016,8,Webber - Camden,4,4,1000000US270531002002016,"Block 2016, Block Group 2, Census Tract 1002, Hennepin County, Minnesota",44,19,9,0,16,0,0,0,44,44,19,9,0,16,0,0,0,0,0,0,0,0,0,0,0
270531002002021,8,Webber - Camden,4,4,1000000US270531002002021,"Block 2021, Block Group 2, Census Tract 1002, Hennepin County, Minnesota",74,37,33,0,0,0,1,3,74,74,37,33,0,0,0,1,3,0,0,0,0,0,0,0,0
270531002002023,8,Webber - Camden,4,4,1000000US270531002002023,"Block 2023, Block Group 2, Census Tract 1002, Hennepin County, Minnesota",79,38,22,1,10,0,4,4,79,74,38,21,1,10,0,0,4,5,0,1,0,0,0,4,0
270531004002005,8,Webber - Camden,4,4,1000000US270531004002005,"Block 2005, Block Group 2, Census Tract 1004, Hennepin County, Minnesota",52,26,16,1,0,0,5,4,52,47,26,16,1,0,0,0,4,5,0,0,0,0,0,5,0
270531004002007,8,Webber - Camden,4,4,1000000US270531004002007,"Block 2007, Block Group 2, Census Tract 1004, Hennepin County, Minnesota",66,12,28,0,23,0,1,2,66,66,12,28,0,23,0,1,2,0,0,0,0,0,0,0,0
270531004002008,8,Webber - Camden,4,4,1000000US270531004002008,"Block 2008, Block Group 2, Census Tract 1004, Hennepin County, Minnesota",68,20,36,0,12,0,0,0,68,59,11,36,0,12,0,0,0,9,9,0,0,0,0,0,0
270531004002010,8,Webber - Camden,4,4,1000000US270531004002010,"Block 2010, Block Group 2, Census Tract 1004, Hennepin County, Minnesota",66,27,23,0,6,0,2,8,66,60,26,22,0,6,0,0,6,6,1,1,0,0,0,2,2
270531004001018,8,Webber - Camden,4,4,1000000US270531004001018,"Block 1018, Block Group 1, Census Tract 1004, Hennepin County, Minnesota",107,45,35,0,6,0,17,4,107,89,44,35,0,6,0,1,3,18,1,0,0,0,0,16,1
270531004003011,8,Webber - Camden,4,4,1000000US270531004003011,"Block 3011, Block Group 3, Census Tract 1004, Hennepin County, Minnesota",22,15,2,0,1,0,0,4,22,22,15,2,0,1,0,0,4,0,0,0,0,0,0,0,0
270531002002011,8,Webber - Camden,4,4,1000000US270531002002011,"Block 2011, Block Group 2, Census Tract 1002, Hennepin County, Minnesota",0,0,0,0,0,0,0,0,0,0,0,0,0,0,0,0,0,0,0,0,0,0,0,0,0
270531004002000,8,Webber - Camden,4,4,1000000US270531004002000,"Block 2000, Block Group 2, Census Tract 1004, Hennepin County, Minnesota",86,30,23,1,11,0,11,10,86,78,30,23,1,11,0,3,10,8,0,0,0,0,0,8,0
270531004001010,8,Webber - Camden,4,4,1000000US270531004001010,"Block 1010, Block Group 1, Census Tract 1004, Hennepin County, Minnesota",46,5,18,9,3,0,11,0,46,35,5,18,9,3,0,0,0,11,0,0,0,0,0,11,0
270531002002003,8,Webber - Camden,4,4,1000000US270531002002003,"Block 2003, Block Group 2, Census Tract 1002, Hennepin County, Minnesota",58,23,6,0,22,0,0,7,58,58,23,6,0,22,0,0,7,0,0,0,0,0,0,0,0
270531002002009,8,Webber - Camden,4,4,1000000US270531002002009,"Block 2009, Block Group 2, Census Tract 1002, Hennepin County, Minnesota",0,0,0,0,0,0,0,0,0,0,0,0,0,0,0,0,0,0,0,0,0,0,0,0,0
270531002002012,8,Webber - Camden,4,4,1000000US270531002002012,"Block 2012, Block Group 2, Census Tract 1002, Hennepin County, Minnesota",0,0,0,0,0,0,0,0,0,0,0,0,0,0,0,0,0,0,0,0,0,0,0,0,0
270531004003014,8,Webber - Camden,4,4,1000000US270531004003014,"Block 3014, Block Group 3, Census Tract 1004, Hennepin County, Minnesota",44,28,15,0,0,0,0,1,44,32,18,13,0,0,0,0,1,12,10,2,0,0,0,0,0
270531002002020,8,Webber - Camden,4,4,1000000US270531002002020,"Block 2020, Block Group 2, Census Tract 1002, Hennepin County, Minnesota",100,18,59,4,0,1,4,14,100,94,18,59,4,0,1,0,12,6,0,0,0,0,0,4,2
270531002002022,8,Webber - Camden,4,4,1000000US270531002002022,"Block 2022, Block Group 2, Census Tract 1002, Hennepin County, Minnesota",65,36,22,0,7,0,0,0,65,65,36,22,0,7,0,0,0,0,0,0,0,0,0,0,0
270531004002001,8,Webber - Camden,4,4,1000000US270531004002001,"Block 2001, Block Group 2, Census Tract 1004, Hennepin County, Minnesota",91,24,34,14,14,0,5,0,91,84,24,34,12,14,0,0,0,7,0,0,2,0,0,5,0
270531004001019,8,Webber - Camden,4,4,1000000US270531004001019,"Block 1019, Block Group 1, Census Tract 1004, Hennepin County, Minnesota",95,32,27,0,24,0,4,8,95,90,31,27,0,24,0,0,8,5,1,0,0,0,0,4,0
270531002002007,8,Webber - Camden,4,4,1000000US270531002002007,"Block 2007, Block Group 2, Census Tract 1002, Hennepin County, Minnesota",0,0,0,0,0,0,0,0,0,0,0,0,0,0,0,0,0,0,0,0,0,0,0,0,0
270531002002018,8,Webber - Camden,4,4,1000000US270531002002018,"Block 2018, Block Group 2, Census Tract 1002, Hennepin County, Minnesota",48,27,8,2,11,0,0,0,48,47,27,7,2,11,0,0,0,1,0,1,0,0,0,0,0
270531002002002,8,Webber - Camden,4,4,1000000US270531002002002,"Block 2002, Block Group 2, Census Tract 1002, Hennepin County, Minnesota",43,32,9,0,0,0,0,2,43,43,32,9,0,0,0,0,2,0,0,0,0,0,0,0,0
270531002002014,8,Webber - Camden,4,4,1000000US270531002002014,"Block 2014, Block Group 2, Census Tract 1002, Hennepin County, Minnesota",46,24,13,0,7,0,0,2,46,45,23,13,0,7,0,0,2,1,1,0,0,0,0,0,0
270531002002013,8,Webber - Camden,4,4,1000000US270531002002013,"Block 2013, Block Group 2, Census Tract 1002, Hennepin County, Minnesota",42,31,11,0,0,0,0,0,42,42,31,11,0,0,0,0,0,0,0,0,0,0,0,0,0
270531002003008,8,Webber - Camden,4,4,1000000US270531002003008,"Block 3008, Block Group 3, Census Tract 1002, Hennepin County, Minnesota",111,28,65,3,0,0,2,13,111,110,27,65,3,0,0,2,13,1,1,0,0,0,0,0,0
270531002002026,8,Webber - Camden,4,4,1000000US270531002002026,"Block 2026, Block Group 2, Census Tract 1002, Hennepin County, Minnesota",73,36,31,6,0,0,0,0,73,68,35,30,3,0,0,0,0,5,1,1,3,0,0,0,0
270531004003010,8,Webber - Camden,4,4,1000000US270531004003010,"Block 3010, Block Group 3, Census Tract 1004, Hennepin County, Minnesota",63,40,9,0,10,0,0,4,63,58,39,9,0,9,0,0,1,5,1,0,0,1,0,0,3
270531004002006,8,Webber - Camden,4,4,1000000US270531004002006,"Block 2006, Block Group 2, Census Tract 1004, Hennepin County, Minnesota",47,30,14,2,0,0,1,0,47,40,24,14,2,0,0,0,0,7,6,0,0,0,0,1,0
270531002003004,8,Webber - Camden,4,4,1000000US270531002003004,"Block 3004, Block Group 3, Census Tract 1002, Hennepin County, Minnesota",50,24,15,6,0,0,4,1,50,40,21,15,4,0,0,0,0,10,3,0,2,0,0,4,1
270531004003015,8,Webber - Camden,4,4,1000000US270531004003015,"Block 3015, Block Group 3, Census Tract 1004, Hennepin County, Minnesota",81,33,33,0,11,0,0,4,81,81,33,33,0,11,0,0,4,0,0,0,0,0,0,0,0
270531004003000,8,Webber - Camden,4,4,1000000US270531004003000,"Block 3000, Block Group 3, Census Tract 1004, Hennepin County, Minnesota",78,32,39,0,0,0,0,7,78,78,32,39,0,0,0,0,7,0,0,0,0,0,0,0,0
270531004001005,8,Webber - Camden,4,4,1000000US270531004001005,"Block 1005, Block Group 1, Census Tract 1004, Hennepin County, Minnesota",127,38,48,4,24,0,3,10,127,120,34,48,4,24,0,0,10,7,4,0,0,0,0,3,0
270531004001006,8,Webber - Camden,4,4,1000000US270531004001006,"Block 1006, Block Group 1, Census Tract 1004, Hennepin County, Minnesota",79,13,45,10,7,0,0,4,79,77,13,45,10,7,0,0,2,2,0,0,0,0,0,0,2
270531004001017,8,Webber - Camden,4,4,1000000US270531004001017,"Block 1017, Block Group 1, Census Tract 1004, Hennepin County, Minnesota",92,25,17,2,31,0,7,10,92,81,21,17,2,31,0,0,10,11,4,0,0,0,0,7,0
270531002002005,8,Webber - Camden,4,4,1000000US270531002002005,"Block 2005, Block Group 2, Census Tract 1002, Hennepin County, Minnesota",10,10,0,0,0,0,0,0,10,10,10,0,0,0,0,0,0,0,0,0,0,0,0,0,0
270531002002004,8,Webber - Camden,4,4,1000000US270531002002004,"Block 2004, Block Group 2, Census Tract 1002, Hennepin County, Minnesota",39,24,7,0,6,0,0,2,39,37,23,7,0,6,0,0,1,2,1,0,0,0,0,0,1
270531002002010,8,Webber - Camden,4,4,1000000US270531002002010,"Block 2010, Block Group 2, Census Tract 1002, Hennepin County, Minnesota",0,0,0,0,0,0,0,0,0,0,0,0,0,0,0,0,0,0,0,0,0,0,0,0,0
270531004001012,8,Webber - Camden,4,4,1000000US270531004001012,"Block 1012, Block Group 1, Census Tract 1004, Hennepin County, Minnesota",0,0,0,0,0,0,0,0,0,0,0,0,0,0,0,0,0,0,0,0,0,0,0,0,0
270531002003009,8,Webber - Camden,4,4,1000000US270531002003009,"Block 3009, Block Group 3, Census Tract 1002, Hennepin County, Minnesota",103,35,47,1,10,0,6,4,103,91,30,47,1,10,0,0,3,12,5,0,0,0,0,6,1
270531004003002,8,Webber - Camden,4,4,1000000US270531004003002,"Block 3002, Block Group 3, Census Tract 1004, Hennepin County, Minnesota",0,0,0,0,0,0,0,0,0,0,0,0,0,0,0,0,0,0,0,0,0,0,0,0,0
270531002003015,8,Webber - Camden,4,4,1000000US270531002003015,"Block 3015, Block Group 3, Census Tract 1002, Hennepin County, Minnesota",47,35,9,0,1,0,2,0,47,47,35,9,0,1,0,2,0,0,0,0,0,0,0,0,0
270531004003008,8,Webber - Camden,4,4,1000000US270531004003008,"Block 3008, Block Group 3, Census Tract 1004, Hennepin County, Minnesota",105,22,51,3,2,0,12,15,105,92,22,50,3,2,0,0,15,13,0,1,0,0,0,12,0
270531002002006,8,Webber - Camden,4,4,1000000US270531002002006,"Block 2006, Block Group 2, Census Tract 1002, Hennepin County, Minnesota",36,23,9,0,1,0,0,3,36,36,23,9,0,1,0,0,3,0,0,0,0,0,0,0,0
270531002002017,8,Webber - Camden,4,4,1000000US270531002002017,"Block 2017, Block Group 2, Census Tract 1002, Hennepin County, Minnesota",49,31,8,0,0,0,2,8,49,47,30,8,0,0,0,2,7,2,1,0,0,0,0,0,1
270531002002000,8,Webber - Camden,4,4,1000000US270531002002000,"Block 2000, Block Group 2, Census Tract 1002, Hennepin County, Minnesota",19,12,1,0,2,0,0,4,19,18,11,1,0,2,0,0,4,1,1,0,0,0,0,0,0
270531002003001,8,Webber - Camden,4,4,1000000US270531002003001,"Block 3001, Block Group 3, Census Tract 1002, Hennepin County, Minnesota",0,0,0,0,0,0,0,0,0,0,0,0,0,0,0,0,0,0,0,0,0,0,0,0,0
270531002002024,8,Webber - Camden,4,4,1000000US270531002002024,"Block 2024, Block Group 2, Census Tract 1002, Hennepin County, Minnesota",78,37,21,2,4,0,0,14,78,78,37,21,2,4,0,0,14,0,0,0,0,0,0,0,0
270531002003017,8,Webber - Camden,4,4,1000000US270531002003017,"Block 3017, Block Group 3, Census Tract 1002, Hennepin County, Minnesota",0,0,0,0,0,0,0,0,0,0,0,0,0,0,0,0,0,0,0,0,0,0,0,0,0
270531004001020,8,Webber - Camden,4,4,1000000US270531004001020,"Block 1020, Block Group 1, Census Tract 1004, Hennepin County, Minnesota",72,23,32,0,9,0,1,7,72,69,21,32,0,9,0,0,7,3,2,0,0,0,0,1,0
270531004001016,8,Webber - Camden,4,4,1000000US270531004001016,"Block 1016, Block Group 1, Census Tract 1004, Hennepin County, Minnesota",73,31,32,0,0,0,0,10,73,70,31,32,0,0,0,0,7,3,0,0,0,0,0,0,3
270530017002008,9,Bottineau,14,14,1000000US270530017002008,"Block 2008, Block Group 2, Census Tract 17, Hennepin County, Minnesota",37,36,1,0,0,0,0,0,37,36,35,1,0,0,0,0,0,1,1,0,0,0,0,0,0
270530017002024,9,Bottineau,14,14,1000000US270530017002024,"Block 2024, Block Group 2, Census Tract 17, Hennepin County, Minnesota",49,35,5,0,0,0,5,4,49,38,34,4,0,0,0,0,0,11,1,1,0,0,0,5,4
270530017002023,9,Bottineau,14,14,1000000US270530017002023,"Block 2023, Block Group 2, Census Tract 17, Hennepin County, Minnesota",35,34,0,1,0,0,0,0,35,34,33,0,1,0,0,0,0,1,1,0,0,0,0,0,0
270530017002011,9,Bottineau,14,14,1000000US270530017002011,"Block 2011, Block Group 2, Census Tract 17, Hennepin County, Minnesota",0,0,0,0,0,0,0,0,0,0,0,0,0,0,0,0,0,0,0,0,0,0,0,0,0
270530017002026,9,Bottineau,14,14,1000000US270530017002026,"Block 2026, Block Group 2, Census Tract 17, Hennepin County, Minnesota",4,3,0,1,0,0,0,0,4,4,3,0,1,0,0,0,0,0,0,0,0,0,0,0,0
270530017002002,9,Bottineau,14,14,1000000US270530017002002,"Block 2002, Block Group 2, Census Tract 17, Hennepin County, Minnesota",6,5,0,0,0,0,0,1,6,6,5,0,0,0,0,0,1,0,0,0,0,0,0,0,0
270530017002007,9,Bottineau,14,14,1000000US270530017002007,"Block 2007, Block Group 2, Census Tract 17, Hennepin County, Minnesota",121,50,10,0,39,0,20,2,121,95,44,10,0,39,0,0,2,26,6,0,0,0,0,20,0
270530017002006,9,Bottineau,14,14,1000000US270530017002006,"Block 2006, Block Group 2, Census Tract 17, Hennepin County, Minnesota",80,58,14,6,1,0,1,0,80,79,58,14,6,1,0,0,0,1,0,0,0,0,0,1,0
270530017002000,9,Bottineau,14,14,1000000US270530017002000,"Block 2000, Block Group 2, Census Tract 17, Hennepin County, Minnesota",53,28,1,7,0,0,17,0,53,15,10,1,4,0,0,0,0,38,18,0,3,0,0,17,0
270530017002004,9,Bottineau,14,14,1000000US270530017002004,"Block 2004, Block Group 2, Census Tract 17, Hennepin County, Minnesota",14,14,0,0,0,0,0,0,14,14,14,0,0,0,0,0,0,0,0,0,0,0,0,0,0
270530017002022,9,Bottineau,14,14,1000000US270530017002022,"Block 2022, Block Group 2, Census Tract 17, Hennepin County, Minnesota",78,49,15,0,1,0,5,8,78,72,48,15,0,1,0,1,7,6,1,0,0,0,0,4,1
270530017002025,9,Bottineau,14,14,1000000US270530017002025,"Block 2025, Block Group 2, Census Tract 17, Hennepin County, Minnesota",40,35,0,0,0,0,1,4,40,39,35,0,0,0,0,0,4,1,0,0,0,0,0,1,0
270530017002001,9,Bottineau,14,14,1000000US270530017002001,"Block 2001, Block Group 2, Census Tract 17, Hennepin County, Minnesota",17,12,0,1,0,0,0,4,17,17,12,0,1,0,0,0,4,0,0,0,0,0,0,0,0
270530017002021,9,Bottineau,14,14,1000000US270530017002021,"Block 2021, Block Group 2, Census Tract 17, Hennepin County, Minnesota",515,70,418,10,1,0,11,5,515,498,65,418,8,1,0,1,5,17,5,0,2,0,0,10,0
270530017002015,9,Bottineau,14,14,1000000US270530017002015,"Block 2015, Block Group 2, Census Tract 17, Hennepin County, Minnesota",16,15,1,0,0,0,0,0,16,16,15,1,0,0,0,0,0,0,0,0,0,0,0,0,0
270530017002019,9,Bottineau,14,14,1000000US270530017002019,"Block 2019, Block Group 2, Census Tract 17, Hennepin County, Minnesota",158,31,114,0,2,0,2,9,158,153,31,113,0,2,0,2,5,5,0,1,0,0,0,0,4
270530017002017,9,Bottineau,14,14,1000000US270530017002017,"Block 2017, Block Group 2, Census Tract 17, Hennepin County, Minnesota",40,40,0,0,0,0,0,0,40,40,40,0,0,0,0,0,0,0,0,0,0,0,0,0,0
270530017002018,9,Bottineau,14,14,1000000US270530017002018,"Block 2018, Block Group 2, Census Tract 17, Hennepin County, Minnesota",30,22,5,0,1,0,0,2,30,26,22,1,0,1,0,0,2,4,0,4,0,0,0,0,0
270530017002003,9,Bottineau,14,14,1000000US270530017002003,"Block 2003, Block Group 2, Census Tract 17, Hennepin County, Minnesota",41,19,7,2,6,0,2,5,41,32,19,4,2,5,0,0,2,9,0,3,0,1,0,2,3
270530017002013,9,Bottineau,14,14,1000000US270530017002013,"Block 2013, Block Group 2, Census Tract 17, Hennepin County, Minnesota",41,31,8,0,2,0,0,0,41,40,30,8,0,2,0,0,0,1,1,0,0,0,0,0,0
270530017002020,9,Bottineau,14,14,1000000US270530017002020,"Block 2020, Block Group 2, Census Tract 17, Hennepin County, Minnesota",110,75,11,1,0,0,10,13,110,83,67,11,1,0,0,1,3,27,8,0,0,0,0,9,10
270530017002005,9,Bottineau,14,14,1000000US270530017002005,"Block 2005, Block Group 2, Census Tract 17, Hennepin County, Minnesota",10,10,0,0,0,0,0,0,10,10,10,0,0,0,0,0,0,0,0,0,0,0,0,0,0
270530017002014,9,Bottineau,14,14,1000000US270530017002014,"Block 2014, Block Group 2, Census Tract 17, Hennepin County, Minnesota",50,38,5,4,0,0,2,1,50,44,38,5,0,0,0,1,0,6,0,0,4,0,0,1,1
270530017002016,9,Bottineau,14,14,1000000US270530017002016,"Block 2016, Block Group 2, Census Tract 17, Hennepin County, Minnesota",33,27,0,0,6,0,0,0,33,32,26,0,0,6,0,0,0,1,1,0,0,0,0,0,0
270530017002012,9,Bottineau,14,14,1000000US270530017002012,"Block 2012, Block Group 2, Census Tract 17, Hennepin County, Minnesota",78,60,8,1,2,0,0,7,78,75,58,8,1,2,0,0,6,3,2,0,0,0,0,0,1
270530017002009,9,Bottineau,14,14,1000000US270530017002009,"Block 2009, Block Group 2, Census Tract 17, Hennepin County, Minnesota",0,0,0,0,0,0,0,0,0,0,0,0,0,0,0,0,0,0,0,0,0,0,0,0,0
270531002001002,10,Victory,3,3,1000000US270531002001002,"Block 1002, Block Group 1, Census Tract 1002, Hennepin County, Minnesota",50,45,5,0,0,0,0,0,50,46,41,5,0,0,0,0,0,4,4,0,0,0,0,0,0
270531002001003,10,Victory,3,3,1000000US270531002001003,"Block 1003, Block Group 1, Census Tract 1002, Hennepin County, Minnesota",65,35,16,0,11,0,0,3,65,61,33,16,0,11,0,0,1,4,2,0,0,0,0,0,2
270531002001000,10,Victory,3,3,1000000US270531002001000,"Block 1000, Block Group 1, Census Tract 1002, Hennepin County, Minnesota",39,18,5,0,12,0,0,4,39,39,18,5,0,12,0,0,4,0,0,0,0,0,0,0,0
270530003002006,10,Victory,3,3,1000000US270530003002006,"Block 2006, Block Group 2, Census Tract 3, Hennepin County, Minnesota",82,52,19,0,3,0,0,8,82,82,52,19,0,3,0,0,8,0,0,0,0,0,0,0,0
270531002001028,10,Victory,3,3,1000000US270531002001028,"Block 1028, Block Group 1, Census Tract 1002, Hennepin County, Minnesota",0,0,0,0,0,0,0,0,0,0,0,0,0,0,0,0,0,0,0,0,0,0,0,0,0
270530003004000,10,Victory,3,3,1000000US270530003004000,"Block 4000, Block Group 4, Census Tract 3, Hennepin County, Minnesota",80,59,19,1,0,0,1,0,80,79,59,19,1,0,0,0,0,1,0,0,0,0,0,1,0
270531002001022,10,Victory,3,3,1000000US270531002001022,"Block 1022, Block Group 1, Census Tract 1002, Hennepin County, Minnesota",0,0,0,0,0,0,0,0,0,0,0,0,0,0,0,0,0,0,0,0,0,0,0,0,0
270531002001005,10,Victory,3,3,1000000US270531002001005,"Block 1005, Block Group 1, Census Tract 1002, Hennepin County, Minnesota",42,29,5,0,3,0,1,4,42,41,29,5,0,3,0,0,4,1,0,0,0,0,0,1,0
270530003004004,10,Victory,3,3,1000000US270530003004004,"Block 4004, Block Group 4, Census Tract 3, Hennepin County, Minnesota",56,53,0,1,0,0,0,2,56,52,50,0,0,0,0,0,2,4,3,0,1,0,0,0,0
270530003004002,10,Victory,3,3,1000000US270530003004002,"Block 4002, Block Group 4, Census Tract 3, Hennepin County, Minnesota",70,61,4,3,0,0,2,0,70,67,60,4,3,0,0,0,0,3,1,0,0,0,0,2,0
270531002001011,10,Victory,3,3,1000000US270531002001011,"Block 1011, Block Group 1, Census Tract 1002, Hennepin County, Minnesota",41,31,2,0,7,0,0,1,41,38,28,2,0,7,0,0,1,3,3,0,0,0,0,0,0
270531002001036,10,Victory,3,3,1000000US270531002001036,"Block 1036, Block Group 1, Census Tract 1002, Hennepin County, Minnesota",0,0,0,0,0,0,0,0,0,0,0,0,0,0,0,0,0,0,0,0,0,0,0,0,0
270531002001024,10,Victory,3,3,1000000US270531002001024,"Block 1024, Block Group 1, Census Tract 1002, Hennepin County, Minnesota",0,0,0,0,0,0,0,0,0,0,0,0,0,0,0,0,0,0,0,0,0,0,0,0,0
270530003004001,10,Victory,3,3,1000000US270530003004001,"Block 4001, Block Group 4, Census Tract 3, Hennepin County, Minnesota",61,57,0,0,0,0,4,0,61,56,56,0,0,0,0,0,0,5,1,0,0,0,0,4,0
270530003004006,10,Victory,3,3,1000000US270530003004006,"Block 4006, Block Group 4, Census Tract 3, Hennepin County, Minnesota",53,50,1,0,0,0,0,2,53,52,49,1,0,0,0,0,2,1,1,0,0,0,0,0,0
270530003004008,10,Victory,3,3,1000000US270530003004008,"Block 4008, Block Group 4, Census Tract 3, Hennepin County, Minnesota",57,33,16,2,0,0,2,4,57,48,29,15,0,0,0,0,4,9,4,1,2,0,0,2,0
270531002001035,10,Victory,3,3,1000000US270531002001035,"Block 1035, Block Group 1, Census Tract 1002, Hennepin County, Minnesota",26,25,0,0,0,0,0,1,26,26,25,0,0,0,0,0,1,0,0,0,0,0,0,0,0
270531002001034,10,Victory,3,3,1000000US270531002001034,"Block 1034, Block Group 1, Census Tract 1002, Hennepin County, Minnesota",31,24,6,0,0,0,1,0,31,30,24,6,0,0,0,0,0,1,0,0,0,0,0,1,0
270530003003005,10,Victory,3,3,1000000US270530003003005,"Block 3005, Block Group 3, Census Tract 3, Hennepin County, Minnesota",65,52,8,0,0,0,1,4,65,64,52,8,0,0,0,0,4,1,0,0,0,0,0,1,0
270530003003006,10,Victory,3,3,1000000US270530003003006,"Block 3006, Block Group 3, Census Tract 3, Hennepin County, Minnesota",67,53,7,2,0,0,1,4,67,64,52,7,2,0,0,0,3,3,1,0,0,0,0,1,1
270530003002004,10,Victory,3,3,1000000US270530003002004,"Block 2004, Block Group 2, Census Tract 3, Hennepin County, Minnesota",79,45,33,0,0,0,0,1,79,76,43,32,0,0,0,0,1,3,2,1,0,0,0,0,0
270530003002011,10,Victory,3,3,1000000US270530003002011,"Block 2011, Block Group 2, Census Tract 3, Hennepin County, Minnesota",87,35,45,0,0,0,0,7,87,86,35,45,0,0,0,0,6,1,0,0,0,0,0,0,1
270530003003004,10,Victory,3,3,1000000US270530003003004,"Block 3004, Block Group 3, Census Tract 3, Hennepin County, Minnesota",74,64,4,0,0,0,0,6,74,71,62,4,0,0,0,0,5,3,2,0,0,0,0,0,1
270530003003008,10,Victory,3,3,1000000US270530003003008,"Block 3008, Block Group 3, Census Tract 3, Hennepin County, Minnesota",83,36,36,3,1,0,0,7,83,82,35,36,3,1,0,0,7,1,1,0,0,0,0,0,0
270530003002005,10,Victory,3,3,1000000US270530003002005,"Block 2005, Block Group 2, Census Tract 3, Hennepin County, Minnesota",77,41,28,0,5,0,0,3,77,72,38,26,0,5,0,0,3,5,3,2,0,0,0,0,0
270530003003011,10,Victory,3,3,1000000US270530003003011,"Block 3011, Block Group 3, Census Tract 3, Hennepin County, Minnesota",69,59,7,1,1,0,1,0,69,68,58,7,1,1,0,1,0,1,1,0,0,0,0,0,0
270530003003010,10,Victory,3,3,1000000US270530003003010,"Block 3010, Block Group 3, Census Tract 3, Hennepin County, Minnesota",56,42,5,0,9,0,0,0,56,56,42,5,0,9,0,0,0,0,0,0,0,0,0,0,0
270531002001026,10,Victory,3,3,1000000US270531002001026,"Block 1026, Block Group 1, Census Tract 1002, Hennepin County, Minnesota",0,0,0,0,0,0,0,0,0,0,0,0,0,0,0,0,0,0,0,0,0,0,0,0,0
270530003002001,10,Victory,3,3,1000000US270530003002001,"Block 2001, Block Group 2, Census Tract 3, Hennepin County, Minnesota",84,52,5,0,9,0,9,9,84,69,51,3,0,9,0,0,6,15,1,2,0,0,0,9,3
270530003001011,10,Victory,3,3,1000000US270530003001011,"Block 1011, Block Group 1, Census Tract 3, Hennepin County, Minnesota",77,41,13,1,8,0,1,13,77,72,41,13,1,8,0,0,9,5,0,0,0,0,0,1,4
270530003001001,10,Victory,3,3,1000000US270530003001001,"Block 1001, Block Group 1, Census Tract 3, Hennepin County, Minnesota",66,33,21,0,12,0,0,0,66,65,33,20,0,12,0,0,0,1,0,1,0,0,0,0,0
270531002001029,10,Victory,3,3,1000000US270531002001029,"Block 1029, Block Group 1, Census Tract 1002, Hennepin County, Minnesota",32,16,9,0,3,0,0,4,32,32,16,9,0,3,0,0,4,0,0,0,0,0,0,0,0
270530003001000,10,Victory,3,3,1000000US270530003001000,"Block 1000, Block Group 1, Census Tract 3, Hennepin County, Minnesota",89,34,20,0,35,0,0,0,89,89,34,20,0,35,0,0,0,0,0,0,0,0,0,0,0
270530003001008,10,Victory,3,3,1000000US270530003001008,"Block 1008, Block Group 1, Census Tract 3, Hennepin County, Minnesota",91,55,28,7,0,0,0,1,91,91,55,28,7,0,0,0,1,0,0,0,0,0,0,0,0
270531002001008,10,Victory,3,3,1000000US270531002001008,"Block 1008, Block Group 1, Census Tract 1002, Hennepin County, Minnesota",62,59,3,0,0,0,0,0,62,62,59,3,0,0,0,0,0,0,0,0,0,0,0,0,0
270530003003002,10,Victory,3,3,1000000US270530003003002,"Block 3002, Block Group 3, Census Tract 3, Hennepin County, Minnesota",54,50,0,0,0,0,2,2,54,51,49,0,0,0,0,0,2,3,1,0,0,0,0,2,0
270530003003001,10,Victory,3,3,1000000US270530003003001,"Block 3001, Block Group 3, Census Tract 3, Hennepin County, Minnesota",65,43,13,0,2,0,0,7,65,65,43,13,0,2,0,0,7,0,0,0,0,0,0,0,0
270530003001003,10,Victory,3,3,1000000US270530003001003,"Block 1003, Block Group 1, Census Tract 3, Hennepin County, Minnesota",57,47,5,0,1,0,0,4,57,57,47,5,0,1,0,0,4,0,0,0,0,0,0,0,0
270530003001005,10,Victory,3,3,1000000US270530003001005,"Block 1005, Block Group 1, Census Tract 3, Hennepin County, Minnesota",72,53,18,0,1,0,0,0,72,67,48,18,0,1,0,0,0,5,5,0,0,0,0,0,0
270531002001019,10,Victory,3,3,1000000US270531002001019,"Block 1019, Block Group 1, Census Tract 1002, Hennepin County, Minnesota",46,29,6,0,7,0,1,3,46,42,29,6,0,7,0,0,0,4,0,0,0,0,0,1,3
270530003002007,10,Victory,3,3,1000000US270530003002007,"Block 2007, Block Group 2, Census Tract 3, Hennepin County, Minnesota",56,36,15,0,1,0,0,4,56,52,33,14,0,1,0,0,4,4,3,1,0,0,0,0,0
270531002001012,10,Victory,3,3,1000000US270531002001012,"Block 1012, Block Group 1, Census Tract 1002, Hennepin County, Minnesota",42,24,13,3,2,0,0,0,42,42,24,13,3,2,0,0,0,0,0,0,0,0,0,0,0
270530003004007,10,Victory,3,3,1000000US270530003004007,"Block 4007, Block Group 4, Census Tract 3, Hennepin County, Minnesota",65,47,9,2,0,0,3,4,65,55,45,6,2,0,0,0,2,10,2,3,0,0,0,3,2
270530003002002,10,Victory,3,3,1000000US270530003002002,"Block 2002, Block Group 2, Census Tract 3, Hennepin County, Minnesota",70,42,24,0,0,0,0,4,70,70,42,24,0,0,0,0,4,0,0,0,0,0,0,0,0
270531002001033,10,Victory,3,3,1000000US270531002001033,"Block 1033, Block Group 1, Census Tract 1002, Hennepin County, Minnesota",0,0,0,0,0,0,0,0,0,0,0,0,0,0,0,0,0,0,0,0,0,0,0,0,0
270531002001031,10,Victory,3,3,1000000US270531002001031,"Block 1031, Block Group 1, Census Tract 1002, Hennepin County, Minnesota",24,14,4,0,2,0,0,4,24,19,9,4,0,2,0,0,4,5,5,0,0,0,0,0,0
270531002001040,10,Victory,3,3,1000000US270531002001040,"Block 1040, Block Group 1, Census Tract 1002, Hennepin County, Minnesota",76,49,6,0,10,0,11,0,76,65,45,6,0,10,0,4,0,11,4,0,0,0,0,7,0
270531002001042,10,Victory,3,3,1000000US270531002001042,"Block 1042, Block Group 1, Census Tract 1002, Hennepin County, Minnesota",56,34,20,0,2,0,0,0,56,56,34,20,0,2,0,0,0,0,0,0,0,0,0,0,0
270531002001010,10,Victory,3,3,1000000US270531002001010,"Block 1010, Block Group 1, Census Tract 1002, Hennepin County, Minnesota",107,81,13,2,0,0,1,10,107,97,74,13,2,0,0,0,8,10,7,0,0,0,0,1,2
270531002001017,10,Victory,3,3,1000000US270531002001017,"Block 1017, Block Group 1, Census Tract 1002, Hennepin County, Minnesota",0,0,0,0,0,0,0,0,0,0,0,0,0,0,0,0,0,0,0,0,0,0,0,0,0
270530003004003,10,Victory,3,3,1000000US270530003004003,"Block 4003, Block Group 4, Census Tract 3, Hennepin County, Minnesota",67,53,6,0,0,0,0,8,67,67,53,6,0,0,0,0,8,0,0,0,0,0,0,0,0
270530003004010,10,Victory,3,3,1000000US270530003004010,"Block 4010, Block Group 4, Census Tract 3, Hennepin County, Minnesota",59,59,0,0,0,0,0,0,59,58,58,0,0,0,0,0,0,1,1,0,0,0,0,0,0
270531002001018,10,Victory,3,3,1000000US270531002001018,"Block 1018, Block Group 1, Census Tract 1002, Hennepin County, Minnesota",37,18,15,0,4,0,0,0,37,37,18,15,0,4,0,0,0,0,0,0,0,0,0,0,0
270531002001021,10,Victory,3,3,1000000US270531002001021,"Block 1021, Block Group 1, Census Tract 1002, Hennepin County, Minnesota",0,0,0,0,0,0,0,0,0,0,0,0,0,0,0,0,0,0,0,0,0,0,0,0,0
270530212003010,10,Victory,3,3,1000000US270530212003010,"Block 3010, Block Group 3, Census Tract 212, Hennepin County, Minnesota",0,0,0,0,0,0,0,0,0,0,0,0,0,0,0,0,0,0,0,0,0,0,0,0,0
270531002001009,10,Victory,3,3,1000000US270531002001009,"Block 1009, Block Group 1, Census Tract 1002, Hennepin County, Minnesota",89,58,21,0,4,0,0,6,89,89,58,21,0,4,0,0,6,0,0,0,0,0,0,0,0
270531002001027,10,Victory,3,3,1000000US270531002001027,"Block 1027, Block Group 1, Census Tract 1002, Hennepin County, Minnesota",0,0,0,0,0,0,0,0,0,0,0,0,0,0,0,0,0,0,0,0,0,0,0,0,0
270530003004005,10,Victory,3,3,1000000US270530003004005,"Block 4005, Block Group 4, Census Tract 3, Hennepin County, Minnesota",47,40,2,2,0,1,2,0,47,46,40,2,1,0,1,2,0,1,0,0,1,0,0,0,0
270530003003003,10,Victory,3,3,1000000US270530003003003,"Block 3003, Block Group 3, Census Tract 3, Hennepin County, Minnesota",57,51,0,3,0,0,3,0,57,50,47,0,3,0,0,0,0,7,4,0,0,0,0,3,0
270531002001015,10,Victory,3,3,1000000US270531002001015,"Block 1015, Block Group 1, Census Tract 1002, Hennepin County, Minnesota",37,36,0,0,0,0,1,0,37,36,36,0,0,0,0,0,0,1,0,0,0,0,0,1,0
270530003001002,10,Victory,3,3,1000000US270530003001002,"Block 1002, Block Group 1, Census Tract 3, Hennepin County, Minnesota",65,58,2,0,0,0,0,5,65,64,57,2,0,0,0,0,5,1,1,0,0,0,0,0,0
270531002001039,10,Victory,3,3,1000000US270531002001039,"Block 1039, Block Group 1, Census Tract 1002, Hennepin County, Minnesota",89,32,25,0,16,0,7,9,89,89,32,25,0,16,0,7,9,0,0,0,0,0,0,0,0
270530003002008,10,Victory,3,3,1000000US270530003002008,"Block 2008, Block Group 2, Census Tract 3, Hennepin County, Minnesota",50,33,9,0,0,0,0,8,50,45,33,9,0,0,0,0,3,5,0,0,0,0,0,0,5
270531002001007,10,Victory,3,3,1000000US270531002001007,"Block 1007, Block Group 1, Census Tract 1002, Hennepin County, Minnesota",0,0,0,0,0,0,0,0,0,0,0,0,0,0,0,0,0,0,0,0,0,0,0,0,0
270530003003007,10,Victory,3,3,1000000US270530003003007,"Block 3007, Block Group 3, Census Tract 3, Hennepin County, Minnesota",77,35,24,0,6,0,4,8,77,68,32,24,0,6,0,2,4,9,3,0,0,0,0,2,4
270530003002010,10,Victory,3,3,1000000US270530003002010,"Block 2010, Block Group 2, Census Tract 3, Hennepin County, Minnesota",48,33,6,1,0,0,2,6,48,44,33,6,1,0,0,0,4,4,0,0,0,0,0,2,2
270530003002009,10,Victory,3,3,1000000US270530003002009,"Block 2009, Block Group 2, Census Tract 3, Hennepin County, Minnesota",81,56,4,0,15,0,4,2,81,77,56,4,0,15,0,0,2,4,0,0,0,0,0,4,0
270531002001037,10,Victory,3,3,1000000US270531002001037,"Block 1037, Block Group 1, Census Tract 1002, Hennepin County, Minnesota",47,43,0,0,0,0,0,4,47,47,43,0,0,0,0,0,4,0,0,0,0,0,0,0,0
270530003004011,10,Victory,3,3,1000000US270530003004011,"Block 4011, Block Group 4, Census Tract 3, Hennepin County, Minnesota",54,53,1,0,0,0,0,0,54,54,53,1,0,0,0,0,0,0,0,0,0,0,0,0,0
270531002001016,10,Victory,3,3,1000000US270531002001016,"Block 1016, Block Group 1, Census Tract 1002, Hennepin County, Minnesota",58,48,1,0,0,0,8,1,58,43,38,1,0,0,0,3,1,15,10,0,0,0,0,5,0
270531002001014,10,Victory,3,3,1000000US270531002001014,"Block 1014, Block Group 1, Census Tract 1002, Hennepin County, Minnesota",0,0,0,0,0,0,0,0,0,0,0,0,0,0,0,0,0,0,0,0,0,0,0,0,0
270531002001013,10,Victory,3,3,1000000US270531002001013,"Block 1013, Block Group 1, Census Tract 1002, Hennepin County, Minnesota",30,15,0,0,10,0,5,0,30,24,14,0,0,10,0,0,0,6,1,0,0,0,0,5,0
270530003001006,10,Victory,3,3,1000000US270530003001006,"Block 1006, Block Group 1, Census Tract 3, Hennepin County, Minnesota",57,46,9,0,0,0,0,2,57,56,45,9,0,0,0,0,2,1,1,0,0,0,0,0,0
270530003002003,10,Victory,3,3,1000000US270530003002003,"Block 2003, Block Group 2, Census Tract 3, Hennepin County, Minnesota",70,61,2,0,0,0,0,7,70,64,57,2,0,0,0,0,5,6,4,0,0,0,0,0,2
270530003001009,10,Victory,3,3,1000000US270530003001009,"Block 1009, Block Group 1, Census Tract 3, Hennepin County, Minnesota",64,50,7,0,0,0,0,7,64,64,50,7,0,0,0,0,7,0,0,0,0,0,0,0,0
270531002001023,10,Victory,3,3,1000000US270531002001023,"Block 1023, Block Group 1, Census Tract 1002, Hennepin County, Minnesota",0,0,0,0,0,0,0,0,0,0,0,0,0,0,0,0,0,0,0,0,0,0,0,0,0
270531002001020,10,Victory,3,3,1000000US270531002001020,"Block 1020, Block Group 1, Census Tract 1002, Hennepin County, Minnesota",37,24,13,0,0,0,0,0,37,37,24,13,0,0,0,0,0,0,0,0,0,0,0,0,0
270531002001030,10,Victory,3,3,1000000US270531002001030,"Block 1030, Block Group 1, Census Tract 1002, Hennepin County, Minnesota",61,23,13,1,12,2,4,6,61,59,23,12,1,12,2,4,5,2,0,1,0,0,0,0,1
270530003001007,10,Victory,3,3,1000000US270530003001007,"Block 1007, Block Group 1, Census Tract 3, Hennepin County, Minnesota",75,40,26,5,0,0,0,4,75,72,37,26,5,0,0,0,4,3,3,0,0,0,0,0,0
270530003002000,10,Victory,3,3,1000000US270530003002000,"Block 2000, Block Group 2, Census Tract 3, Hennepin County, Minnesota",75,42,22,0,0,0,1,10,75,71,42,22,0,0,0,0,7,4,0,0,0,0,0,1,3
270531002001041,10,Victory,3,3,1000000US270531002001041,"Block 1041, Block Group 1, Census Tract 1002, Hennepin County, Minnesota",77,29,35,0,11,0,1,1,77,69,23,35,0,11,0,0,0,8,6,0,0,0,0,1,1
270531002001038,10,Victory,3,3,1000000US270531002001038,"Block 1038, Block Group 1, Census Tract 1002, Hennepin County, Minnesota",0,0,0,0,0,0,0,0,0,0,0,0,0,0,0,0,0,0,0,0,0,0,0,0,0
270531002001004,10,Victory,3,3,1000000US270531002001004,"Block 1004, Block Group 1, Census Tract 1002, Hennepin County, Minnesota",26,20,6,0,0,0,0,0,26,23,17,6,0,0,0,0,0,3,3,0,0,0,0,0,0
270531002001025,10,Victory,3,3,1000000US270531002001025,"Block 1025, Block Group 1, Census Tract 1002, Hennepin County, Minnesota",34,27,3,0,1,0,3,0,34,31,27,3,0,1,0,0,0,3,0,0,0,0,0,3,0
270530003004009,10,Victory,3,3,1000000US270530003004009,"Block 4009, Block Group 4, Census Tract 3, Hennepin County, Minnesota",54,52,2,0,0,0,0,0,54,54,52,2,0,0,0,0,0,0,0,0,0,0,0,0,0
270530003003009,10,Victory,3,3,1000000US270530003003009,"Block 3009, Block Group 3, Census Tract 3, Hennepin County, Minnesota",54,39,12,0,1,0,0,2,54,54,39,12,0,1,0,0,2,0,0,0,0,0,0,0,0
270530003001004,10,Victory,3,3,1000000US270530003001004,"Block 1004, Block Group 1, Census Tract 3, Hennepin County, Minnesota",77,48,18,0,4,0,0,7,77,74,48,18,0,4,0,0,4,3,0,0,0,0,0,0,3
270530003003000,10,Victory,3,3,1000000US270530003003000,"Block 3000, Block Group 3, Census Tract 3, Hennepin County, Minnesota",19,11,1,0,0,0,5,2,19,14,11,1,0,0,0,0,2,5,0,0,0,0,0,5,0
270530003001010,10,Victory,3,3,1000000US270530003001010,"Block 1010, Block Group 1, Census Tract 3, Hennepin County, Minnesota",61,54,7,0,0,0,0,0,61,60,53,7,0,0,0,0,0,1,1,0,0,0,0,0,0
270531002001032,10,Victory,3,3,1000000US270531002001032,"Block 1032, Block Group 1, Census Tract 1002, Hennepin County, Minnesota",6,6,0,0,0,0,0,0,6,6,6,0,0,0,0,0,0,0,0,0,0,0,0,0,0
270531002001001,10,Victory,3,3,1000000US270531002001001,"Block 1001, Block Group 1, Census Tract 1002, Hennepin County, Minnesota",40,32,2,0,4,0,0,2,40,40,32,2,0,4,0,0,2,0,0,0,0,0,0,0,0
270530001013015,11,Humboldt Industrial Area,8,8,1000000US270530001013015,"Block 3015, Block Group 3, Census Tract 1.01, Hennepin County, Minnesota",0,0,0,0,0,0,0,0,0,0,0,0,0,0,0,0,0,0,0,0,0,0,0,0,0
270530001013002,11,Humboldt Industrial Area,8,8,1000000US270530001013002,"Block 3002, Block Group 3, Census Tract 1.01, Hennepin County, Minnesota",0,0,0,0,0,0,0,0,0,0,0,0,0,0,0,0,0,0,0,0,0,0,0,0,0
270530001013001,11,Humboldt Industrial Area,8,8,1000000US270530001013001,"Block 3001, Block Group 3, Census Tract 1.01, Hennepin County, Minnesota",0,0,0,0,0,0,0,0,0,0,0,0,0,0,0,0,0,0,0,0,0,0,0,0,0
270530001013000,11,Humboldt Industrial Area,8,8,1000000US270530001013000,"Block 3000, Block Group 3, Census Tract 1.01, Hennepin County, Minnesota",0,0,0,0,0,0,0,0,0,0,0,0,0,0,0,0,0,0,0,0,0,0,0,0,0
270531104004010,12,Howe,63,63,1000000US270531104004010,"Block 4010, Block Group 4, Census Tract 1104, Hennepin County, Minnesota",42,21,6,0,0,0,9,6,42,30,21,6,0,0,0,0,3,12,0,0,0,0,0,9,3
270531104004003,12,Howe,63,63,1000000US270531104004003,"Block 4003, Block Group 4, Census Tract 1104, Hennepin County, Minnesota",117,63,41,5,0,0,0,8,117,112,60,41,5,0,0,0,6,5,3,0,0,0,0,0,2
270531089001005,12,Howe,63,63,1000000US270531089001005,"Block 1005, Block Group 1, Census Tract 1089, Hennepin County, Minnesota",68,61,0,0,0,0,0,7,68,65,58,0,0,0,0,0,7,3,3,0,0,0,0,0,0
270531089001006,12,Howe,63,63,1000000US270531089001006,"Block 1006, Block Group 1, Census Tract 1089, Hennepin County, Minnesota",58,46,0,0,3,0,4,5,58,53,46,0,0,3,0,0,4,5,0,0,0,0,0,4,1
270531089002007,12,Howe,63,63,1000000US270531089002007,"Block 2007, Block Group 2, Census Tract 1089, Hennepin County, Minnesota",60,46,7,2,2,0,0,3,60,60,46,7,2,2,0,0,3,0,0,0,0,0,0,0,0
270531089002000,12,Howe,63,63,1000000US270531089002000,"Block 2000, Block Group 2, Census Tract 1089, Hennepin County, Minnesota",74,63,7,0,1,0,0,3,74,74,63,7,0,1,0,0,3,0,0,0,0,0,0,0,0
270531088001008,12,Howe,63,63,1000000US270531088001008,"Block 1008, Block Group 1, Census Tract 1088, Hennepin County, Minnesota",0,0,0,0,0,0,0,0,0,0,0,0,0,0,0,0,0,0,0,0,0,0,0,0,0
270531088001003,12,Howe,63,63,1000000US270531088001003,"Block 1003, Block Group 1, Census Tract 1088, Hennepin County, Minnesota",28,6,13,4,0,0,0,5,28,24,6,13,0,0,0,0,5,4,0,0,4,0,0,0,0
270531088001004,12,Howe,63,63,1000000US270531088001004,"Block 1004, Block Group 1, Census Tract 1088, Hennepin County, Minnesota",30,23,1,3,0,0,0,3,30,21,17,1,3,0,0,0,0,9,6,0,0,0,0,0,3
270531104004006,12,Howe,63,63,1000000US270531104004006,"Block 4006, Block Group 4, Census Tract 1104, Hennepin County, Minnesota",0,0,0,0,0,0,0,0,0,0,0,0,0,0,0,0,0,0,0,0,0,0,0,0,0
270531088001001,12,Howe,63,63,1000000US270531088001001,"Block 1001, Block Group 1, Census Tract 1088, Hennepin County, Minnesota",76,60,13,0,0,0,0,3,76,65,49,13,0,0,0,0,3,11,11,0,0,0,0,0,0
270531090002012,12,Howe,63,63,1000000US270531090002012,"Block 2012, Block Group 2, Census Tract 1090, Hennepin County, Minnesota",51,50,1,0,0,0,0,0,51,50,49,1,0,0,0,0,0,1,1,0,0,0,0,0,0
270531090002008,12,Howe,63,63,1000000US270531090002008,"Block 2008, Block Group 2, Census Tract 1090, Hennepin County, Minnesota",61,53,3,0,0,0,0,5,61,61,53,3,0,0,0,0,5,0,0,0,0,0,0,0,0
270531090001001,12,Howe,63,63,1000000US270531090001001,"Block 1001, Block Group 1, Census Tract 1090, Hennepin County, Minnesota",61,50,2,0,4,0,1,4,61,60,50,2,0,4,0,0,4,1,0,0,0,0,0,1,0
270531104004009,12,Howe,63,63,1000000US270531104004009,"Block 4009, Block Group 4, Census Tract 1104, Hennepin County, Minnesota",120,60,32,3,1,0,15,9,120,98,56,32,3,1,0,0,6,22,4,0,0,0,0,15,3
270531090002013,12,Howe,63,63,1000000US270531090002013,"Block 2013, Block Group 2, Census Tract 1090, Hennepin County, Minnesota",50,43,1,0,0,0,0,6,50,47,42,1,0,0,0,0,4,3,1,0,0,0,0,0,2
270531090002002,12,Howe,63,63,1000000US270531090002002,"Block 2002, Block Group 2, Census Tract 1090, Hennepin County, Minnesota",0,0,0,0,0,0,0,0,0,0,0,0,0,0,0,0,0,0,0,0,0,0,0,0,0
270531090001003,12,Howe,63,63,1000000US270531090001003,"Block 1003, Block Group 1, Census Tract 1090, Hennepin County, Minnesota",68,65,0,2,0,0,0,1,68,63,62,0,0,0,0,0,1,5,3,0,2,0,0,0,0
270531090002015,12,Howe,63,63,1000000US270531090002015,"Block 2015, Block Group 2, Census Tract 1090, Hennepin County, Minnesota",20,20,0,0,0,0,0,0,20,20,20,0,0,0,0,0,0,0,0,0,0,0,0,0,0
270531090002003,12,Howe,63,63,1000000US270531090002003,"Block 2003, Block Group 2, Census Tract 1090, Hennepin County, Minnesota",0,0,0,0,0,0,0,0,0,0,0,0,0,0,0,0,0,0,0,0,0,0,0,0,0
270531105001004,12,Howe,63,63,1000000US270531105001004,"Block 1004, Block Group 1, Census Tract 1105, Hennepin County, Minnesota",27,26,0,0,1,0,0,0,27,27,26,0,0,1,0,0,0,0,0,0,0,0,0,0,0
270531090002019,12,Howe,63,63,1000000US270531090002019,"Block 2019, Block Group 2, Census Tract 1090, Hennepin County, Minnesota",48,47,0,0,0,0,1,0,48,47,47,0,0,0,0,0,0,1,0,0,0,0,0,1,0
270531090002005,12,Howe,63,63,1000000US270531090002005,"Block 2005, Block Group 2, Census Tract 1090, Hennepin County, Minnesota",89,82,1,0,1,0,1,4,89,88,82,1,0,1,0,0,4,1,0,0,0,0,0,1,0
270531090002006,12,Howe,63,63,1000000US270531090002006,"Block 2006, Block Group 2, Census Tract 1090, Hennepin County, Minnesota",11,10,1,0,0,0,0,0,11,11,10,1,0,0,0,0,0,0,0,0,0,0,0,0,0
270531090002022,12,Howe,63,63,1000000US270531090002022,"Block 2022, Block Group 2, Census Tract 1090, Hennepin County, Minnesota",64,57,1,0,2,0,1,3,64,60,54,1,0,2,0,0,3,4,3,0,0,0,0,1,0
270531090001002,12,Howe,63,63,1000000US270531090001002,"Block 1002, Block Group 1, Census Tract 1090, Hennepin County, Minnesota",57,47,0,0,2,0,6,2,57,50,46,0,0,2,0,0,2,7,1,0,0,0,0,6,0
270531090001005,12,Howe,63,63,1000000US270531090001005,"Block 1005, Block Group 1, Census Tract 1090, Hennepin County, Minnesota",0,0,0,0,0,0,0,0,0,0,0,0,0,0,0,0,0,0,0,0,0,0,0,0,0
270531090001000,12,Howe,63,63,1000000US270531090001000,"Block 1000, Block Group 1, Census Tract 1090, Hennepin County, Minnesota",66,62,0,0,0,0,0,4,66,60,56,0,0,0,0,0,4,6,6,0,0,0,0,0,0
270531090002011,12,Howe,63,63,1000000US270531090002011,"Block 2011, Block Group 2, Census Tract 1090, Hennepin County, Minnesota",58,49,2,0,1,0,0,6,58,57,48,2,0,1,0,0,6,1,1,0,0,0,0,0,0
270531089001007,12,Howe,63,63,1000000US270531089001007,"Block 1007, Block Group 1, Census Tract 1089, Hennepin County, Minnesota",73,46,5,0,1,0,16,5,73,51,40,5,0,1,0,0,5,22,6,0,0,0,0,16,0
270531105001013,12,Howe,63,63,1000000US270531105001013,"Block 1013, Block Group 1, Census Tract 1105, Hennepin County, Minnesota",58,50,0,1,0,0,0,7,58,56,48,0,1,0,0,0,7,2,2,0,0,0,0,0,0
270531104004002,12,Howe,63,63,1000000US270531104004002,"Block 4002, Block Group 4, Census Tract 1104, Hennepin County, Minnesota",76,50,17,1,6,0,2,0,76,71,48,16,1,6,0,0,0,5,2,1,0,0,0,2,0
270531089002001,12,Howe,63,63,1000000US270531089002001,"Block 2001, Block Group 2, Census Tract 1089, Hennepin County, Minnesota",54,49,0,0,0,0,4,1,54,48,47,0,0,0,0,0,1,6,2,0,0,0,0,4,0
270531090002007,12,Howe,63,63,1000000US270531090002007,"Block 2007, Block Group 2, Census Tract 1090, Hennepin County, Minnesota",0,0,0,0,0,0,0,0,0,0,0,0,0,0,0,0,0,0,0,0,0,0,0,0,0
270531089001008,12,Howe,63,63,1000000US270531089001008,"Block 1008, Block Group 1, Census Tract 1089, Hennepin County, Minnesota",56,48,0,0,8,0,0,0,56,56,48,0,0,8,0,0,0,0,0,0,0,0,0,0,0
270531104004001,12,Howe,63,63,1000000US270531104004001,"Block 4001, Block Group 4, Census Tract 1104, Hennepin County, Minnesota",58,56,1,0,0,0,1,0,58,56,55,1,0,0,0,0,0,2,1,0,0,0,0,1,0
270531105001003,12,Howe,63,63,1000000US270531105001003,"Block 1003, Block Group 1, Census Tract 1105, Hennepin County, Minnesota",43,43,0,0,0,0,0,0,43,41,41,0,0,0,0,0,0,2,2,0,0,0,0,0,0
270531105001002,12,Howe,63,63,1000000US270531105001002,"Block 1002, Block Group 1, Census Tract 1105, Hennepin County, Minnesota",0,0,0,0,0,0,0,0,0,0,0,0,0,0,0,0,0,0,0,0,0,0,0,0,0
270531105001000,12,Howe,63,63,1000000US270531105001000,"Block 1000, Block Group 1, Census Tract 1105, Hennepin County, Minnesota",0,0,0,0,0,0,0,0,0,0,0,0,0,0,0,0,0,0,0,0,0,0,0,0,0
270531090001006,12,Howe,63,63,1000000US270531090001006,"Block 1006, Block Group 1, Census Tract 1090, Hennepin County, Minnesota",62,54,4,0,2,0,0,2,62,59,52,4,0,2,0,0,1,3,2,0,0,0,0,0,1
270531090002010,12,Howe,63,63,1000000US270531090002010,"Block 2010, Block Group 2, Census Tract 1090, Hennepin County, Minnesota",72,65,1,0,3,0,0,3,72,71,64,1,0,3,0,0,3,1,1,0,0,0,0,0,0
270531090001007,12,Howe,63,63,1000000US270531090001007,"Block 1007, Block Group 1, Census Tract 1090, Hennepin County, Minnesota",64,51,7,0,4,0,0,2,64,64,51,7,0,4,0,0,2,0,0,0,0,0,0,0,0
270531105001001,12,Howe,63,63,1000000US270531105001001,"Block 1001, Block Group 1, Census Tract 1105, Hennepin County, Minnesota",0,0,0,0,0,0,0,0,0,0,0,0,0,0,0,0,0,0,0,0,0,0,0,0,0
270531090002000,12,Howe,63,63,1000000US270531090002000,"Block 2000, Block Group 2, Census Tract 1090, Hennepin County, Minnesota",0,0,0,0,0,0,0,0,0,0,0,0,0,0,0,0,0,0,0,0,0,0,0,0,0
270531090002001,12,Howe,63,63,1000000US270531090002001,"Block 2001, Block Group 2, Census Tract 1090, Hennepin County, Minnesota",0,0,0,0,0,0,0,0,0,0,0,0,0,0,0,0,0,0,0,0,0,0,0,0,0
270531105001005,12,Howe,63,63,1000000US270531105001005,"Block 1005, Block Group 1, Census Tract 1105, Hennepin County, Minnesota",19,17,0,1,0,0,0,1,19,19,17,0,1,0,0,0,1,0,0,0,0,0,0,0,0
270531089001011,12,Howe,63,63,1000000US270531089001011,"Block 1011, Block Group 1, Census Tract 1089, Hennepin County, Minnesota",45,41,0,0,0,0,0,4,45,44,41,0,0,0,0,0,3,1,0,0,0,0,0,0,1
270531090001011,12,Howe,63,63,1000000US270531090001011,"Block 1011, Block Group 1, Census Tract 1090, Hennepin County, Minnesota",66,60,0,3,0,0,2,1,66,62,60,0,2,0,0,0,0,4,0,0,1,0,0,2,1
270531089001002,12,Howe,63,63,1000000US270531089001002,"Block 1002, Block Group 1, Census Tract 1089, Hennepin County, Minnesota",58,56,1,0,1,0,0,0,58,57,55,1,0,1,0,0,0,1,1,0,0,0,0,0,0
270531089001009,12,Howe,63,63,1000000US270531089001009,"Block 1009, Block Group 1, Census Tract 1089, Hennepin County, Minnesota",31,25,0,0,2,0,1,3,31,30,25,0,0,2,0,0,3,1,0,0,0,0,0,1,0
270531089001010,12,Howe,63,63,1000000US270531089001010,"Block 1010, Block Group 1, Census Tract 1089, Hennepin County, Minnesota",40,30,0,4,6,0,0,0,40,36,30,0,0,6,0,0,0,4,0,0,4,0,0,0,0
270531090001010,12,Howe,63,63,1000000US270531090001010,"Block 1010, Block Group 1, Census Tract 1090, Hennepin County, Minnesota",60,52,4,0,2,0,0,2,60,59,52,3,0,2,0,0,2,1,0,1,0,0,0,0,0
270531090001013,12,Howe,63,63,1000000US270531090001013,"Block 1013, Block Group 1, Census Tract 1090, Hennepin County, Minnesota",55,49,1,4,1,0,0,0,55,55,49,1,4,1,0,0,0,0,0,0,0,0,0,0,0
270531090002017,12,Howe,63,63,1000000US270531090002017,"Block 2017, Block Group 2, Census Tract 1090, Hennepin County, Minnesota",61,55,0,0,0,0,1,5,61,58,55,0,0,0,0,0,3,3,0,0,0,0,0,1,2
270531104001006,12,Howe,63,63,1000000US270531104001006,"Block 1006, Block Group 1, Census Tract 1104, Hennepin County, Minnesota",77,47,10,6,5,0,0,9,77,76,46,10,6,5,0,0,9,1,1,0,0,0,0,0,0
270531090001012,12,Howe,63,63,1000000US270531090001012,"Block 1012, Block Group 1, Census Tract 1090, Hennepin County, Minnesota",45,38,3,0,0,0,0,4,45,45,38,3,0,0,0,0,4,0,0,0,0,0,0,0,0
270531104001001,12,Howe,63,63,1000000US270531104001001,"Block 1001, Block Group 1, Census Tract 1104, Hennepin County, Minnesota",69,60,2,0,2,0,0,5,69,65,56,2,0,2,0,0,5,4,4,0,0,0,0,0,0
270531089001001,12,Howe,63,63,1000000US270531089001001,"Block 1001, Block Group 1, Census Tract 1089, Hennepin County, Minnesota",63,58,2,1,0,0,0,2,63,62,57,2,1,0,0,0,2,1,1,0,0,0,0,0,0
270531089001000,12,Howe,63,63,1000000US270531089001000,"Block 1000, Block Group 1, Census Tract 1089, Hennepin County, Minnesota",69,57,2,0,9,0,0,1,69,68,56,2,0,9,0,0,1,1,1,0,0,0,0,0,0
270531104001004,12,Howe,63,63,1000000US270531104001004,"Block 1004, Block Group 1, Census Tract 1104, Hennepin County, Minnesota",64,58,3,0,3,0,0,0,64,58,52,3,0,3,0,0,0,6,6,0,0,0,0,0,0
270531104001003,12,Howe,63,63,1000000US270531104001003,"Block 1003, Block Group 1, Census Tract 1104, Hennepin County, Minnesota",57,53,4,0,0,0,0,0,57,57,53,4,0,0,0,0,0,0,0,0,0,0,0,0,0
270531104001005,12,Howe,63,63,1000000US270531104001005,"Block 1005, Block Group 1, Census Tract 1104, Hennepin County, Minnesota",74,49,11,0,2,0,6,6,74,67,48,11,0,2,0,0,6,7,1,0,0,0,0,6,0
270531104001009,12,Howe,63,63,1000000US270531104001009,"Block 1009, Block Group 1, Census Tract 1104, Hennepin County, Minnesota",68,65,0,3,0,0,0,0,68,68,65,0,3,0,0,0,0,0,0,0,0,0,0,0,0
270531104001002,12,Howe,63,63,1000000US270531104001002,"Block 1002, Block Group 1, Census Tract 1104, Hennepin County, Minnesota",69,53,6,4,2,0,4,0,69,67,51,6,4,2,0,4,0,2,2,0,0,0,0,0,0
270531090001009,12,Howe,63,63,1000000US270531090001009,"Block 1009, Block Group 1, Census Tract 1090, Hennepin County, Minnesota",77,68,0,2,1,0,0,6,77,75,66,0,2,1,0,0,6,2,2,0,0,0,0,0,0
270531104004000,12,Howe,63,63,1000000US270531104004000,"Block 4000, Block Group 4, Census Tract 1104, Hennepin County, Minnesota",50,46,0,0,0,0,0,4,50,49,45,0,0,0,0,0,4,1,1,0,0,0,0,0,0
270531090001014,12,Howe,63,63,1000000US270531090001014,"Block 1014, Block Group 1, Census Tract 1090, Hennepin County, Minnesota",39,34,3,0,1,0,0,1,39,32,27,3,0,1,0,0,1,7,7,0,0,0,0,0,0
270531105001008,12,Howe,63,63,1000000US270531105001008,"Block 1008, Block Group 1, Census Tract 1105, Hennepin County, Minnesota",62,53,7,1,0,0,0,1,62,57,49,6,1,0,0,0,1,5,4,1,0,0,0,0,0
270531105001012,12,Howe,63,63,1000000US270531105001012,"Block 1012, Block Group 1, Census Tract 1105, Hennepin County, Minnesota",74,55,9,0,4,0,1,5,74,72,54,9,0,4,0,0,5,2,1,0,0,0,0,1,0
270531088002007,12,Howe,63,63,1000000US270531088002007,"Block 2007, Block Group 2, Census Tract 1088, Hennepin County, Minnesota",89,58,16,5,2,0,3,5,89,68,41,16,5,2,0,0,4,21,17,0,0,0,0,3,1
270531089002005,12,Howe,63,63,1000000US270531089002005,"Block 2005, Block Group 2, Census Tract 1089, Hennepin County, Minnesota",65,52,9,3,1,0,0,0,65,61,49,9,2,1,0,0,0,4,3,0,1,0,0,0,0
270531090002018,12,Howe,63,63,1000000US270531090002018,"Block 2018, Block Group 2, Census Tract 1090, Hennepin County, Minnesota",54,51,3,0,0,0,0,0,54,54,51,3,0,0,0,0,0,0,0,0,0,0,0,0,0
270531105001009,12,Howe,63,63,1000000US270531105001009,"Block 1009, Block Group 1, Census Tract 1105, Hennepin County, Minnesota",53,52,0,0,1,0,0,0,53,53,52,0,0,1,0,0,0,0,0,0,0,0,0,0,0
270531105001010,12,Howe,63,63,1000000US270531105001010,"Block 1010, Block Group 1, Census Tract 1105, Hennepin County, Minnesota",54,52,0,2,0,0,0,0,54,45,43,0,2,0,0,0,0,9,9,0,0,0,0,0,0
270531088002012,12,Howe,63,63,1000000US270531088002012,"Block 2012, Block Group 2, Census Tract 1088, Hennepin County, Minnesota",0,0,0,0,0,0,0,0,0,0,0,0,0,0,0,0,0,0,0,0,0,0,0,0,0
270531088002003,12,Howe,63,63,1000000US270531088002003,"Block 2003, Block Group 2, Census Tract 1088, Hennepin County, Minnesota",138,43,48,34,0,0,2,11,138,117,39,48,26,0,0,0,4,21,4,0,8,0,0,2,7
270531088002013,12,Howe,63,63,1000000US270531088002013,"Block 2013, Block Group 2, Census Tract 1088, Hennepin County, Minnesota",0,0,0,0,0,0,0,0,0,0,0,0,0,0,0,0,0,0,0,0,0,0,0,0,0
270531088002008,12,Howe,63,63,1000000US270531088002008,"Block 2008, Block Group 2, Census Tract 1088, Hennepin County, Minnesota",0,0,0,0,0,0,0,0,0,0,0,0,0,0,0,0,0,0,0,0,0,0,0,0,0
270531088002010,12,Howe,63,63,1000000US270531088002010,"Block 2010, Block Group 2, Census Tract 1088, Hennepin County, Minnesota",78,55,2,5,1,0,6,9,78,70,54,1,5,1,0,0,9,8,1,1,0,0,0,6,0
270531089002003,12,Howe,63,63,1000000US270531089002003,"Block 2003, Block Group 2, Census Tract 1089, Hennepin County, Minnesota",56,49,2,0,0,0,1,4,56,54,48,2,0,0,0,0,4,2,1,0,0,0,0,1,0
270531088004023,12,Howe,63,63,1000000US270531088004023,"Block 4023, Block Group 4, Census Tract 1088, Hennepin County, Minnesota",0,0,0,0,0,0,0,0,0,0,0,0,0,0,0,0,0,0,0,0,0,0,0,0,0
270531088002004,12,Howe,63,63,1000000US270531088002004,"Block 2004, Block Group 2, Census Tract 1088, Hennepin County, Minnesota",165,68,39,18,12,0,19,9,165,122,52,39,15,11,0,0,5,43,16,0,3,1,0,19,4
270531088002005,12,Howe,63,63,1000000US270531088002005,"Block 2005, Block Group 2, Census Tract 1088, Hennepin County, Minnesota",26,8,18,0,0,0,0,0,26,26,8,18,0,0,0,0,0,0,0,0,0,0,0,0,0
270531088002006,12,Howe,63,63,1000000US270531088002006,"Block 2006, Block Group 2, Census Tract 1088, Hennepin County, Minnesota",12,5,7,0,0,0,0,0,12,12,5,7,0,0,0,0,0,0,0,0,0,0,0,0,0
270531088002011,12,Howe,63,63,1000000US270531088002011,"Block 2011, Block Group 2, Census Tract 1088, Hennepin County, Minnesota",80,58,10,1,4,0,0,7,80,77,55,10,1,4,0,0,7,3,3,0,0,0,0,0,0
270531088001007,12,Howe,63,63,1000000US270531088001007,"Block 1007, Block Group 1, Census Tract 1088, Hennepin County, Minnesota",0,0,0,0,0,0,0,0,0,0,0,0,0,0,0,0,0,0,0,0,0,0,0,0,0
270531088002009,12,Howe,63,63,1000000US270531088002009,"Block 2009, Block Group 2, Census Tract 1088, Hennepin County, Minnesota",68,45,18,0,0,0,1,4,68,62,41,18,0,0,0,0,3,6,4,0,0,0,0,1,1
270531088002001,12,Howe,63,63,1000000US270531088002001,"Block 2001, Block Group 2, Census Tract 1088, Hennepin County, Minnesota",79,62,2,3,6,0,0,6,79,79,62,2,3,6,0,0,6,0,0,0,0,0,0,0,0
270531088004022,12,Howe,63,63,1000000US270531088004022,"Block 4022, Block Group 4, Census Tract 1088, Hennepin County, Minnesota",0,0,0,0,0,0,0,0,0,0,0,0,0,0,0,0,0,0,0,0,0,0,0,0,0
270531088001006,12,Howe,63,63,1000000US270531088001006,"Block 1006, Block Group 1, Census Tract 1088, Hennepin County, Minnesota",66,36,3,4,10,0,6,7,66,58,35,3,2,10,0,3,5,8,1,0,2,0,0,3,2
270531089002009,12,Howe,63,63,1000000US270531089002009,"Block 2009, Block Group 2, Census Tract 1089, Hennepin County, Minnesota",70,49,19,1,1,0,0,0,70,70,49,19,1,1,0,0,0,0,0,0,0,0,0,0,0
270531089002010,12,Howe,63,63,1000000US270531089002010,"Block 2010, Block Group 2, Census Tract 1089, Hennepin County, Minnesota",60,60,0,0,0,0,0,0,60,59,59,0,0,0,0,0,0,1,1,0,0,0,0,0,0
270531090002004,12,Howe,63,63,1000000US270531090002004,"Block 2004, Block Group 2, Census Tract 1090, Hennepin County, Minnesota",46,46,0,0,0,0,0,0,46,44,44,0,0,0,0,0,0,2,2,0,0,0,0,0,0
270531089001003,12,Howe,63,63,1000000US270531089001003,"Block 1003, Block Group 1, Census Tract 1089, Hennepin County, Minnesota",67,53,2,0,0,0,5,7,67,59,51,1,0,0,0,1,6,8,2,1,0,0,0,4,1
270531105001014,12,Howe,63,63,1000000US270531105001014,"Block 1014, Block Group 1, Census Tract 1105, Hennepin County, Minnesota",45,41,2,0,1,0,0,1,45,45,41,2,0,1,0,0,1,0,0,0,0,0,0,0,0
270531104004007,12,Howe,63,63,1000000US270531104004007,"Block 4007, Block Group 4, Census Tract 1104, Hennepin County, Minnesota",48,41,0,0,1,0,2,4,48,46,41,0,0,1,0,0,4,2,0,0,0,0,0,2,0
270531090001008,12,Howe,63,63,1000000US270531090001008,"Block 1008, Block Group 1, Census Tract 1090, Hennepin County, Minnesota",71,69,0,0,0,0,1,1,71,71,69,0,0,0,0,1,1,0,0,0,0,0,0,0,0
270531088002002,12,Howe,63,63,1000000US270531088002002,"Block 2002, Block Group 2, Census Tract 1088, Hennepin County, Minnesota",83,65,7,1,0,0,5,5,83,77,64,7,1,0,0,0,5,6,1,0,0,0,0,5,0
270531088002000,12,Howe,63,63,1000000US270531088002000,"Block 2000, Block Group 2, Census Tract 1088, Hennepin County, Minnesota",74,45,12,0,0,0,15,2,74,56,43,12,0,0,0,0,1,18,2,0,0,0,0,15,1
270531090002014,12,Howe,63,63,1000000US270531090002014,"Block 2014, Block Group 2, Census Tract 1090, Hennepin County, Minnesota",0,0,0,0,0,0,0,0,0,0,0,0,0,0,0,0,0,0,0,0,0,0,0,0,0
270531104004005,12,Howe,63,63,1000000US270531104004005,"Block 4005, Block Group 4, Census Tract 1104, Hennepin County, Minnesota",0,0,0,0,0,0,0,0,0,0,0,0,0,0,0,0,0,0,0,0,0,0,0,0,0
270531104004004,12,Howe,63,63,1000000US270531104004004,"Block 4004, Block Group 4, Census Tract 1104, Hennepin County, Minnesota",40,21,7,7,2,0,0,3,40,40,21,7,7,2,0,0,3,0,0,0,0,0,0,0,0
270531088001000,12,Howe,63,63,1000000US270531088001000,"Block 1000, Block Group 1, Census Tract 1088, Hennepin County, Minnesota",81,71,0,2,0,0,0,8,81,76,69,0,2,0,0,0,5,5,2,0,0,0,0,0,3
270531104004008,12,Howe,63,63,1000000US270531104004008,"Block 4008, Block Group 4, Census Tract 1104, Hennepin County, Minnesota",97,64,4,21,0,0,6,2,97,81,57,3,19,0,0,0,2,16,7,1,2,0,0,6,0
270531088001002,12,Howe,63,63,1000000US270531088001002,"Block 1002, Block Group 1, Census Tract 1088, Hennepin County, Minnesota",167,76,23,23,10,0,26,9,167,110,53,22,22,10,0,0,3,57,23,1,1,0,0,26,6
270531090001004,12,Howe,63,63,1000000US270531090001004,"Block 1004, Block Group 1, Census Tract 1090, Hennepin County, Minnesota",55,44,0,0,0,0,11,0,55,39,39,0,0,0,0,0,0,16,5,0,0,0,0,11,0
270531089001004,12,Howe,63,63,1000000US270531089001004,"Block 1004, Block Group 1, Census Tract 1089, Hennepin County, Minnesota",66,54,1,3,1,0,1,6,66,65,53,1,3,1,0,1,6,1,1,0,0,0,0,0,0
270531105001006,12,Howe,63,63,1000000US270531105001006,"Block 1006, Block Group 1, Census Tract 1105, Hennepin County, Minnesota",71,62,0,3,3,0,0,3,71,71,62,0,3,3,0,0,3,0,0,0,0,0,0,0,0
270531090002020,12,Howe,63,63,1000000US270531090002020,"Block 2020, Block Group 2, Census Tract 1090, Hennepin County, Minnesota",44,41,2,0,0,0,0,1,44,42,39,2,0,0,0,0,1,2,2,0,0,0,0,0,0
270531090002021,12,Howe,63,63,1000000US270531090002021,"Block 2021, Block Group 2, Census Tract 1090, Hennepin County, Minnesota",49,48,1,0,0,0,0,0,49,49,48,1,0,0,0,0,0,0,0,0,0,0,0,0,0
270531104001007,12,Howe,63,63,1000000US270531104001007,"Block 1007, Block Group 1, Census Tract 1104, Hennepin County, Minnesota",74,62,1,0,3,0,8,0,74,65,61,1,0,3,0,0,0,9,1,0,0,0,0,8,0
270531104001000,12,Howe,63,63,1000000US270531104001000,"Block 1000, Block Group 1, Census Tract 1104, Hennepin County, Minnesota",69,61,0,4,1,0,1,2,69,67,61,0,4,1,0,0,1,2,0,0,0,0,0,1,1
270531090001015,12,Howe,63,63,1000000US270531090001015,"Block 1015, Block Group 1, Census Tract 1090, Hennepin County, Minnesota",0,0,0,0,0,0,0,0,0,0,0,0,0,0,0,0,0,0,0,0,0,0,0,0,0
270531105001007,12,Howe,63,63,1000000US270531105001007,"Block 1007, Block Group 1, Census Tract 1105, Hennepin County, Minnesota",57,53,0,0,0,0,0,4,57,57,53,0,0,0,0,0,4,0,0,0,0,0,0,0,0
270531104001008,12,Howe,63,63,1000000US270531104001008,"Block 1008, Block Group 1, Census Tract 1104, Hennepin County, Minnesota",78,56,8,7,0,0,3,4,78,69,55,8,5,0,0,0,1,9,1,0,2,0,0,3,3
270531105001011,12,Howe,63,63,1000000US270531105001011,"Block 1011, Block Group 1, Census Tract 1105, Hennepin County, Minnesota",56,52,0,0,4,0,0,0,56,56,52,0,0,4,0,0,0,0,0,0,0,0,0,0,0
270531089002004,12,Howe,63,63,1000000US270531089002004,"Block 2004, Block Group 2, Census Tract 1089, Hennepin County, Minnesota",74,69,0,0,1,0,0,4,74,73,69,0,0,1,0,0,3,1,0,0,0,0,0,0,1
270531088001005,12,Howe,63,63,1000000US270531088001005,"Block 1005, Block Group 1, Census Tract 1088, Hennepin County, Minnesota",226,74,74,11,1,0,59,7,226,155,62,74,11,1,0,0,7,71,12,0,0,0,0,59,0
270531090002009,12,Howe,63,63,1000000US270531090002009,"Block 2009, Block Group 2, Census Tract 1090, Hennepin County, Minnesota",55,52,0,0,3,0,0,0,55,54,51,0,0,3,0,0,0,1,1,0,0,0,0,0,0
270531090002016,12,Howe,63,63,1000000US270531090002016,"Block 2016, Block Group 2, Census Tract 1090, Hennepin County, Minnesota",66,63,0,0,0,0,0,3,66,64,62,0,0,0,0,0,2,2,1,0,0,0,0,0,1
270531089002008,12,Howe,63,63,1000000US270531089002008,"Block 2008, Block Group 2, Census Tract 1089, Hennepin County, Minnesota",71,70,0,0,0,0,0,1,71,71,70,0,0,0,0,0,1,0,0,0,0,0,0,0,0
270531089002006,12,Howe,63,63,1000000US270531089002006,"Block 2006, Block Group 2, Census Tract 1089, Hennepin County, Minnesota",53,42,0,0,8,0,0,3,53,52,41,0,0,8,0,0,3,1,1,0,0,0,0,0,0
270531089002002,12,Howe,63,63,1000000US270531089002002,"Block 2002, Block Group 2, Census Tract 1089, Hennepin County, Minnesota",0,0,0,0,0,0,0,0,0,0,0,0,0,0,0,0,0,0,0,0,0,0,0,0,0
270531104003005,13,Hiawatha,64,64,1000000US270531104003005,"Block 3005, Block Group 3, Census Tract 1104, Hennepin County, Minnesota",0,0,0,0,0,0,0,0,0,0,0,0,0,0,0,0,0,0,0,0,0,0,0,0,0
270531104003013,13,Hiawatha,64,64,1000000US270531104003013,"Block 3013, Block Group 3, Census Tract 1104, Hennepin County, Minnesota",25,24,0,0,0,0,0,1,25,23,22,0,0,0,0,0,1,2,2,0,0,0,0,0,0
270531104003003,13,Hiawatha,64,64,1000000US270531104003003,"Block 3003, Block Group 3, Census Tract 1104, Hennepin County, Minnesota",85,51,18,2,3,0,9,2,85,77,51,18,2,3,0,1,2,8,0,0,0,0,0,8,0
270531105002021,13,Hiawatha,64,64,1000000US270531105002021,"Block 2021, Block Group 2, Census Tract 1105, Hennepin County, Minnesota",355,333,15,2,1,1,1,2,355,354,333,15,2,1,1,0,2,1,0,0,0,0,0,1,0
270531105002030,13,Hiawatha,64,64,1000000US270531105002030,"Block 2030, Block Group 2, Census Tract 1105, Hennepin County, Minnesota",0,0,0,0,0,0,0,0,0,0,0,0,0,0,0,0,0,0,0,0,0,0,0,0,0
270531105002005,13,Hiawatha,64,64,1000000US270531105002005,"Block 2005, Block Group 2, Census Tract 1105, Hennepin County, Minnesota",66,59,0,1,2,0,0,4,66,63,57,0,1,2,0,0,3,3,2,0,0,0,0,0,1
270531105002002,13,Hiawatha,64,64,1000000US270531105002002,"Block 2002, Block Group 2, Census Tract 1105, Hennepin County, Minnesota",0,0,0,0,0,0,0,0,0,0,0,0,0,0,0,0,0,0,0,0,0,0,0,0,0
270531104003014,13,Hiawatha,64,64,1000000US270531104003014,"Block 3014, Block Group 3, Census Tract 1104, Hennepin County, Minnesota",0,0,0,0,0,0,0,0,0,0,0,0,0,0,0,0,0,0,0,0,0,0,0,0,0
270531105004006,13,Hiawatha,64,64,1000000US270531105004006,"Block 4006, Block Group 4, Census Tract 1105, Hennepin County, Minnesota",57,55,0,0,0,0,1,1,57,57,55,0,0,0,0,1,1,0,0,0,0,0,0,0,0
270531105005001,13,Hiawatha,64,64,1000000US270531105005001,"Block 5001, Block Group 5, Census Tract 1105, Hennepin County, Minnesota",0,0,0,0,0,0,0,0,0,0,0,0,0,0,0,0,0,0,0,0,0,0,0,0,0
270531105002015,13,Hiawatha,64,64,1000000US270531105002015,"Block 2015, Block Group 2, Census Tract 1105, Hennepin County, Minnesota",0,0,0,0,0,0,0,0,0,0,0,0,0,0,0,0,0,0,0,0,0,0,0,0,0
270531105002014,13,Hiawatha,64,64,1000000US270531105002014,"Block 2014, Block Group 2, Census Tract 1105, Hennepin County, Minnesota",44,44,0,0,0,0,0,0,44,44,44,0,0,0,0,0,0,0,0,0,0,0,0,0,0
270531105002022,13,Hiawatha,64,64,1000000US270531105002022,"Block 2022, Block Group 2, Census Tract 1105, Hennepin County, Minnesota",0,0,0,0,0,0,0,0,0,0,0,0,0,0,0,0,0,0,0,0,0,0,0,0,0
270531105002023,13,Hiawatha,64,64,1000000US270531105002023,"Block 2023, Block Group 2, Census Tract 1105, Hennepin County, Minnesota",0,0,0,0,0,0,0,0,0,0,0,0,0,0,0,0,0,0,0,0,0,0,0,0,0
270531105005005,13,Hiawatha,64,64,1000000US270531105005005,"Block 5005, Block Group 5, Census Tract 1105, Hennepin County, Minnesota",58,58,0,0,0,0,0,0,58,56,56,0,0,0,0,0,0,2,2,0,0,0,0,0,0
270531104003004,13,Hiawatha,64,64,1000000US270531104003004,"Block 3004, Block Group 3, Census Tract 1104, Hennepin County, Minnesota",32,31,0,0,1,0,0,0,32,30,29,0,0,1,0,0,0,2,2,0,0,0,0,0,0
270531104003007,13,Hiawatha,64,64,1000000US270531104003007,"Block 3007, Block Group 3, Census Tract 1104, Hennepin County, Minnesota",0,0,0,0,0,0,0,0,0,0,0,0,0,0,0,0,0,0,0,0,0,0,0,0,0
270531104003008,13,Hiawatha,64,64,1000000US270531104003008,"Block 3008, Block Group 3, Census Tract 1104, Hennepin County, Minnesota",23,21,2,0,0,0,0,0,23,23,21,2,0,0,0,0,0,0,0,0,0,0,0,0,0
270531105005014,13,Hiawatha,64,64,1000000US270531105005014,"Block 5014, Block Group 5, Census Tract 1105, Hennepin County, Minnesota",49,47,0,1,0,0,1,0,49,47,47,0,0,0,0,0,0,2,0,0,1,0,0,1,0
270531105005016,13,Hiawatha,64,64,1000000US270531105005016,"Block 5016, Block Group 5, Census Tract 1105, Hennepin County, Minnesota",61,56,0,0,3,0,2,0,61,58,55,0,0,3,0,0,0,3,1,0,0,0,0,2,0
270531105005002,13,Hiawatha,64,64,1000000US270531105005002,"Block 5002, Block Group 5, Census Tract 1105, Hennepin County, Minnesota",0,0,0,0,0,0,0,0,0,0,0,0,0,0,0,0,0,0,0,0,0,0,0,0,0
270531105005012,13,Hiawatha,64,64,1000000US270531105005012,"Block 5012, Block Group 5, Census Tract 1105, Hennepin County, Minnesota",77,73,0,0,3,0,1,0,77,76,73,0,0,3,0,0,0,1,0,0,0,0,0,1,0
270531105002025,13,Hiawatha,64,64,1000000US270531105002025,"Block 2025, Block Group 2, Census Tract 1105, Hennepin County, Minnesota",0,0,0,0,0,0,0,0,0,0,0,0,0,0,0,0,0,0,0,0,0,0,0,0,0
270531105002004,13,Hiawatha,64,64,1000000US270531105002004,"Block 2004, Block Group 2, Census Tract 1105, Hennepin County, Minnesota",64,61,0,0,3,0,0,0,64,60,57,0,0,3,0,0,0,4,4,0,0,0,0,0,0
270531105002028,13,Hiawatha,64,64,1000000US270531105002028,"Block 2028, Block Group 2, Census Tract 1105, Hennepin County, Minnesota",44,34,8,1,0,0,0,1,44,44,34,8,1,0,0,0,1,0,0,0,0,0,0,0,0
270531105004001,13,Hiawatha,64,64,1000000US270531105004001,"Block 4001, Block Group 4, Census Tract 1105, Hennepin County, Minnesota",54,53,0,0,1,0,0,0,54,53,52,0,0,1,0,0,0,1,1,0,0,0,0,0,0
270531105002003,13,Hiawatha,64,64,1000000US270531105002003,"Block 2003, Block Group 2, Census Tract 1105, Hennepin County, Minnesota",66,60,0,0,0,0,6,0,66,59,59,0,0,0,0,0,0,7,1,0,0,0,0,6,0
270531105002027,13,Hiawatha,64,64,1000000US270531105002027,"Block 2027, Block Group 2, Census Tract 1105, Hennepin County, Minnesota",0,0,0,0,0,0,0,0,0,0,0,0,0,0,0,0,0,0,0,0,0,0,0,0,0
270531105003020,13,Hiawatha,64,64,1000000US270531105003020,"Block 3020, Block Group 3, Census Tract 1105, Hennepin County, Minnesota",0,0,0,0,0,0,0,0,0,0,0,0,0,0,0,0,0,0,0,0,0,0,0,0,0
270531104003015,13,Hiawatha,64,64,1000000US270531104003015,"Block 3015, Block Group 3, Census Tract 1104, Hennepin County, Minnesota",41,36,0,0,0,0,0,5,41,41,36,0,0,0,0,0,5,0,0,0,0,0,0,0,0
270531104002011,13,Hiawatha,64,64,1000000US270531104002011,"Block 2011, Block Group 2, Census Tract 1104, Hennepin County, Minnesota",69,53,1,3,0,0,9,3,69,58,53,1,3,0,0,0,1,11,0,0,0,0,0,9,2
270531104002009,13,Hiawatha,64,64,1000000US270531104002009,"Block 2009, Block Group 2, Census Tract 1104, Hennepin County, Minnesota",65,53,4,1,2,0,0,5,65,65,53,4,1,2,0,0,5,0,0,0,0,0,0,0,0
270531104002007,13,Hiawatha,64,64,1000000US270531104002007,"Block 2007, Block Group 2, Census Tract 1104, Hennepin County, Minnesota",51,40,0,0,0,0,7,4,51,42,38,0,0,0,0,0,4,9,2,0,0,0,0,7,0
270531105004003,13,Hiawatha,64,64,1000000US270531105004003,"Block 4003, Block Group 4, Census Tract 1105, Hennepin County, Minnesota",0,0,0,0,0,0,0,0,0,0,0,0,0,0,0,0,0,0,0,0,0,0,0,0,0
270531104003011,13,Hiawatha,64,64,1000000US270531104003011,"Block 3011, Block Group 3, Census Tract 1104, Hennepin County, Minnesota",0,0,0,0,0,0,0,0,0,0,0,0,0,0,0,0,0,0,0,0,0,0,0,0,0
270531104002002,13,Hiawatha,64,64,1000000US270531104002002,"Block 2002, Block Group 2, Census Tract 1104, Hennepin County, Minnesota",61,60,0,0,0,0,1,0,61,60,60,0,0,0,0,0,0,1,0,0,0,0,0,1,0
270531104002006,13,Hiawatha,64,64,1000000US270531104002006,"Block 2006, Block Group 2, Census Tract 1104, Hennepin County, Minnesota",56,47,0,0,6,0,3,0,56,55,47,0,0,6,0,2,0,1,0,0,0,0,0,1,0
270531104002008,13,Hiawatha,64,64,1000000US270531104002008,"Block 2008, Block Group 2, Census Tract 1104, Hennepin County, Minnesota",72,56,5,5,0,0,2,4,72,70,56,5,5,0,0,0,4,2,0,0,0,0,0,2,0
270531105005010,13,Hiawatha,64,64,1000000US270531105005010,"Block 5010, Block Group 5, Census Tract 1105, Hennepin County, Minnesota",57,52,1,1,0,0,0,3,57,56,52,1,0,0,0,0,3,1,0,0,1,0,0,0,0
270531105003005,13,Hiawatha,64,64,1000000US270531105003005,"Block 3005, Block Group 3, Census Tract 1105, Hennepin County, Minnesota",0,0,0,0,0,0,0,0,0,0,0,0,0,0,0,0,0,0,0,0,0,0,0,0,0
270531104003001,13,Hiawatha,64,64,1000000US270531104003001,"Block 3001, Block Group 3, Census Tract 1104, Hennepin County, Minnesota",63,49,1,0,0,0,7,6,63,50,48,1,0,0,0,0,1,13,1,0,0,0,0,7,5
270531104003016,13,Hiawatha,64,64,1000000US270531104003016,"Block 3016, Block Group 3, Census Tract 1104, Hennepin County, Minnesota",101,82,11,3,1,0,1,3,101,101,82,11,3,1,0,1,3,0,0,0,0,0,0,0,0
270531104003000,13,Hiawatha,64,64,1000000US270531104003000,"Block 3000, Block Group 3, Census Tract 1104, Hennepin County, Minnesota",57,46,3,0,2,0,6,0,57,51,46,3,0,2,0,0,0,6,0,0,0,0,0,6,0
270531104003010,13,Hiawatha,64,64,1000000US270531104003010,"Block 3010, Block Group 3, Census Tract 1104, Hennepin County, Minnesota",101,61,19,0,6,0,6,9,101,91,61,19,0,6,0,0,5,10,0,0,0,0,0,6,4
270531104003012,13,Hiawatha,64,64,1000000US270531104003012,"Block 3012, Block Group 3, Census Tract 1104, Hennepin County, Minnesota",69,60,7,0,0,0,1,1,69,68,60,7,0,0,0,0,1,1,0,0,0,0,0,1,0
270531104002004,13,Hiawatha,64,64,1000000US270531104002004,"Block 2004, Block Group 2, Census Tract 1104, Hennepin County, Minnesota",75,69,1,1,4,0,0,0,75,69,63,1,1,4,0,0,0,6,6,0,0,0,0,0,0
270531104002005,13,Hiawatha,64,64,1000000US270531104002005,"Block 2005, Block Group 2, Census Tract 1104, Hennepin County, Minnesota",57,45,9,1,1,0,0,1,57,57,45,9,1,1,0,0,1,0,0,0,0,0,0,0,0
270531104003002,13,Hiawatha,64,64,1000000US270531104003002,"Block 3002, Block Group 3, Census Tract 1104, Hennepin County, Minnesota",0,0,0,0,0,0,0,0,0,0,0,0,0,0,0,0,0,0,0,0,0,0,0,0,0
270531105005008,13,Hiawatha,64,64,1000000US270531105005008,"Block 5008, Block Group 5, Census Tract 1105, Hennepin County, Minnesota",59,47,3,4,0,0,3,2,59,52,44,3,4,0,0,0,1,7,3,0,0,0,0,3,1
270531105005007,13,Hiawatha,64,64,1000000US270531105005007,"Block 5007, Block Group 5, Census Tract 1105, Hennepin County, Minnesota",74,64,3,3,3,0,0,1,74,73,63,3,3,3,0,0,1,1,1,0,0,0,0,0,0
270531105004002,13,Hiawatha,64,64,1000000US270531105004002,"Block 4002, Block Group 4, Census Tract 1105, Hennepin County, Minnesota",45,41,0,0,2,0,0,2,45,44,40,0,0,2,0,0,2,1,1,0,0,0,0,0,0
270531104002010,13,Hiawatha,64,64,1000000US270531104002010,"Block 2010, Block Group 2, Census Tract 1104, Hennepin County, Minnesota",54,51,2,1,0,0,0,0,54,53,50,2,1,0,0,0,0,1,1,0,0,0,0,0,0
270531105005009,13,Hiawatha,64,64,1000000US270531105005009,"Block 5009, Block Group 5, Census Tract 1105, Hennepin County, Minnesota",66,59,0,3,0,0,4,0,66,62,59,0,3,0,0,0,0,4,0,0,0,0,0,4,0
270531105003007,13,Hiawatha,64,64,1000000US270531105003007,"Block 3007, Block Group 3, Census Tract 1105, Hennepin County, Minnesota",24,6,4,4,0,0,10,0,24,12,4,4,4,0,0,0,0,12,2,0,0,0,0,10,0
270531105004005,13,Hiawatha,64,64,1000000US270531105004005,"Block 4005, Block Group 4, Census Tract 1105, Hennepin County, Minnesota",54,52,0,0,0,0,0,2,54,54,52,0,0,0,0,0,2,0,0,0,0,0,0,0,0
270531105002006,13,Hiawatha,64,64,1000000US270531105002006,"Block 2006, Block Group 2, Census Tract 1105, Hennepin County, Minnesota",80,59,9,2,2,0,0,8,80,76,55,9,2,2,0,0,8,4,4,0,0,0,0,0,0
270531105002019,13,Hiawatha,64,64,1000000US270531105002019,"Block 2019, Block Group 2, Census Tract 1105, Hennepin County, Minnesota",0,0,0,0,0,0,0,0,0,0,0,0,0,0,0,0,0,0,0,0,0,0,0,0,0
270531105003006,13,Hiawatha,64,64,1000000US270531105003006,"Block 3006, Block Group 3, Census Tract 1105, Hennepin County, Minnesota",0,0,0,0,0,0,0,0,0,0,0,0,0,0,0,0,0,0,0,0,0,0,0,0,0
270531105003016,13,Hiawatha,64,64,1000000US270531105003016,"Block 3016, Block Group 3, Census Tract 1105, Hennepin County, Minnesota",0,0,0,0,0,0,0,0,0,0,0,0,0,0,0,0,0,0,0,0,0,0,0,0,0
270531105003019,13,Hiawatha,64,64,1000000US270531105003019,"Block 3019, Block Group 3, Census Tract 1105, Hennepin County, Minnesota",97,80,6,0,0,0,2,9,97,87,73,6,0,0,0,0,8,10,7,0,0,0,0,2,1
270531105002011,13,Hiawatha,64,64,1000000US270531105002011,"Block 2011, Block Group 2, Census Tract 1105, Hennepin County, Minnesota",64,54,0,0,7,0,3,0,64,61,54,0,0,7,0,0,0,3,0,0,0,0,0,3,0
270531105003008,13,Hiawatha,64,64,1000000US270531105003008,"Block 3008, Block Group 3, Census Tract 1105, Hennepin County, Minnesota",160,100,35,6,0,0,10,9,160,143,92,35,6,0,0,1,9,17,8,0,0,0,0,9,0
270531105002033,13,Hiawatha,64,64,1000000US270531105002033,"Block 2033, Block Group 2, Census Tract 1105, Hennepin County, Minnesota",0,0,0,0,0,0,0,0,0,0,0,0,0,0,0,0,0,0,0,0,0,0,0,0,0
270531105003004,13,Hiawatha,64,64,1000000US270531105003004,"Block 3004, Block Group 3, Census Tract 1105, Hennepin County, Minnesota",190,144,14,7,20,0,0,5,190,185,139,14,7,20,0,0,5,5,5,0,0,0,0,0,0
270531105003012,13,Hiawatha,64,64,1000000US270531105003012,"Block 3012, Block Group 3, Census Tract 1105, Hennepin County, Minnesota",68,57,0,2,7,0,0,2,68,68,57,0,2,7,0,0,2,0,0,0,0,0,0,0,0
270531105002024,13,Hiawatha,64,64,1000000US270531105002024,"Block 2024, Block Group 2, Census Tract 1105, Hennepin County, Minnesota",0,0,0,0,0,0,0,0,0,0,0,0,0,0,0,0,0,0,0,0,0,0,0,0,0
270531105003003,13,Hiawatha,64,64,1000000US270531105003003,"Block 3003, Block Group 3, Census Tract 1105, Hennepin County, Minnesota",116,51,45,5,0,0,11,4,116,96,44,45,4,0,0,0,3,20,7,0,1,0,0,11,1
270531105003000,13,Hiawatha,64,64,1000000US270531105003000,"Block 3000, Block Group 3, Census Tract 1105, Hennepin County, Minnesota",57,46,2,0,4,0,5,0,57,45,40,1,0,4,0,0,0,12,6,1,0,0,0,5,0
270531105004007,13,Hiawatha,64,64,1000000US270531105004007,"Block 4007, Block Group 4, Census Tract 1105, Hennepin County, Minnesota",70,56,0,1,2,0,7,4,70,62,55,0,1,2,0,0,4,8,1,0,0,0,0,7,0
270531105002016,13,Hiawatha,64,64,1000000US270531105002016,"Block 2016, Block Group 2, Census Tract 1105, Hennepin County, Minnesota",44,41,1,0,0,0,0,2,44,44,41,1,0,0,0,0,2,0,0,0,0,0,0,0,0
270531105003017,13,Hiawatha,64,64,1000000US270531105003017,"Block 3017, Block Group 3, Census Tract 1105, Hennepin County, Minnesota",0,0,0,0,0,0,0,0,0,0,0,0,0,0,0,0,0,0,0,0,0,0,0,0,0
270531105002009,13,Hiawatha,64,64,1000000US270531105002009,"Block 2009, Block Group 2, Census Tract 1105, Hennepin County, Minnesota",63,62,1,0,0,0,0,0,63,63,62,1,0,0,0,0,0,0,0,0,0,0,0,0,0
270531104003006,13,Hiawatha,64,64,1000000US270531104003006,"Block 3006, Block Group 3, Census Tract 1104, Hennepin County, Minnesota",0,0,0,0,0,0,0,0,0,0,0,0,0,0,0,0,0,0,0,0,0,0,0,0,0
270531105002026,13,Hiawatha,64,64,1000000US270531105002026,"Block 2026, Block Group 2, Census Tract 1105, Hennepin County, Minnesota",0,0,0,0,0,0,0,0,0,0,0,0,0,0,0,0,0,0,0,0,0,0,0,0,0
270531105005013,13,Hiawatha,64,64,1000000US270531105005013,"Block 5013, Block Group 5, Census Tract 1105, Hennepin County, Minnesota",65,56,5,0,2,0,0,2,65,63,54,5,0,2,0,0,2,2,2,0,0,0,0,0,0
270531105005003,13,Hiawatha,64,64,1000000US270531105005003,"Block 5003, Block Group 5, Census Tract 1105, Hennepin County, Minnesota",70,60,0,0,4,0,0,6,70,70,60,0,0,4,0,0,6,0,0,0,0,0,0,0,0
270531105005015,13,Hiawatha,64,64,1000000US270531105005015,"Block 5015, Block Group 5, Census Tract 1105, Hennepin County, Minnesota",62,60,0,0,2,0,0,0,62,60,58,0,0,2,0,0,0,2,2,0,0,0,0,0,0
270531104002001,13,Hiawatha,64,64,1000000US270531104002001,"Block 2001, Block Group 2, Census Tract 1104, Hennepin County, Minnesota",60,53,6,0,0,0,0,1,60,54,47,6,0,0,0,0,1,6,6,0,0,0,0,0,0
270531104002000,13,Hiawatha,64,64,1000000US270531104002000,"Block 2000, Block Group 2, Census Tract 1104, Hennepin County, Minnesota",72,50,10,8,0,0,0,4,72,67,46,9,8,0,0,0,4,5,4,1,0,0,0,0,0
270531105005006,13,Hiawatha,64,64,1000000US270531105005006,"Block 5006, Block Group 5, Census Tract 1105, Hennepin County, Minnesota",70,66,1,0,2,0,0,1,70,70,66,1,0,2,0,0,1,0,0,0,0,0,0,0,0
270531105002035,13,Hiawatha,64,64,1000000US270531105002035,"Block 2035, Block Group 2, Census Tract 1105, Hennepin County, Minnesota",0,0,0,0,0,0,0,0,0,0,0,0,0,0,0,0,0,0,0,0,0,0,0,0,0
270531105003002,13,Hiawatha,64,64,1000000US270531105003002,"Block 3002, Block Group 3, Census Tract 1105, Hennepin County, Minnesota",86,68,7,0,0,0,2,9,86,82,68,7,0,0,0,0,7,4,0,0,0,0,0,2,2
270531105003009,13,Hiawatha,64,64,1000000US270531105003009,"Block 3009, Block Group 3, Census Tract 1105, Hennepin County, Minnesota",35,26,4,0,4,0,1,0,35,32,24,4,0,4,0,0,0,3,2,0,0,0,0,1,0
270531105002032,13,Hiawatha,64,64,1000000US270531105002032,"Block 2032, Block Group 2, Census Tract 1105, Hennepin County, Minnesota",0,0,0,0,0,0,0,0,0,0,0,0,0,0,0,0,0,0,0,0,0,0,0,0,0
270531105004004,13,Hiawatha,64,64,1000000US270531105004004,"Block 4004, Block Group 4, Census Tract 1105, Hennepin County, Minnesota",64,57,3,1,1,0,0,2,64,61,54,3,1,1,0,0,2,3,3,0,0,0,0,0,0
270531105002007,13,Hiawatha,64,64,1000000US270531105002007,"Block 2007, Block Group 2, Census Tract 1105, Hennepin County, Minnesota",64,52,8,0,0,0,4,0,64,62,51,8,0,0,0,3,0,2,1,0,0,0,0,1,0
270531105002010,13,Hiawatha,64,64,1000000US270531105002010,"Block 2010, Block Group 2, Census Tract 1105, Hennepin County, Minnesota",60,57,1,0,2,0,0,0,60,60,57,1,0,2,0,0,0,0,0,0,0,0,0,0,0
270531105002017,13,Hiawatha,64,64,1000000US270531105002017,"Block 2017, Block Group 2, Census Tract 1105, Hennepin County, Minnesota",55,55,0,0,0,0,0,0,55,55,55,0,0,0,0,0,0,0,0,0,0,0,0,0,0
270531104003009,13,Hiawatha,64,64,1000000US270531104003009,"Block 3009, Block Group 3, Census Tract 1104, Hennepin County, Minnesota",38,31,2,4,0,0,0,1,38,35,28,2,4,0,0,0,1,3,3,0,0,0,0,0,0
270531105002013,13,Hiawatha,64,64,1000000US270531105002013,"Block 2013, Block Group 2, Census Tract 1105, Hennepin County, Minnesota",76,70,0,0,2,0,1,3,76,72,70,0,0,2,0,0,0,4,0,0,0,0,0,1,3
270531105002020,13,Hiawatha,64,64,1000000US270531105002020,"Block 2020, Block Group 2, Census Tract 1105, Hennepin County, Minnesota",0,0,0,0,0,0,0,0,0,0,0,0,0,0,0,0,0,0,0,0,0,0,0,0,0
270531105004000,13,Hiawatha,64,64,1000000US270531105004000,"Block 4000, Block Group 4, Census Tract 1105, Hennepin County, Minnesota",256,254,0,0,0,0,0,2,256,256,254,0,0,0,0,0,2,0,0,0,0,0,0,0,0
270531105005000,13,Hiawatha,64,64,1000000US270531105005000,"Block 5000, Block Group 5, Census Tract 1105, Hennepin County, Minnesota",0,0,0,0,0,0,0,0,0,0,0,0,0,0,0,0,0,0,0,0,0,0,0,0,0
270531104002003,13,Hiawatha,64,64,1000000US270531104002003,"Block 2003, Block Group 2, Census Tract 1104, Hennepin County, Minnesota",59,49,0,1,6,0,0,3,59,51,42,0,0,6,0,0,3,8,7,0,1,0,0,0,0
270531105005011,13,Hiawatha,64,64,1000000US270531105005011,"Block 5011, Block Group 5, Census Tract 1105, Hennepin County, Minnesota",60,56,0,0,3,0,1,0,60,57,54,0,0,3,0,0,0,3,2,0,0,0,0,1,0
270531105003015,13,Hiawatha,64,64,1000000US270531105003015,"Block 3015, Block Group 3, Census Tract 1105, Hennepin County, Minnesota",102,79,9,0,5,0,4,5,102,97,78,9,0,5,0,0,5,5,1,0,0,0,0,4,0
270531105003014,13,Hiawatha,64,64,1000000US270531105003014,"Block 3014, Block Group 3, Census Tract 1105, Hennepin County, Minnesota",77,64,0,2,1,0,8,2,77,69,64,0,2,1,0,0,2,8,0,0,0,0,0,8,0
270531105003013,13,Hiawatha,64,64,1000000US270531105003013,"Block 3013, Block Group 3, Census Tract 1105, Hennepin County, Minnesota",63,45,6,0,0,0,7,5,63,55,45,5,0,0,0,0,5,8,0,1,0,0,0,7,0
270531105003018,13,Hiawatha,64,64,1000000US270531105003018,"Block 3018, Block Group 3, Census Tract 1105, Hennepin County, Minnesota",50,36,7,3,0,0,0,4,50,50,36,7,3,0,0,0,4,0,0,0,0,0,0,0,0
270531105003001,13,Hiawatha,64,64,1000000US270531105003001,"Block 3001, Block Group 3, Census Tract 1105, Hennepin County, Minnesota",56,50,0,2,0,0,0,4,56,52,50,0,1,0,0,0,1,4,0,0,1,0,0,0,3
270531105003010,13,Hiawatha,64,64,1000000US270531105003010,"Block 3010, Block Group 3, Census Tract 1105, Hennepin County, Minnesota",65,56,3,0,0,0,5,1,65,58,54,3,0,0,0,0,1,7,2,0,0,0,0,5,0
270531105003011,13,Hiawatha,64,64,1000000US270531105003011,"Block 3011, Block Group 3, Census Tract 1105, Hennepin County, Minnesota",52,48,2,0,1,0,0,1,52,51,48,2,0,1,0,0,0,1,0,0,0,0,0,0,1
270531105002008,13,Hiawatha,64,64,1000000US270531105002008,"Block 2008, Block Group 2, Census Tract 1105, Hennepin County, Minnesota",48,41,1,0,0,0,0,6,48,48,41,1,0,0,0,0,6,0,0,0,0,0,0,0,0
270531105005004,13,Hiawatha,64,64,1000000US270531105005004,"Block 5004, Block Group 5, Census Tract 1105, Hennepin County, Minnesota",38,33,0,0,2,0,0,3,38,38,33,0,0,2,0,0,3,0,0,0,0,0,0,0,0
270531105002031,13,Hiawatha,64,64,1000000US270531105002031,"Block 2031, Block Group 2, Census Tract 1105, Hennepin County, Minnesota",0,0,0,0,0,0,0,0,0,0,0,0,0,0,0,0,0,0,0,0,0,0,0,0,0
270531105002000,13,Hiawatha,64,64,1000000US270531105002000,"Block 2000, Block Group 2, Census Tract 1105, Hennepin County, Minnesota",0,0,0,0,0,0,0,0,0,0,0,0,0,0,0,0,0,0,0,0,0,0,0,0,0
270531105002018,13,Hiawatha,64,64,1000000US270531105002018,"Block 2018, Block Group 2, Census Tract 1105, Hennepin County, Minnesota",75,70,3,0,0,0,0,2,75,72,68,3,0,0,0,0,1,3,2,0,0,0,0,0,1
270531105002001,13,Hiawatha,64,64,1000000US270531105002001,"Block 2001, Block Group 2, Census Tract 1105, Hennepin County, Minnesota",0,0,0,0,0,0,0,0,0,0,0,0,0,0,0,0,0,0,0,0,0,0,0,0,0
270531105002012,13,Hiawatha,64,64,1000000US270531105002012,"Block 2012, Block Group 2, Census Tract 1105, Hennepin County, Minnesota",43,39,0,0,2,0,0,2,43,43,39,0,0,2,0,0,2,0,0,0,0,0,0,0,0
270531115002010,14,Windom,68,68,1000000US270531115002010,"Block 2010, Block Group 2, Census Tract 1115, Hennepin County, Minnesota",60,57,0,0,0,0,0,3,60,58,56,0,0,0,0,0,2,2,1,0,0,0,0,0,1
270531115002000,14,Windom,68,68,1000000US270531115002000,"Block 2000, Block Group 2, Census Tract 1115, Hennepin County, Minnesota",0,0,0,0,0,0,0,0,0,0,0,0,0,0,0,0,0,0,0,0,0,0,0,0,0
270531115002011,14,Windom,68,68,1000000US270531115002011,"Block 2011, Block Group 2, Census Tract 1115, Hennepin County, Minnesota",63,52,8,0,3,0,0,0,63,62,51,8,0,3,0,0,0,1,1,0,0,0,0,0,0
270530120031001,14,Windom,68,68,1000000US270530120031001,"Block 1001, Block Group 1, Census Tract 120.03, Hennepin County, Minnesota",26,25,0,1,0,0,0,0,26,26,25,0,1,0,0,0,0,0,0,0,0,0,0,0,0
270530120036002,14,Windom,68,68,1000000US270530120036002,"Block 6002, Block Group 6, Census Tract 120.03, Hennepin County, Minnesota",45,40,0,0,5,0,0,0,45,45,40,0,0,5,0,0,0,0,0,0,0,0,0,0,0
270530120031003,14,Windom,68,68,1000000US270530120031003,"Block 1003, Block Group 1, Census Tract 120.03, Hennepin County, Minnesota",2,2,0,0,0,0,0,0,2,2,2,0,0,0,0,0,0,0,0,0,0,0,0,0,0
270530120031002,14,Windom,68,68,1000000US270530120031002,"Block 1002, Block Group 1, Census Tract 120.03, Hennepin County, Minnesota",35,33,0,0,2,0,0,0,35,35,33,0,0,2,0,0,0,0,0,0,0,0,0,0,0
270530120036003,14,Windom,68,68,1000000US270530120036003,"Block 6003, Block Group 6, Census Tract 120.03, Hennepin County, Minnesota",41,37,2,2,0,0,0,0,41,37,33,2,2,0,0,0,0,4,4,0,0,0,0,0,0
270531115002015,14,Windom,68,68,1000000US270531115002015,"Block 2015, Block Group 2, Census Tract 1115, Hennepin County, Minnesota",59,58,0,0,0,0,0,1,59,59,58,0,0,0,0,0,1,0,0,0,0,0,0,0,0
270530120031005,14,Windom,68,68,1000000US270530120031005,"Block 1005, Block Group 1, Census Tract 120.03, Hennepin County, Minnesota",20,14,4,0,0,0,1,1,20,20,14,4,0,0,0,1,1,0,0,0,0,0,0,0,0
270531115002006,14,Windom,68,68,1000000US270531115002006,"Block 2006, Block Group 2, Census Tract 1115, Hennepin County, Minnesota",103,98,1,0,1,0,0,3,103,103,98,1,0,1,0,0,3,0,0,0,0,0,0,0,0
270531115004005,14,Windom,68,68,1000000US270531115004005,"Block 4005, Block Group 4, Census Tract 1115, Hennepin County, Minnesota",55,48,0,2,0,0,2,3,55,51,48,0,2,0,0,0,1,4,0,0,0,0,0,2,2
270531115004004,14,Windom,68,68,1000000US270531115004004,"Block 4004, Block Group 4, Census Tract 1115, Hennepin County, Minnesota",58,50,0,0,3,0,0,5,58,54,46,0,0,3,0,0,5,4,4,0,0,0,0,0,0
270530120036006,14,Windom,68,68,1000000US270530120036006,"Block 6006, Block Group 6, Census Tract 120.03, Hennepin County, Minnesota",225,131,63,3,6,0,9,13,225,207,126,60,3,5,0,1,12,18,5,3,0,1,0,8,1
270531115004002,14,Windom,68,68,1000000US270531115004002,"Block 4002, Block Group 4, Census Tract 1115, Hennepin County, Minnesota",49,45,2,0,0,0,0,2,49,48,44,2,0,0,0,0,2,1,1,0,0,0,0,0,0
270531115004012,14,Windom,68,68,1000000US270531115004012,"Block 4012, Block Group 4, Census Tract 1115, Hennepin County, Minnesota",93,43,22,1,0,0,14,13,93,80,43,22,1,0,0,1,13,13,0,0,0,0,0,13,0
270531115004013,14,Windom,68,68,1000000US270531115004013,"Block 4013, Block Group 4, Census Tract 1115, Hennepin County, Minnesota",265,246,13,1,0,4,0,1,265,264,245,13,1,0,4,0,1,1,1,0,0,0,0,0,0
270531115004011,14,Windom,68,68,1000000US270531115004011,"Block 4011, Block Group 4, Census Tract 1115, Hennepin County, Minnesota",57,47,2,0,6,0,0,2,57,56,47,2,0,6,0,0,1,1,0,0,0,0,0,0,1
270531115004016,14,Windom,68,68,1000000US270531115004016,"Block 4016, Block Group 4, Census Tract 1115, Hennepin County, Minnesota",0,0,0,0,0,0,0,0,0,0,0,0,0,0,0,0,0,0,0,0,0,0,0,0,0
270531115004003,14,Windom,68,68,1000000US270531115004003,"Block 4003, Block Group 4, Census Tract 1115, Hennepin County, Minnesota",56,56,0,0,0,0,0,0,56,54,54,0,0,0,0,0,0,2,2,0,0,0,0,0,0
270531115004001,14,Windom,68,68,1000000US270531115004001,"Block 4001, Block Group 4, Census Tract 1115, Hennepin County, Minnesota",53,44,1,1,2,0,0,5,53,53,44,1,1,2,0,0,5,0,0,0,0,0,0,0,0
270530120031000,14,Windom,68,68,1000000US270530120031000,"Block 1000, Block Group 1, Census Tract 120.03, Hennepin County, Minnesota",42,28,3,0,0,0,0,11,42,42,28,3,0,0,0,0,11,0,0,0,0,0,0,0,0
270530120036001,14,Windom,68,68,1000000US270530120036001,"Block 6001, Block Group 6, Census Tract 120.03, Hennepin County, Minnesota",78,63,7,1,1,0,1,5,78,74,60,7,1,1,0,1,4,4,3,0,0,0,0,0,1
270530120036004,14,Windom,68,68,1000000US270530120036004,"Block 6004, Block Group 6, Census Tract 120.03, Hennepin County, Minnesota",43,28,6,5,2,0,2,0,43,36,28,6,0,2,0,0,0,7,0,0,5,0,0,2,0
270530120031006,14,Windom,68,68,1000000US270530120031006,"Block 1006, Block Group 1, Census Tract 120.03, Hennepin County, Minnesota",100,83,4,0,4,0,9,0,100,80,72,4,0,4,0,0,0,20,11,0,0,0,0,9,0
270531115004015,14,Windom,68,68,1000000US270531115004015,"Block 4015, Block Group 4, Census Tract 1115, Hennepin County, Minnesota",51,39,11,0,1,0,0,0,51,51,39,11,0,1,0,0,0,0,0,0,0,0,0,0,0
270531115004010,14,Windom,68,68,1000000US270531115004010,"Block 4010, Block Group 4, Census Tract 1115, Hennepin County, Minnesota",53,48,2,2,1,0,0,0,53,51,46,2,2,1,0,0,0,2,2,0,0,0,0,0,0
270531115002014,14,Windom,68,68,1000000US270531115002014,"Block 2014, Block Group 2, Census Tract 1115, Hennepin County, Minnesota",77,45,20,7,0,0,0,5,77,73,43,19,7,0,0,0,4,4,2,1,0,0,0,0,1
270530120036009,14,Windom,68,68,1000000US270530120036009,"Block 6009, Block Group 6, Census Tract 120.03, Hennepin County, Minnesota",30,12,9,0,0,0,9,0,30,19,9,9,0,0,0,1,0,11,3,0,0,0,0,8,0
270531115002013,14,Windom,68,68,1000000US270531115002013,"Block 2013, Block Group 2, Census Tract 1115, Hennepin County, Minnesota",74,39,6,0,17,0,11,1,74,62,39,6,0,16,0,0,1,12,0,0,0,1,0,11,0
270531115002016,14,Windom,68,68,1000000US270531115002016,"Block 2016, Block Group 2, Census Tract 1115, Hennepin County, Minnesota",48,45,0,1,0,0,0,2,48,47,45,0,1,0,0,0,1,1,0,0,0,0,0,0,1
270531115002012,14,Windom,68,68,1000000US270531115002012,"Block 2012, Block Group 2, Census Tract 1115, Hennepin County, Minnesota",54,49,2,0,2,0,1,0,54,52,48,2,0,2,0,0,0,2,1,0,0,0,0,1,0
270530120036007,14,Windom,68,68,1000000US270530120036007,"Block 6007, Block Group 6, Census Tract 120.03, Hennepin County, Minnesota",61,36,17,0,1,0,0,7,61,58,36,16,0,1,0,0,5,3,0,1,0,0,0,0,2
270530120035001,14,Windom,68,68,1000000US270530120035001,"Block 5001, Block Group 5, Census Tract 120.03, Hennepin County, Minnesota",487,166,203,8,8,0,50,52,487,412,150,202,8,8,0,0,44,75,16,1,0,0,0,50,8
270530120036008,14,Windom,68,68,1000000US270530120036008,"Block 6008, Block Group 6, Census Tract 120.03, Hennepin County, Minnesota",25,7,12,0,0,0,0,6,25,23,7,12,0,0,0,0,4,2,0,0,0,0,0,0,2
270530120031004,14,Windom,68,68,1000000US270530120031004,"Block 1004, Block Group 1, Census Tract 120.03, Hennepin County, Minnesota",119,52,38,4,5,1,15,4,119,100,50,37,4,5,1,0,3,19,2,1,0,0,0,15,1
270531115004014,14,Windom,68,68,1000000US270531115004014,"Block 4014, Block Group 4, Census Tract 1115, Hennepin County, Minnesota",57,46,5,0,3,0,2,1,57,57,46,5,0,3,0,2,1,0,0,0,0,0,0,0,0
270531115004008,14,Windom,68,68,1000000US270531115004008,"Block 4008, Block Group 4, Census Tract 1115, Hennepin County, Minnesota",52,50,0,0,2,0,0,0,52,48,46,0,0,2,0,0,0,4,4,0,0,0,0,0,0
270531115004007,14,Windom,68,68,1000000US270531115004007,"Block 4007, Block Group 4, Census Tract 1115, Hennepin County, Minnesota",50,44,0,0,2,0,0,4,50,48,43,0,0,2,0,0,3,2,1,0,0,0,0,0,1
270530120034000,14,Windom,68,68,1000000US270530120034000,"Block 4000, Block Group 4, Census Tract 120.03, Hennepin County, Minnesota",496,105,271,5,8,0,72,35,496,376,68,270,5,8,0,1,24,120,37,1,0,0,0,71,11
270530120034001,14,Windom,68,68,1000000US270530120034001,"Block 4001, Block Group 4, Census Tract 120.03, Hennepin County, Minnesota",6,6,0,0,0,0,0,0,6,6,6,0,0,0,0,0,0,0,0,0,0,0,0,0,0
270530120034002,14,Windom,68,68,1000000US270530120034002,"Block 4002, Block Group 4, Census Tract 120.03, Hennepin County, Minnesota",91,36,34,5,0,0,8,8,91,77,29,34,5,0,0,1,8,14,7,0,0,0,0,7,0
270530120036005,14,Windom,68,68,1000000US270530120036005,"Block 6005, Block Group 6, Census Tract 120.03, Hennepin County, Minnesota",0,0,0,0,0,0,0,0,0,0,0,0,0,0,0,0,0,0,0,0,0,0,0,0,0
270531115002005,14,Windom,68,68,1000000US270531115002005,"Block 2005, Block Group 2, Census Tract 1115, Hennepin County, Minnesota",88,86,1,0,1,0,0,0,88,88,86,1,0,1,0,0,0,0,0,0,0,0,0,0,0
270531115004006,14,Windom,68,68,1000000US270531115004006,"Block 4006, Block Group 4, Census Tract 1115, Hennepin County, Minnesota",71,68,0,0,2,0,0,1,71,70,67,0,0,2,0,0,1,1,1,0,0,0,0,0,0
270531115002007,14,Windom,68,68,1000000US270531115002007,"Block 2007, Block Group 2, Census Tract 1115, Hennepin County, Minnesota",48,48,0,0,0,0,0,0,48,48,48,0,0,0,0,0,0,0,0,0,0,0,0,0,0
270531115002008,14,Windom,68,68,1000000US270531115002008,"Block 2008, Block Group 2, Census Tract 1115, Hennepin County, Minnesota",71,57,0,0,13,0,1,0,71,68,54,0,0,13,0,1,0,3,3,0,0,0,0,0,0
270531115002002,14,Windom,68,68,1000000US270531115002002,"Block 2002, Block Group 2, Census Tract 1115, Hennepin County, Minnesota",124,81,17,6,3,0,10,7,124,108,75,17,6,3,0,0,7,16,6,0,0,0,0,10,0
270531115002001,14,Windom,68,68,1000000US270531115002001,"Block 2001, Block Group 2, Census Tract 1115, Hennepin County, Minnesota",67,53,6,0,1,0,6,1,67,60,52,6,0,1,0,0,1,7,1,0,0,0,0,6,0
270530120036000,14,Windom,68,68,1000000US270530120036000,"Block 6000, Block Group 6, Census Tract 120.03, Hennepin County, Minnesota",117,57,44,2,1,0,6,7,117,113,54,44,1,1,0,6,7,4,3,0,1,0,0,0,0
270530120031007,14,Windom,68,68,1000000US270530120031007,"Block 1007, Block Group 1, Census Tract 120.03, Hennepin County, Minnesota",236,136,66,1,15,1,2,15,236,221,127,64,1,15,1,0,13,15,9,2,0,0,0,2,2
270530120035002,14,Windom,68,68,1000000US270530120035002,"Block 5002, Block Group 5, Census Tract 120.03, Hennepin County, Minnesota",3,1,1,0,0,0,0,1,3,3,1,1,0,0,0,0,1,0,0,0,0,0,0,0,0
270530120031008,14,Windom,68,68,1000000US270530120031008,"Block 1008, Block Group 1, Census Tract 120.03, Hennepin County, Minnesota",0,0,0,0,0,0,0,0,0,0,0,0,0,0,0,0,0,0,0,0,0,0,0,0,0
270531115004000,14,Windom,68,68,1000000US270531115004000,"Block 4000, Block Group 4, Census Tract 1115, Hennepin County, Minnesota",54,52,0,0,0,0,0,2,54,49,48,0,0,0,0,0,1,5,4,0,0,0,0,0,1
270531115002004,14,Windom,68,68,1000000US270531115002004,"Block 2004, Block Group 2, Census Tract 1115, Hennepin County, Minnesota",90,82,7,0,1,0,0,0,90,84,76,7,0,1,0,0,0,6,6,0,0,0,0,0,0
270531115002003,14,Windom,68,68,1000000US270531115002003,"Block 2003, Block Group 2, Census Tract 1115, Hennepin County, Minnesota",86,60,12,3,1,0,8,2,86,75,57,12,3,1,0,0,2,11,3,0,0,0,0,8,0
270531115002009,14,Windom,68,68,1000000US270531115002009,"Block 2009, Block Group 2, Census Tract 1115, Hennepin County, Minnesota",75,43,16,3,3,0,5,5,75,69,42,16,3,3,0,0,5,6,1,0,0,0,0,5,0
270531115004009,14,Windom,68,68,1000000US270531115004009,"Block 4009, Block Group 4, Census Tract 1115, Hennepin County, Minnesota",59,57,2,0,0,0,0,0,59,59,57,2,0,0,0,0,0,0,0,0,0,0,0,0,0
270530120035000,14,Windom,68,68,1000000US270530120035000,"Block 5000, Block Group 5, Census Tract 120.03, Hennepin County, Minnesota",332,173,83,3,6,0,51,16,332,251,147,82,3,6,0,1,12,81,26,1,0,0,0,50,4
270531111004003,15,Ericsson,76,76,1000000US270531111004003,"Block 4003, Block Group 4, Census Tract 1111, Hennepin County, Minnesota",66,41,6,0,8,0,6,5,66,60,41,6,0,8,0,0,5,6,0,0,0,0,0,6,0
270531111002011,15,Ericsson,76,76,1000000US270531111002011,"Block 2011, Block Group 2, Census Tract 1111, Hennepin County, Minnesota",98,97,0,1,0,0,0,0,98,98,97,0,1,0,0,0,0,0,0,0,0,0,0,0,0
270531111004000,15,Ericsson,76,76,1000000US270531111004000,"Block 4000, Block Group 4, Census Tract 1111, Hennepin County, Minnesota",62,50,1,4,2,0,0,5,62,62,50,1,4,2,0,0,5,0,0,0,0,0,0,0,0
270531111003003,15,Ericsson,76,76,1000000US270531111003003,"Block 3003, Block Group 3, Census Tract 1111, Hennepin County, Minnesota",74,56,10,1,6,0,0,1,74,74,56,10,1,6,0,0,1,0,0,0,0,0,0,0,0
270531111003008,15,Ericsson,76,76,1000000US270531111003008,"Block 3008, Block Group 3, Census Tract 1111, Hennepin County, Minnesota",67,54,6,0,1,0,0,6,67,67,54,6,0,1,0,0,6,0,0,0,0,0,0,0,0
270531111002008,15,Ericsson,76,76,1000000US270531111002008,"Block 2008, Block Group 2, Census Tract 1111, Hennepin County, Minnesota",57,52,5,0,0,0,0,0,57,56,51,5,0,0,0,0,0,1,1,0,0,0,0,0,0
270531111002014,15,Ericsson,76,76,1000000US270531111002014,"Block 2014, Block Group 2, Census Tract 1111, Hennepin County, Minnesota",0,0,0,0,0,0,0,0,0,0,0,0,0,0,0,0,0,0,0,0,0,0,0,0,0
270531111002010,15,Ericsson,76,76,1000000US270531111002010,"Block 2010, Block Group 2, Census Tract 1111, Hennepin County, Minnesota",160,141,7,0,0,0,7,5,160,155,139,7,0,0,0,4,5,5,2,0,0,0,0,3,0
270531111001003,15,Ericsson,76,76,1000000US270531111001003,"Block 1003, Block Group 1, Census Tract 1111, Hennepin County, Minnesota",0,0,0,0,0,0,0,0,0,0,0,0,0,0,0,0,0,0,0,0,0,0,0,0,0
270531111003011,15,Ericsson,76,76,1000000US270531111003011,"Block 3011, Block Group 3, Census Tract 1111, Hennepin County, Minnesota",25,16,4,0,3,0,1,1,25,24,16,4,0,3,0,0,1,1,0,0,0,0,0,1,0
270531111002002,15,Ericsson,76,76,1000000US270531111002002,"Block 2002, Block Group 2, Census Tract 1111, Hennepin County, Minnesota",15,15,0,0,0,0,0,0,15,15,15,0,0,0,0,0,0,0,0,0,0,0,0,0,0
270531111001007,15,Ericsson,76,76,1000000US270531111001007,"Block 1007, Block Group 1, Census Tract 1111, Hennepin County, Minnesota",72,51,13,1,0,0,2,5,72,69,50,13,1,0,0,0,5,3,1,0,0,0,0,2,0
270531111002009,15,Ericsson,76,76,1000000US270531111002009,"Block 2009, Block Group 2, Census Tract 1111, Hennepin County, Minnesota",45,41,2,0,0,0,1,1,45,42,39,2,0,0,0,0,1,3,2,0,0,0,0,1,0
270531111003006,15,Ericsson,76,76,1000000US270531111003006,"Block 3006, Block Group 3, Census Tract 1111, Hennepin County, Minnesota",49,43,4,0,0,1,0,1,49,48,43,4,0,0,0,0,1,1,0,0,0,0,1,0,0
270531111003000,15,Ericsson,76,76,1000000US270531111003000,"Block 3000, Block Group 3, Census Tract 1111, Hennepin County, Minnesota",7,6,0,0,0,0,0,1,7,7,6,0,0,0,0,0,1,0,0,0,0,0,0,0,0
270531111002001,15,Ericsson,76,76,1000000US270531111002001,"Block 2001, Block Group 2, Census Tract 1111, Hennepin County, Minnesota",0,0,0,0,0,0,0,0,0,0,0,0,0,0,0,0,0,0,0,0,0,0,0,0,0
270531111002013,15,Ericsson,76,76,1000000US270531111002013,"Block 2013, Block Group 2, Census Tract 1111, Hennepin County, Minnesota",60,59,0,0,1,0,0,0,60,60,59,0,0,1,0,0,0,0,0,0,0,0,0,0,0
270531111003015,15,Ericsson,76,76,1000000US270531111003015,"Block 3015, Block Group 3, Census Tract 1111, Hennepin County, Minnesota",65,56,6,0,2,0,0,1,65,65,56,6,0,2,0,0,1,0,0,0,0,0,0,0,0
270531111001005,15,Ericsson,76,76,1000000US270531111001005,"Block 1005, Block Group 1, Census Tract 1111, Hennepin County, Minnesota",160,58,12,5,0,0,78,7,160,87,56,12,5,0,0,8,6,73,2,0,0,0,0,70,1
270531111001001,15,Ericsson,76,76,1000000US270531111001001,"Block 1001, Block Group 1, Census Tract 1111, Hennepin County, Minnesota",60,53,3,2,0,0,1,1,60,59,53,3,2,0,0,0,1,1,0,0,0,0,0,1,0
270531111004007,15,Ericsson,76,76,1000000US270531111004007,"Block 4007, Block Group 4, Census Tract 1111, Hennepin County, Minnesota",61,50,0,1,2,0,5,3,61,55,50,0,1,2,0,0,2,6,0,0,0,0,0,5,1
270531111003017,15,Ericsson,76,76,1000000US270531111003017,"Block 3017, Block Group 3, Census Tract 1111, Hennepin County, Minnesota",59,51,0,0,0,0,7,1,59,52,51,0,0,0,0,0,1,7,0,0,0,0,0,7,0
270531111003016,15,Ericsson,76,76,1000000US270531111003016,"Block 3016, Block Group 3, Census Tract 1111, Hennepin County, Minnesota",86,62,0,2,4,2,10,6,86,76,62,0,2,4,2,0,6,10,0,0,0,0,0,10,0
270531111003019,15,Ericsson,76,76,1000000US270531111003019,"Block 3019, Block Group 3, Census Tract 1111, Hennepin County, Minnesota",42,37,3,1,0,0,0,1,42,41,36,3,1,0,0,0,1,1,1,0,0,0,0,0,0
270531111004012,15,Ericsson,76,76,1000000US270531111004012,"Block 4012, Block Group 4, Census Tract 1111, Hennepin County, Minnesota",69,48,2,0,11,0,4,4,69,67,46,2,0,11,0,4,4,2,2,0,0,0,0,0,0
270531111003018,15,Ericsson,76,76,1000000US270531111003018,"Block 3018, Block Group 3, Census Tract 1111, Hennepin County, Minnesota",72,67,1,0,2,0,2,0,72,67,65,0,0,2,0,0,0,5,2,1,0,0,0,2,0
270531111003005,15,Ericsson,76,76,1000000US270531111003005,"Block 3005, Block Group 3, Census Tract 1111, Hennepin County, Minnesota",1,1,0,0,0,0,0,0,1,1,1,0,0,0,0,0,0,0,0,0,0,0,0,0,0
270531111002012,15,Ericsson,76,76,1000000US270531111002012,"Block 2012, Block Group 2, Census Tract 1111, Hennepin County, Minnesota",54,52,0,0,0,0,2,0,54,52,52,0,0,0,0,0,0,2,0,0,0,0,0,2,0
270531111002005,15,Ericsson,76,76,1000000US270531111002005,"Block 2005, Block Group 2, Census Tract 1111, Hennepin County, Minnesota",72,49,5,1,2,0,6,9,72,60,48,4,0,2,0,0,6,12,1,1,1,0,0,6,3
270531111002004,15,Ericsson,76,76,1000000US270531111002004,"Block 2004, Block Group 2, Census Tract 1111, Hennepin County, Minnesota",51,40,1,9,1,0,0,0,51,49,40,1,7,1,0,0,0,2,0,0,2,0,0,0,0
270531111002000,15,Ericsson,76,76,1000000US270531111002000,"Block 2000, Block Group 2, Census Tract 1111, Hennepin County, Minnesota",0,0,0,0,0,0,0,0,0,0,0,0,0,0,0,0,0,0,0,0,0,0,0,0,0
270531111001004,15,Ericsson,76,76,1000000US270531111001004,"Block 1004, Block Group 1, Census Tract 1111, Hennepin County, Minnesota",54,50,3,0,1,0,0,0,54,54,50,3,0,1,0,0,0,0,0,0,0,0,0,0,0
270531111004009,15,Ericsson,76,76,1000000US270531111004009,"Block 4009, Block Group 4, Census Tract 1111, Hennepin County, Minnesota",68,55,6,0,5,0,0,2,68,68,55,6,0,5,0,0,2,0,0,0,0,0,0,0,0
270531111004004,15,Ericsson,76,76,1000000US270531111004004,"Block 4004, Block Group 4, Census Tract 1111, Hennepin County, Minnesota",65,60,0,0,0,0,5,0,65,56,56,0,0,0,0,0,0,9,4,0,0,0,0,5,0
270531111004005,15,Ericsson,76,76,1000000US270531111004005,"Block 4005, Block Group 4, Census Tract 1111, Hennepin County, Minnesota",58,52,2,0,1,0,1,2,58,54,51,2,0,1,0,0,0,4,1,0,0,0,0,1,2
270531111001009,15,Ericsson,76,76,1000000US270531111001009,"Block 1009, Block Group 1, Census Tract 1111, Hennepin County, Minnesota",85,58,14,0,4,0,5,4,85,79,57,14,0,4,0,0,4,6,1,0,0,0,0,5,0
270531111001000,15,Ericsson,76,76,1000000US270531111001000,"Block 1000, Block Group 1, Census Tract 1111, Hennepin County, Minnesota",72,61,5,2,3,0,0,1,72,70,59,5,2,3,0,0,1,2,2,0,0,0,0,0,0
270531111004014,15,Ericsson,76,76,1000000US270531111004014,"Block 4014, Block Group 4, Census Tract 1111, Hennepin County, Minnesota",60,54,3,1,0,0,0,2,60,60,54,3,1,0,0,0,2,0,0,0,0,0,0,0,0
270531111004008,15,Ericsson,76,76,1000000US270531111004008,"Block 4008, Block Group 4, Census Tract 1111, Hennepin County, Minnesota",55,50,1,1,0,0,0,3,55,54,49,1,1,0,0,0,3,1,1,0,0,0,0,0,0
270531111002006,15,Ericsson,76,76,1000000US270531111002006,"Block 2006, Block Group 2, Census Tract 1111, Hennepin County, Minnesota",37,32,0,0,1,0,4,0,37,37,32,0,0,1,0,4,0,0,0,0,0,0,0,0,0
270531111004010,15,Ericsson,76,76,1000000US270531111004010,"Block 4010, Block Group 4, Census Tract 1111, Hennepin County, Minnesota",78,55,2,2,4,0,11,4,78,64,54,2,0,4,0,0,4,14,1,0,2,0,0,11,0
270531111003007,15,Ericsson,76,76,1000000US270531111003007,"Block 3007, Block Group 3, Census Tract 1111, Hennepin County, Minnesota",72,52,3,4,1,0,6,6,72,64,52,3,4,1,0,0,4,8,0,0,0,0,0,6,2
270531111002015,15,Ericsson,76,76,1000000US270531111002015,"Block 2015, Block Group 2, Census Tract 1111, Hennepin County, Minnesota",0,0,0,0,0,0,0,0,0,0,0,0,0,0,0,0,0,0,0,0,0,0,0,0,0
270531111003001,15,Ericsson,76,76,1000000US270531111003001,"Block 3001, Block Group 3, Census Tract 1111, Hennepin County, Minnesota",15,12,3,0,0,0,0,0,15,15,12,3,0,0,0,0,0,0,0,0,0,0,0,0,0
270531111002016,15,Ericsson,76,76,1000000US270531111002016,"Block 2016, Block Group 2, Census Tract 1111, Hennepin County, Minnesota",55,45,6,0,1,0,0,3,55,54,44,6,0,1,0,0,3,1,1,0,0,0,0,0,0
270531111002003,15,Ericsson,76,76,1000000US270531111002003,"Block 2003, Block Group 2, Census Tract 1111, Hennepin County, Minnesota",29,28,0,0,0,0,1,0,29,28,28,0,0,0,0,0,0,1,0,0,0,0,0,1,0
270531111002018,15,Ericsson,76,76,1000000US270531111002018,"Block 2018, Block Group 2, Census Tract 1111, Hennepin County, Minnesota",50,50,0,0,0,0,0,0,50,49,49,0,0,0,0,0,0,1,1,0,0,0,0,0,0
270531111003013,15,Ericsson,76,76,1000000US270531111003013,"Block 3013, Block Group 3, Census Tract 1111, Hennepin County, Minnesota",0,0,0,0,0,0,0,0,0,0,0,0,0,0,0,0,0,0,0,0,0,0,0,0,0
270531111004001,15,Ericsson,76,76,1000000US270531111004001,"Block 4001, Block Group 4, Census Tract 1111, Hennepin County, Minnesota",62,57,3,0,0,0,0,2,62,62,57,3,0,0,0,0,2,0,0,0,0,0,0,0,0
270531111003002,15,Ericsson,76,76,1000000US270531111003002,"Block 3002, Block Group 3, Census Tract 1111, Hennepin County, Minnesota",57,55,0,0,2,0,0,0,57,57,55,0,0,2,0,0,0,0,0,0,0,0,0,0,0
270531111003009,15,Ericsson,76,76,1000000US270531111003009,"Block 3009, Block Group 3, Census Tract 1111, Hennepin County, Minnesota",0,0,0,0,0,0,0,0,0,0,0,0,0,0,0,0,0,0,0,0,0,0,0,0,0
270531111001008,15,Ericsson,76,76,1000000US270531111001008,"Block 1008, Block Group 1, Census Tract 1111, Hennepin County, Minnesota",65,62,3,0,0,0,0,0,65,61,58,3,0,0,0,0,0,4,4,0,0,0,0,0,0
270531111004013,15,Ericsson,76,76,1000000US270531111004013,"Block 4013, Block Group 4, Census Tract 1111, Hennepin County, Minnesota",43,38,2,0,1,0,0,2,43,42,37,2,0,1,0,0,2,1,1,0,0,0,0,0,0
270531111004006,15,Ericsson,76,76,1000000US270531111004006,"Block 4006, Block Group 4, Census Tract 1111, Hennepin County, Minnesota",69,59,4,3,0,0,1,2,69,62,55,4,2,0,0,0,1,7,4,0,1,0,0,1,1
270531111003004,15,Ericsson,76,76,1000000US270531111003004,"Block 3004, Block Group 3, Census Tract 1111, Hennepin County, Minnesota",0,0,0,0,0,0,0,0,0,0,0,0,0,0,0,0,0,0,0,0,0,0,0,0,0
270531111002017,15,Ericsson,76,76,1000000US270531111002017,"Block 2017, Block Group 2, Census Tract 1111, Hennepin County, Minnesota",40,39,1,0,0,0,0,0,40,40,39,1,0,0,0,0,0,0,0,0,0,0,0,0,0
270531111003012,15,Ericsson,76,76,1000000US270531111003012,"Block 3012, Block Group 3, Census Tract 1111, Hennepin County, Minnesota",0,0,0,0,0,0,0,0,0,0,0,0,0,0,0,0,0,0,0,0,0,0,0,0,0
270531111004002,15,Ericsson,76,76,1000000US270531111004002,"Block 4002, Block Group 4, Census Tract 1111, Hennepin County, Minnesota",55,48,3,0,0,0,4,0,55,51,48,3,0,0,0,0,0,4,0,0,0,0,0,4,0
270531111003010,15,Ericsson,76,76,1000000US270531111003010,"Block 3010, Block Group 3, Census Tract 1111, Hennepin County, Minnesota",9,9,0,0,0,0,0,0,9,9,9,0,0,0,0,0,0,0,0,0,0,0,0,0,0
270531111001010,15,Ericsson,76,76,1000000US270531111001010,"Block 1010, Block Group 1, Census Tract 1111, Hennepin County, Minnesota",0,0,0,0,0,0,0,0,0,0,0,0,0,0,0,0,0,0,0,0,0,0,0,0,0
270531111001002,15,Ericsson,76,76,1000000US270531111001002,"Block 1002, Block Group 1, Census Tract 1111, Hennepin County, Minnesota",0,0,0,0,0,0,0,0,0,0,0,0,0,0,0,0,0,0,0,0,0,0,0,0,0
270531111004011,15,Ericsson,76,76,1000000US270531111004011,"Block 4011, Block Group 4, Census Tract 1111, Hennepin County, Minnesota",70,65,2,0,0,0,2,1,70,68,65,2,0,0,0,0,1,2,0,0,0,0,0,2,0
270531111003014,15,Ericsson,76,76,1000000US270531111003014,"Block 3014, Block Group 3, Census Tract 1111, Hennepin County, Minnesota",83,48,10,4,13,0,0,8,83,78,48,10,4,13,0,0,3,5,0,0,0,0,0,0,5
270531111002007,15,Ericsson,76,76,1000000US270531111002007,"Block 2007, Block Group 2, Census Tract 1111, Hennepin County, Minnesota",0,0,0,0,0,0,0,0,0,0,0,0,0,0,0,0,0,0,0,0,0,0,0,0,0
270531111001006,15,Ericsson,76,76,1000000US270531111001006,"Block 1006, Block Group 1, Census Tract 1111, Hennepin County, Minnesota",77,65,5,3,1,0,0,3,77,71,63,5,3,0,0,0,0,6,2,0,0,1,0,0,3
270531109001018,16,Field,77,77,1000000US270531109001018,"Block 1018, Block Group 1, Census Tract 1109, Hennepin County, Minnesota",29,19,6,0,0,0,1,3,29,27,19,6,0,0,0,0,2,2,0,0,0,0,0,1,1
270531116001007,16,Field,77,77,1000000US270531116001007,"Block 1007, Block Group 1, Census Tract 1116, Hennepin County, Minnesota",70,40,17,2,4,0,0,7,70,65,40,16,1,4,0,0,4,5,0,1,1,0,0,0,3
270531116004013,16,Field,77,77,1000000US270531116004013,"Block 4013, Block Group 4, Census Tract 1116, Hennepin County, Minnesota",54,49,3,0,2,0,0,0,54,54,49,3,0,2,0,0,0,0,0,0,0,0,0,0,0
270531116001010,16,Field,77,77,1000000US270531116001010,"Block 1010, Block Group 1, Census Tract 1116, Hennepin County, Minnesota",0,0,0,0,0,0,0,0,0,0,0,0,0,0,0,0,0,0,0,0,0,0,0,0,0
270531116001009,16,Field,77,77,1000000US270531116001009,"Block 1009, Block Group 1, Census Tract 1116, Hennepin County, Minnesota",28,27,0,1,0,0,0,0,28,28,27,0,1,0,0,0,0,0,0,0,0,0,0,0,0
270531109001013,16,Field,77,77,1000000US270531109001013,"Block 1013, Block Group 1, Census Tract 1109, Hennepin County, Minnesota",73,43,19,0,7,0,0,4,73,62,32,19,0,7,0,0,4,11,11,0,0,0,0,0,0
270531109001003,16,Field,77,77,1000000US270531109001003,"Block 1003, Block Group 1, Census Tract 1109, Hennepin County, Minnesota",75,56,11,0,1,0,3,4,75,66,50,11,0,1,0,0,4,9,6,0,0,0,0,3,0
270531116004007,16,Field,77,77,1000000US270531116004007,"Block 4007, Block Group 4, Census Tract 1116, Hennepin County, Minnesota",41,32,1,0,0,0,0,8,41,41,32,1,0,0,0,0,8,0,0,0,0,0,0,0,0
270531116004006,16,Field,77,77,1000000US270531116004006,"Block 4006, Block Group 4, Census Tract 1116, Hennepin County, Minnesota",0,0,0,0,0,0,0,0,0,0,0,0,0,0,0,0,0,0,0,0,0,0,0,0,0
270531109001004,16,Field,77,77,1000000US270531109001004,"Block 1004, Block Group 1, Census Tract 1109, Hennepin County, Minnesota",51,31,8,0,4,0,8,0,51,41,31,6,0,4,0,0,0,10,0,2,0,0,0,8,0
270531116004002,16,Field,77,77,1000000US270531116004002,"Block 4002, Block Group 4, Census Tract 1116, Hennepin County, Minnesota",71,44,14,6,3,0,0,4,71,71,44,14,6,3,0,0,4,0,0,0,0,0,0,0,0
270531116004012,16,Field,77,77,1000000US270531116004012,"Block 4012, Block Group 4, Census Tract 1116, Hennepin County, Minnesota",45,37,4,0,3,0,0,1,45,44,36,4,0,3,0,0,1,1,1,0,0,0,0,0,0
270531109001011,16,Field,77,77,1000000US270531109001011,"Block 1011, Block Group 1, Census Tract 1109, Hennepin County, Minnesota",59,37,11,0,0,0,4,7,59,53,35,11,0,0,0,0,7,6,2,0,0,0,0,4,0
270531109001015,16,Field,77,77,1000000US270531109001015,"Block 1015, Block Group 1, Census Tract 1109, Hennepin County, Minnesota",58,43,9,0,3,0,3,0,58,56,41,9,0,3,0,3,0,2,2,0,0,0,0,0,0
270531109001001,16,Field,77,77,1000000US270531109001001,"Block 1001, Block Group 1, Census Tract 1109, Hennepin County, Minnesota",56,54,2,0,0,0,0,0,56,55,53,2,0,0,0,0,0,1,1,0,0,0,0,0,0
270531116004005,16,Field,77,77,1000000US270531116004005,"Block 4005, Block Group 4, Census Tract 1116, Hennepin County, Minnesota",51,46,5,0,0,0,0,0,51,50,45,5,0,0,0,0,0,1,1,0,0,0,0,0,0
270531109001005,16,Field,77,77,1000000US270531109001005,"Block 1005, Block Group 1, Census Tract 1109, Hennepin County, Minnesota",0,0,0,0,0,0,0,0,0,0,0,0,0,0,0,0,0,0,0,0,0,0,0,0,0
270531109001014,16,Field,77,77,1000000US270531109001014,"Block 1014, Block Group 1, Census Tract 1109, Hennepin County, Minnesota",59,36,17,1,0,0,0,5,59,57,35,17,0,0,0,0,5,2,1,0,1,0,0,0,0
270531116004001,16,Field,77,77,1000000US270531116004001,"Block 4001, Block Group 4, Census Tract 1116, Hennepin County, Minnesota",32,22,2,2,0,0,0,6,32,32,22,2,2,0,0,0,6,0,0,0,0,0,0,0,0
270531116004010,16,Field,77,77,1000000US270531116004010,"Block 4010, Block Group 4, Census Tract 1116, Hennepin County, Minnesota",59,58,0,0,0,0,0,1,59,58,58,0,0,0,0,0,0,1,0,0,0,0,0,0,1
270531116004009,16,Field,77,77,1000000US270531116004009,"Block 4009, Block Group 4, Census Tract 1116, Hennepin County, Minnesota",66,54,8,0,0,0,0,4,66,65,53,8,0,0,0,0,4,1,1,0,0,0,0,0,0
270531116001004,16,Field,77,77,1000000US270531116001004,"Block 1004, Block Group 1, Census Tract 1116, Hennepin County, Minnesota",54,44,6,0,3,0,0,1,54,53,44,6,0,2,0,0,1,1,0,0,0,1,0,0,0
270531116004015,16,Field,77,77,1000000US270531116004015,"Block 4015, Block Group 4, Census Tract 1116, Hennepin County, Minnesota",0,0,0,0,0,0,0,0,0,0,0,0,0,0,0,0,0,0,0,0,0,0,0,0,0
270531116001001,16,Field,77,77,1000000US270531116001001,"Block 1001, Block Group 1, Census Tract 1116, Hennepin County, Minnesota",59,46,6,0,0,0,4,3,59,58,45,6,0,0,0,4,3,1,1,0,0,0,0,0,0
270531116004000,16,Field,77,77,1000000US270531116004000,"Block 4000, Block Group 4, Census Tract 1116, Hennepin County, Minnesota",31,19,11,0,0,0,1,0,31,28,17,11,0,0,0,0,0,3,2,0,0,0,0,1,0
270531109001016,16,Field,77,77,1000000US270531109001016,"Block 1016, Block Group 1, Census Tract 1109, Hennepin County, Minnesota",72,55,6,0,7,0,3,1,72,72,55,6,0,7,0,3,1,0,0,0,0,0,0,0,0
270531109001017,16,Field,77,77,1000000US270531109001017,"Block 1017, Block Group 1, Census Tract 1109, Hennepin County, Minnesota",71,60,3,0,0,0,5,3,71,62,56,3,0,0,0,0,3,9,4,0,0,0,0,5,0
270531109001007,16,Field,77,77,1000000US270531109001007,"Block 1007, Block Group 1, Census Tract 1109, Hennepin County, Minnesota",57,27,24,0,0,0,3,3,57,53,26,24,0,0,0,0,3,4,1,0,0,0,0,3,0
270531109001012,16,Field,77,77,1000000US270531109001012,"Block 1012, Block Group 1, Census Tract 1109, Hennepin County, Minnesota",85,40,21,7,0,0,7,10,85,77,40,21,7,0,0,0,9,8,0,0,0,0,0,7,1
270531116004004,16,Field,77,77,1000000US270531116004004,"Block 4004, Block Group 4, Census Tract 1116, Hennepin County, Minnesota",57,43,7,0,0,0,2,5,57,54,42,7,0,0,0,0,5,3,1,0,0,0,0,2,0
270531116001003,16,Field,77,77,1000000US270531116001003,"Block 1003, Block Group 1, Census Tract 1116, Hennepin County, Minnesota",73,42,10,0,6,0,7,8,73,67,42,10,0,6,0,1,8,6,0,0,0,0,0,6,0
270531109001008,16,Field,77,77,1000000US270531109001008,"Block 1008, Block Group 1, Census Tract 1109, Hennepin County, Minnesota",68,39,21,0,0,0,0,8,68,64,35,21,0,0,0,0,8,4,4,0,0,0,0,0,0
270531116001002,16,Field,77,77,1000000US270531116001002,"Block 1002, Block Group 1, Census Tract 1116, Hennepin County, Minnesota",64,47,12,0,2,0,0,3,64,64,47,12,0,2,0,0,3,0,0,0,0,0,0,0,0
270531116001006,16,Field,77,77,1000000US270531116001006,"Block 1006, Block Group 1, Census Tract 1116, Hennepin County, Minnesota",53,46,3,0,1,0,0,3,53,53,46,3,0,1,0,0,3,0,0,0,0,0,0,0,0
270531109001009,16,Field,77,77,1000000US270531109001009,"Block 1009, Block Group 1, Census Tract 1109, Hennepin County, Minnesota",0,0,0,0,0,0,0,0,0,0,0,0,0,0,0,0,0,0,0,0,0,0,0,0,0
270531116001000,16,Field,77,77,1000000US270531116001000,"Block 1000, Block Group 1, Census Tract 1116, Hennepin County, Minnesota",105,78,16,0,0,0,0,11,105,102,77,16,0,0,0,0,9,3,1,0,0,0,0,0,2
270531116001011,16,Field,77,77,1000000US270531116001011,"Block 1011, Block Group 1, Census Tract 1116, Hennepin County, Minnesota",0,0,0,0,0,0,0,0,0,0,0,0,0,0,0,0,0,0,0,0,0,0,0,0,0
270531116004014,16,Field,77,77,1000000US270531116004014,"Block 4014, Block Group 4, Census Tract 1116, Hennepin County, Minnesota",0,0,0,0,0,0,0,0,0,0,0,0,0,0,0,0,0,0,0,0,0,0,0,0,0
270531116004003,16,Field,77,77,1000000US270531116004003,"Block 4003, Block Group 4, Census Tract 1116, Hennepin County, Minnesota",53,44,7,1,0,0,1,0,53,52,43,7,1,0,0,1,0,1,1,0,0,0,0,0,0
270531116004008,16,Field,77,77,1000000US270531116004008,"Block 4008, Block Group 4, Census Tract 1116, Hennepin County, Minnesota",57,44,7,0,0,0,4,2,57,52,43,7,0,0,0,0,2,5,1,0,0,0,0,4,0
270531109001002,16,Field,77,77,1000000US270531109001002,"Block 1002, Block Group 1, Census Tract 1109, Hennepin County, Minnesota",54,39,8,2,1,0,0,4,54,54,39,8,2,1,0,0,4,0,0,0,0,0,0,0,0
270531109001010,16,Field,77,77,1000000US270531109001010,"Block 1010, Block Group 1, Census Tract 1109, Hennepin County, Minnesota",74,41,23,1,0,0,0,9,74,71,41,23,1,0,0,0,6,3,0,0,0,0,0,0,3
270531116004011,16,Field,77,77,1000000US270531116004011,"Block 4011, Block Group 4, Census Tract 1116, Hennepin County, Minnesota",60,45,12,0,3,0,0,0,60,56,44,9,0,3,0,0,0,4,1,3,0,0,0,0,0
270531109001006,16,Field,77,77,1000000US270531109001006,"Block 1006, Block Group 1, Census Tract 1109, Hennepin County, Minnesota",79,34,27,0,0,0,14,4,79,63,33,26,0,0,0,2,2,16,1,1,0,0,0,12,2
270531109001000,16,Field,77,77,1000000US270531109001000,"Block 1000, Block Group 1, Census Tract 1109, Hennepin County, Minnesota",62,37,20,0,1,0,2,2,62,62,37,20,0,1,0,2,2,0,0,0,0,0,0,0,0
270531116001005,16,Field,77,77,1000000US270531116001005,"Block 1005, Block Group 1, Census Tract 1116, Hennepin County, Minnesota",60,40,16,1,1,0,0,2,60,60,40,16,1,1,0,0,2,0,0,0,0,0,0,0,0
270531116001008,16,Field,77,77,1000000US270531116001008,"Block 1008, Block Group 1, Census Tract 1116, Hennepin County, Minnesota",41,39,1,0,1,0,0,0,41,41,39,1,0,1,0,0,0,0,0,0,0,0,0,0,0
270531116002000,17,Page,78,78,1000000US270531116002000,"Block 2000, Block Group 2, Census Tract 1116, Hennepin County, Minnesota",0,0,0,0,0,0,0,0,0,0,0,0,0,0,0,0,0,0,0,0,0,0,0,0,0
270531116002009,17,Page,78,78,1000000US270531116002009,"Block 2009, Block Group 2, Census Tract 1116, Hennepin County, Minnesota",59,36,9,0,6,0,1,7,59,54,35,9,0,5,0,0,5,5,1,0,0,1,0,1,2
270531116002007,17,Page,78,78,1000000US270531116002007,"Block 2007, Block Group 2, Census Tract 1116, Hennepin County, Minnesota",35,27,4,2,0,0,0,2,35,35,27,4,2,0,0,0,2,0,0,0,0,0,0,0,0
270531116002001,17,Page,78,78,1000000US270531116002001,"Block 2001, Block Group 2, Census Tract 1116, Hennepin County, Minnesota",27,26,0,0,1,0,0,0,27,27,26,0,0,1,0,0,0,0,0,0,0,0,0,0,0
270531116003003,17,Page,78,78,1000000US270531116003003,"Block 3003, Block Group 3, Census Tract 1116, Hennepin County, Minnesota",0,0,0,0,0,0,0,0,0,0,0,0,0,0,0,0,0,0,0,0,0,0,0,0,0
270531116003013,17,Page,78,78,1000000US270531116003013,"Block 3013, Block Group 3, Census Tract 1116, Hennepin County, Minnesota",54,51,0,0,0,0,0,3,54,54,51,0,0,0,0,0,3,0,0,0,0,0,0,0,0
270531116003018,17,Page,78,78,1000000US270531116003018,"Block 3018, Block Group 3, Census Tract 1116, Hennepin County, Minnesota",50,47,1,0,2,0,0,0,50,50,47,1,0,2,0,0,0,0,0,0,0,0,0,0,0
270531116003009,17,Page,78,78,1000000US270531116003009,"Block 3009, Block Group 3, Census Tract 1116, Hennepin County, Minnesota",61,60,0,0,1,0,0,0,61,59,58,0,0,1,0,0,0,2,2,0,0,0,0,0,0
270531116003007,17,Page,78,78,1000000US270531116003007,"Block 3007, Block Group 3, Census Tract 1116, Hennepin County, Minnesota",58,55,0,0,3,0,0,0,58,57,54,0,0,3,0,0,0,1,1,0,0,0,0,0,0
270531116004016,17,Page,78,78,1000000US270531116004016,"Block 4016, Block Group 4, Census Tract 1116, Hennepin County, Minnesota",0,0,0,0,0,0,0,0,0,0,0,0,0,0,0,0,0,0,0,0,0,0,0,0,0
270531116003005,17,Page,78,78,1000000US270531116003005,"Block 3005, Block Group 3, Census Tract 1116, Hennepin County, Minnesota",97,94,2,1,0,0,0,0,97,96,94,1,1,0,0,0,0,1,0,1,0,0,0,0,0
270531116002018,17,Page,78,78,1000000US270531116002018,"Block 2018, Block Group 2, Census Tract 1116, Hennepin County, Minnesota",65,60,0,3,1,0,0,1,65,60,55,0,3,1,0,0,1,5,5,0,0,0,0,0,0
270531116002016,17,Page,78,78,1000000US270531116002016,"Block 2016, Block Group 2, Census Tract 1116, Hennepin County, Minnesota",62,54,0,0,5,0,0,3,62,62,54,0,0,5,0,0,3,0,0,0,0,0,0,0,0
270531116003002,17,Page,78,78,1000000US270531116003002,"Block 3002, Block Group 3, Census Tract 1116, Hennepin County, Minnesota",13,13,0,0,0,0,0,0,13,13,13,0,0,0,0,0,0,0,0,0,0,0,0,0,0
270531116003016,17,Page,78,78,1000000US270531116003016,"Block 3016, Block Group 3, Census Tract 1116, Hennepin County, Minnesota",48,41,7,0,0,0,0,0,48,48,41,7,0,0,0,0,0,0,0,0,0,0,0,0,0
270531116002002,17,Page,78,78,1000000US270531116002002,"Block 2002, Block Group 2, Census Tract 1116, Hennepin County, Minnesota",0,0,0,0,0,0,0,0,0,0,0,0,0,0,0,0,0,0,0,0,0,0,0,0,0
270531116002017,17,Page,78,78,1000000US270531116002017,"Block 2017, Block Group 2, Census Tract 1116, Hennepin County, Minnesota",63,53,2,0,3,0,1,4,63,51,43,2,0,3,0,0,3,12,10,0,0,0,0,1,1
270531116003008,17,Page,78,78,1000000US270531116003008,"Block 3008, Block Group 3, Census Tract 1116, Hennepin County, Minnesota",67,66,0,0,0,0,1,0,67,64,64,0,0,0,0,0,0,3,2,0,0,0,0,1,0
270531116003015,17,Page,78,78,1000000US270531116003015,"Block 3015, Block Group 3, Census Tract 1116, Hennepin County, Minnesota",87,82,0,0,2,0,0,3,87,87,82,0,0,2,0,0,3,0,0,0,0,0,0,0,0
270531116003000,17,Page,78,78,1000000US270531116003000,"Block 3000, Block Group 3, Census Tract 1116, Hennepin County, Minnesota",0,0,0,0,0,0,0,0,0,0,0,0,0,0,0,0,0,0,0,0,0,0,0,0,0
270531116003001,17,Page,78,78,1000000US270531116003001,"Block 3001, Block Group 3, Census Tract 1116, Hennepin County, Minnesota",56,51,0,1,2,0,0,2,56,56,51,0,1,2,0,0,2,0,0,0,0,0,0,0,0
270531116002015,17,Page,78,78,1000000US270531116002015,"Block 2015, Block Group 2, Census Tract 1116, Hennepin County, Minnesota",68,63,4,0,1,0,0,0,68,68,63,4,0,1,0,0,0,0,0,0,0,0,0,0,0
270531116002006,17,Page,78,78,1000000US270531116002006,"Block 2006, Block Group 2, Census Tract 1116, Hennepin County, Minnesota",67,62,2,0,3,0,0,0,67,67,62,2,0,3,0,0,0,0,0,0,0,0,0,0,0
270531116002013,17,Page,78,78,1000000US270531116002013,"Block 2013, Block Group 2, Census Tract 1116, Hennepin County, Minnesota",67,56,4,0,3,0,0,4,67,67,56,4,0,3,0,0,4,0,0,0,0,0,0,0,0
270531116002005,17,Page,78,78,1000000US270531116002005,"Block 2005, Block Group 2, Census Tract 1116, Hennepin County, Minnesota",69,61,3,0,1,0,0,4,69,69,61,3,0,1,0,0,4,0,0,0,0,0,0,0,0
270531116002004,17,Page,78,78,1000000US270531116002004,"Block 2004, Block Group 2, Census Tract 1116, Hennepin County, Minnesota",52,51,0,0,0,0,0,1,52,52,51,0,0,0,0,0,1,0,0,0,0,0,0,0,0
270531116002012,17,Page,78,78,1000000US270531116002012,"Block 2012, Block Group 2, Census Tract 1116, Hennepin County, Minnesota",76,64,6,0,0,0,1,5,76,75,63,6,0,0,0,1,5,1,1,0,0,0,0,0,0
270531116002014,17,Page,78,78,1000000US270531116002014,"Block 2014, Block Group 2, Census Tract 1116, Hennepin County, Minnesota",58,57,0,0,0,0,0,1,58,58,57,0,0,0,0,0,1,0,0,0,0,0,0,0,0
270531116003004,17,Page,78,78,1000000US270531116003004,"Block 3004, Block Group 3, Census Tract 1116, Hennepin County, Minnesota",35,31,0,0,4,0,0,0,35,35,31,0,0,4,0,0,0,0,0,0,0,0,0,0,0
270531116003014,17,Page,78,78,1000000US270531116003014,"Block 3014, Block Group 3, Census Tract 1116, Hennepin County, Minnesota",66,59,1,0,1,0,0,5,66,66,59,1,0,1,0,0,5,0,0,0,0,0,0,0,0
270531116003006,17,Page,78,78,1000000US270531116003006,"Block 3006, Block Group 3, Census Tract 1116, Hennepin County, Minnesota",53,47,1,1,0,0,0,4,53,53,47,1,1,0,0,0,4,0,0,0,0,0,0,0,0
270531116002003,17,Page,78,78,1000000US270531116002003,"Block 2003, Block Group 2, Census Tract 1116, Hennepin County, Minnesota",0,0,0,0,0,0,0,0,0,0,0,0,0,0,0,0,0,0,0,0,0,0,0,0,0
270531116002008,17,Page,78,78,1000000US270531116002008,"Block 2008, Block Group 2, Census Tract 1116, Hennepin County, Minnesota",0,0,0,0,0,0,0,0,0,0,0,0,0,0,0,0,0,0,0,0,0,0,0,0,0
270531116002011,17,Page,78,78,1000000US270531116002011,"Block 2011, Block Group 2, Census Tract 1116, Hennepin County, Minnesota",63,55,6,0,1,0,0,1,63,58,50,6,0,1,0,0,1,5,5,0,0,0,0,0,0
270531116003010,17,Page,78,78,1000000US270531116003010,"Block 3010, Block Group 3, Census Tract 1116, Hennepin County, Minnesota",6,6,0,0,0,0,0,0,6,6,6,0,0,0,0,0,0,0,0,0,0,0,0,0,0
270531116003011,17,Page,78,78,1000000US270531116003011,"Block 3011, Block Group 3, Census Tract 1116, Hennepin County, Minnesota",0,0,0,0,0,0,0,0,0,0,0,0,0,0,0,0,0,0,0,0,0,0,0,0,0
270531116003012,17,Page,78,78,1000000US270531116003012,"Block 3012, Block Group 3, Census Tract 1116, Hennepin County, Minnesota",0,0,0,0,0,0,0,0,0,0,0,0,0,0,0,0,0,0,0,0,0,0,0,0,0
270531116003017,17,Page,78,78,1000000US270531116003017,"Block 3017, Block Group 3, Census Tract 1116, Hennepin County, Minnesota",63,58,0,0,1,0,0,4,63,60,57,0,0,1,0,0,2,3,1,0,0,0,0,0,2
270531116003019,17,Page,78,78,1000000US270531116003019,"Block 3019, Block Group 3, Census Tract 1116, Hennepin County, Minnesota",0,0,0,0,0,0,0,0,0,0,0,0,0,0,0,0,0,0,0,0,0,0,0,0,0
270531116002010,17,Page,78,78,1000000US270531116002010,"Block 2010, Block Group 2, Census Tract 1116, Hennepin County, Minnesota",85,69,8,0,0,0,5,3,85,77,65,8,0,0,0,1,3,8,4,0,0,0,0,4,0
270531040003005,18,Como,37,37,1000000US270531040003005,"Block 3005, Block Group 3, Census Tract 1040, Hennepin County, Minnesota",0,0,0,0,0,0,0,0,0,0,0,0,0,0,0,0,0,0,0,0,0,0,0,0,0
270531040005043,18,Como,37,37,1000000US270531040005043,"Block 5043, Block Group 5, Census Tract 1040, Hennepin County, Minnesota",45,44,0,0,0,0,1,0,45,44,44,0,0,0,0,0,0,1,0,0,0,0,0,1,0
270531040003014,18,Como,37,37,1000000US270531040003014,"Block 3014, Block Group 3, Census Tract 1040, Hennepin County, Minnesota",80,68,4,5,2,0,0,1,80,80,68,4,5,2,0,0,1,0,0,0,0,0,0,0,0
270531040005042,18,Como,37,37,1000000US270531040005042,"Block 5042, Block Group 5, Census Tract 1040, Hennepin County, Minnesota",73,66,5,0,2,0,0,0,73,70,63,5,0,2,0,0,0,3,3,0,0,0,0,0,0
270531040003013,18,Como,37,37,1000000US270531040003013,"Block 3013, Block Group 3, Census Tract 1040, Hennepin County, Minnesota",76,69,0,4,0,0,0,3,76,68,64,0,3,0,0,0,1,8,5,0,1,0,0,0,2
270531040003019,18,Como,37,37,1000000US270531040003019,"Block 3019, Block Group 3, Census Tract 1040, Hennepin County, Minnesota",92,81,2,0,3,1,1,4,92,90,80,2,0,3,1,0,4,2,1,0,0,0,0,1,0
270531040005037,18,Como,37,37,1000000US270531040005037,"Block 5037, Block Group 5, Census Tract 1040, Hennepin County, Minnesota",78,60,0,9,6,0,0,3,78,73,60,0,4,6,0,0,3,5,0,0,5,0,0,0,0
270531040005031,18,Como,37,37,1000000US270531040005031,"Block 5031, Block Group 5, Census Tract 1040, Hennepin County, Minnesota",84,66,3,6,6,0,0,3,84,79,64,3,4,6,0,0,2,5,2,0,2,0,0,0,1
270531040003010,18,Como,37,37,1000000US270531040003010,"Block 3010, Block Group 3, Census Tract 1040, Hennepin County, Minnesota",85,56,12,0,16,0,1,0,85,84,55,12,0,16,0,1,0,1,1,0,0,0,0,0,0
270531040002017,18,Como,37,37,1000000US270531040002017,"Block 2017, Block Group 2, Census Tract 1040, Hennepin County, Minnesota",171,162,3,0,0,0,2,4,171,167,161,3,0,0,0,0,3,4,1,0,0,0,0,2,1
270531040002010,18,Como,37,37,1000000US270531040002010,"Block 2010, Block Group 2, Census Tract 1040, Hennepin County, Minnesota",227,44,150,1,24,0,3,5,227,222,42,150,1,24,0,0,5,5,2,0,0,0,0,3,0
270531040002008,18,Como,37,37,1000000US270531040002008,"Block 2008, Block Group 2, Census Tract 1040, Hennepin County, Minnesota",195,161,1,1,28,0,1,3,195,194,161,1,1,28,0,0,3,1,0,0,0,0,0,1,0
270531040004003,18,Como,37,37,1000000US270531040004003,"Block 4003, Block Group 4, Census Tract 1040, Hennepin County, Minnesota",0,0,0,0,0,0,0,0,0,0,0,0,0,0,0,0,0,0,0,0,0,0,0,0,0
270531040001018,18,Como,37,37,1000000US270531040001018,"Block 1018, Block Group 1, Census Tract 1040, Hennepin County, Minnesota",0,0,0,0,0,0,0,0,0,0,0,0,0,0,0,0,0,0,0,0,0,0,0,0,0
270531040001034,18,Como,37,37,1000000US270531040001034,"Block 1034, Block Group 1, Census Tract 1040, Hennepin County, Minnesota",0,0,0,0,0,0,0,0,0,0,0,0,0,0,0,0,0,0,0,0,0,0,0,0,0
270531040001032,18,Como,37,37,1000000US270531040001032,"Block 1032, Block Group 1, Census Tract 1040, Hennepin County, Minnesota",83,78,0,0,3,0,0,2,83,82,77,0,0,3,0,0,2,1,1,0,0,0,0,0,0
270531040001040,18,Como,37,37,1000000US270531040001040,"Block 1040, Block Group 1, Census Tract 1040, Hennepin County, Minnesota",122,80,23,0,12,0,1,6,122,120,79,23,0,12,0,0,6,2,1,0,0,0,0,1,0
270531040001020,18,Como,37,37,1000000US270531040001020,"Block 1020, Block Group 1, Census Tract 1040, Hennepin County, Minnesota",141,84,26,0,17,0,3,11,141,138,83,25,0,17,0,3,10,3,1,1,0,0,0,0,1
270531040001031,18,Como,37,37,1000000US270531040001031,"Block 1031, Block Group 1, Census Tract 1040, Hennepin County, Minnesota",77,70,4,0,1,0,0,2,77,76,69,4,0,1,0,0,2,1,1,0,0,0,0,0,0
270531040001027,18,Como,37,37,1000000US270531040001027,"Block 1027, Block Group 1, Census Tract 1040, Hennepin County, Minnesota",136,113,5,6,5,0,5,2,136,126,110,5,6,5,0,0,0,10,3,0,0,0,0,5,2
270531040002012,18,Como,37,37,1000000US270531040002012,"Block 2012, Block Group 2, Census Tract 1040, Hennepin County, Minnesota",157,30,115,2,1,0,3,6,157,156,29,115,2,1,0,3,6,1,1,0,0,0,0,0,0
270531040002000,18,Como,37,37,1000000US270531040002000,"Block 2000, Block Group 2, Census Tract 1040, Hennepin County, Minnesota",0,0,0,0,0,0,0,0,0,0,0,0,0,0,0,0,0,0,0,0,0,0,0,0,0
270531040001030,18,Como,37,37,1000000US270531040001030,"Block 1030, Block Group 1, Census Tract 1040, Hennepin County, Minnesota",116,103,1,3,7,0,1,1,116,114,102,1,3,7,0,0,1,2,1,0,0,0,0,1,0
270531040002007,18,Como,37,37,1000000US270531040002007,"Block 2007, Block Group 2, Census Tract 1040, Hennepin County, Minnesota",0,0,0,0,0,0,0,0,0,0,0,0,0,0,0,0,0,0,0,0,0,0,0,0,0
270531040003018,18,Como,37,37,1000000US270531040003018,"Block 3018, Block Group 3, Census Tract 1040, Hennepin County, Minnesota",62,59,1,0,0,0,0,2,62,62,59,1,0,0,0,0,2,0,0,0,0,0,0,0,0
270531040005034,18,Como,37,37,1000000US270531040005034,"Block 5034, Block Group 5, Census Tract 1040, Hennepin County, Minnesota",86,77,3,0,4,0,0,2,86,86,77,3,0,4,0,0,2,0,0,0,0,0,0,0,0
270531040005033,18,Como,37,37,1000000US270531040005033,"Block 5033, Block Group 5, Census Tract 1040, Hennepin County, Minnesota",71,61,1,0,7,0,0,2,71,71,61,1,0,7,0,0,2,0,0,0,0,0,0,0,0
270531040003001,18,Como,37,37,1000000US270531040003001,"Block 3001, Block Group 3, Census Tract 1040, Hennepin County, Minnesota",64,57,1,1,0,0,1,4,64,62,57,1,1,0,0,0,3,2,0,0,0,0,0,1,1
270531040001036,18,Como,37,37,1000000US270531040001036,"Block 1036, Block Group 1, Census Tract 1040, Hennepin County, Minnesota",0,0,0,0,0,0,0,0,0,0,0,0,0,0,0,0,0,0,0,0,0,0,0,0,0
270531040001041,18,Como,37,37,1000000US270531040001041,"Block 1041, Block Group 1, Census Tract 1040, Hennepin County, Minnesota",156,69,52,16,9,0,1,9,156,145,65,52,12,9,0,1,6,11,4,0,4,0,0,0,3
270531040002001,18,Como,37,37,1000000US270531040002001,"Block 2001, Block Group 2, Census Tract 1040, Hennepin County, Minnesota",0,0,0,0,0,0,0,0,0,0,0,0,0,0,0,0,0,0,0,0,0,0,0,0,0
270531040001019,18,Como,37,37,1000000US270531040001019,"Block 1019, Block Group 1, Census Tract 1040, Hennepin County, Minnesota",6,0,0,6,0,0,0,0,6,5,0,0,5,0,0,0,0,1,0,0,1,0,0,0,0
270531040001035,18,Como,37,37,1000000US270531040001035,"Block 1035, Block Group 1, Census Tract 1040, Hennepin County, Minnesota",0,0,0,0,0,0,0,0,0,0,0,0,0,0,0,0,0,0,0,0,0,0,0,0,0
270531040002013,18,Como,37,37,1000000US270531040002013,"Block 2013, Block Group 2, Census Tract 1040, Hennepin County, Minnesota",0,0,0,0,0,0,0,0,0,0,0,0,0,0,0,0,0,0,0,0,0,0,0,0,0
270531040002014,18,Como,37,37,1000000US270531040002014,"Block 2014, Block Group 2, Census Tract 1040, Hennepin County, Minnesota",88,62,10,0,7,0,1,8,88,87,62,10,0,7,0,0,8,1,0,0,0,0,0,1,0
270531040002020,18,Como,37,37,1000000US270531040002020,"Block 2020, Block Group 2, Census Tract 1040, Hennepin County, Minnesota",0,0,0,0,0,0,0,0,0,0,0,0,0,0,0,0,0,0,0,0,0,0,0,0,0
270531040001024,18,Como,37,37,1000000US270531040001024,"Block 1024, Block Group 1, Census Tract 1040, Hennepin County, Minnesota",91,79,6,0,3,0,1,2,91,89,78,6,0,3,0,0,2,2,1,0,0,0,0,1,0
270531040005028,18,Como,37,37,1000000US270531040005028,"Block 5028, Block Group 5, Census Tract 1040, Hennepin County, Minnesota",79,72,1,2,2,0,0,2,79,79,72,1,2,2,0,0,2,0,0,0,0,0,0,0,0
270531040005039,18,Como,37,37,1000000US270531040005039,"Block 5039, Block Group 5, Census Tract 1040, Hennepin County, Minnesota",53,50,3,0,0,0,0,0,53,52,49,3,0,0,0,0,0,1,1,0,0,0,0,0,0
270531040004001,18,Como,37,37,1000000US270531040004001,"Block 4001, Block Group 4, Census Tract 1040, Hennepin County, Minnesota",0,0,0,0,0,0,0,0,0,0,0,0,0,0,0,0,0,0,0,0,0,0,0,0,0
270531040003015,18,Como,37,37,1000000US270531040003015,"Block 3015, Block Group 3, Census Tract 1040, Hennepin County, Minnesota",121,85,4,0,26,0,0,6,121,120,85,3,0,26,0,0,6,1,0,1,0,0,0,0,0
270531040003011,18,Como,37,37,1000000US270531040003011,"Block 3011, Block Group 3, Census Tract 1040, Hennepin County, Minnesota",106,90,2,0,7,0,0,7,106,105,89,2,0,7,0,0,7,1,1,0,0,0,0,0,0
270531040003017,18,Como,37,37,1000000US270531040003017,"Block 3017, Block Group 3, Census Tract 1040, Hennepin County, Minnesota",66,62,0,0,3,0,1,0,66,63,60,0,0,3,0,0,0,3,2,0,0,0,0,1,0
270531040005036,18,Como,37,37,1000000US270531040005036,"Block 5036, Block Group 5, Census Tract 1040, Hennepin County, Minnesota",89,76,2,1,4,0,3,3,89,89,76,2,1,4,0,3,3,0,0,0,0,0,0,0,0
270531040003002,18,Como,37,37,1000000US270531040003002,"Block 3002, Block Group 3, Census Tract 1040, Hennepin County, Minnesota",85,67,8,0,6,0,4,0,85,81,67,8,0,6,0,0,0,4,0,0,0,0,0,4,0
270531040005040,18,Como,37,37,1000000US270531040005040,"Block 5040, Block Group 5, Census Tract 1040, Hennepin County, Minnesota",23,20,1,0,0,0,0,2,23,23,20,1,0,0,0,0,2,0,0,0,0,0,0,0,0
270531040003007,18,Como,37,37,1000000US270531040003007,"Block 3007, Block Group 3, Census Tract 1040, Hennepin County, Minnesota",93,69,6,3,9,0,2,4,93,91,68,6,3,9,0,1,4,2,1,0,0,0,0,1,0
270531040003003,18,Como,37,37,1000000US270531040003003,"Block 3003, Block Group 3, Census Tract 1040, Hennepin County, Minnesota",7,7,0,0,0,0,0,0,7,7,7,0,0,0,0,0,0,0,0,0,0,0,0,0,0
270531040003009,18,Como,37,37,1000000US270531040003009,"Block 3009, Block Group 3, Census Tract 1040, Hennepin County, Minnesota",0,0,0,0,0,0,0,0,0,0,0,0,0,0,0,0,0,0,0,0,0,0,0,0,0
270531040004005,18,Como,37,37,1000000US270531040004005,"Block 4005, Block Group 4, Census Tract 1040, Hennepin County, Minnesota",0,0,0,0,0,0,0,0,0,0,0,0,0,0,0,0,0,0,0,0,0,0,0,0,0
270531040002006,18,Como,37,37,1000000US270531040002006,"Block 2006, Block Group 2, Census Tract 1040, Hennepin County, Minnesota",0,0,0,0,0,0,0,0,0,0,0,0,0,0,0,0,0,0,0,0,0,0,0,0,0
270531040002003,18,Como,37,37,1000000US270531040002003,"Block 2003, Block Group 2, Census Tract 1040, Hennepin County, Minnesota",0,0,0,0,0,0,0,0,0,0,0,0,0,0,0,0,0,0,0,0,0,0,0,0,0
270531040001025,18,Como,37,37,1000000US270531040001025,"Block 1025, Block Group 1, Census Tract 1040, Hennepin County, Minnesota",108,86,7,8,6,0,0,1,108,105,86,7,5,6,0,0,1,3,0,0,3,0,0,0,0
270531040003006,18,Como,37,37,1000000US270531040003006,"Block 3006, Block Group 3, Census Tract 1040, Hennepin County, Minnesota",199,125,37,11,17,0,4,5,199,192,124,36,11,17,0,0,4,7,1,1,0,0,0,4,1
270531040004000,18,Como,37,37,1000000US270531040004000,"Block 4000, Block Group 4, Census Tract 1040, Hennepin County, Minnesota",0,0,0,0,0,0,0,0,0,0,0,0,0,0,0,0,0,0,0,0,0,0,0,0,0
270531040002002,18,Como,37,37,1000000US270531040002002,"Block 2002, Block Group 2, Census Tract 1040, Hennepin County, Minnesota",0,0,0,0,0,0,0,0,0,0,0,0,0,0,0,0,0,0,0,0,0,0,0,0,0
270531040005041,18,Como,37,37,1000000US270531040005041,"Block 5041, Block Group 5, Census Tract 1040, Hennepin County, Minnesota",72,58,5,2,5,0,0,2,72,71,57,5,2,5,0,0,2,1,1,0,0,0,0,0,0
270531040003012,18,Como,37,37,1000000US270531040003012,"Block 3012, Block Group 3, Census Tract 1040, Hennepin County, Minnesota",78,67,0,0,11,0,0,0,78,75,64,0,0,11,0,0,0,3,3,0,0,0,0,0,0
270531040004002,18,Como,37,37,1000000US270531040004002,"Block 4002, Block Group 4, Census Tract 1040, Hennepin County, Minnesota",0,0,0,0,0,0,0,0,0,0,0,0,0,0,0,0,0,0,0,0,0,0,0,0,0
270531040005032,18,Como,37,37,1000000US270531040005032,"Block 5032, Block Group 5, Census Tract 1040, Hennepin County, Minnesota",86,73,0,6,5,0,0,2,86,84,71,0,6,5,0,0,2,2,2,0,0,0,0,0,0
270531040002011,18,Como,37,37,1000000US270531040002011,"Block 2011, Block Group 2, Census Tract 1040, Hennepin County, Minnesota",0,0,0,0,0,0,0,0,0,0,0,0,0,0,0,0,0,0,0,0,0,0,0,0,0
270531040002009,18,Como,37,37,1000000US270531040002009,"Block 2009, Block Group 2, Census Tract 1040, Hennepin County, Minnesota",29,24,1,0,3,0,0,1,29,29,24,1,0,3,0,0,1,0,0,0,0,0,0,0,0
270531040002016,18,Como,37,37,1000000US270531040002016,"Block 2016, Block Group 2, Census Tract 1040, Hennepin County, Minnesota",51,45,4,0,2,0,0,0,51,51,45,4,0,2,0,0,0,0,0,0,0,0,0,0,0
270531040001023,18,Como,37,37,1000000US270531040001023,"Block 1023, Block Group 1, Census Tract 1040, Hennepin County, Minnesota",122,98,0,1,12,0,4,7,122,110,96,0,0,12,0,0,2,12,2,0,1,0,0,4,5
270531040001021,18,Como,37,37,1000000US270531040001021,"Block 1021, Block Group 1, Census Tract 1040, Hennepin County, Minnesota",83,68,0,0,4,0,0,11,83,82,67,0,0,4,0,0,11,1,1,0,0,0,0,0,0
270531040001026,18,Como,37,37,1000000US270531040001026,"Block 1026, Block Group 1, Census Tract 1040, Hennepin County, Minnesota",88,83,4,0,1,0,0,0,88,87,82,4,0,1,0,0,0,1,1,0,0,0,0,0,0
270531040002019,18,Como,37,37,1000000US270531040002019,"Block 2019, Block Group 2, Census Tract 1040, Hennepin County, Minnesota",0,0,0,0,0,0,0,0,0,0,0,0,0,0,0,0,0,0,0,0,0,0,0,0,0
270531040002005,18,Como,37,37,1000000US270531040002005,"Block 2005, Block Group 2, Census Tract 1040, Hennepin County, Minnesota",0,0,0,0,0,0,0,0,0,0,0,0,0,0,0,0,0,0,0,0,0,0,0,0,0
270531040002004,18,Como,37,37,1000000US270531040002004,"Block 2004, Block Group 2, Census Tract 1040, Hennepin County, Minnesota",0,0,0,0,0,0,0,0,0,0,0,0,0,0,0,0,0,0,0,0,0,0,0,0,0
270531040005029,18,Como,37,37,1000000US270531040005029,"Block 5029, Block Group 5, Census Tract 1040, Hennepin County, Minnesota",0,0,0,0,0,0,0,0,0,0,0,0,0,0,0,0,0,0,0,0,0,0,0,0,0
270531040005044,18,Como,37,37,1000000US270531040005044,"Block 5044, Block Group 5, Census Tract 1040, Hennepin County, Minnesota",15,13,0,0,2,0,0,0,15,15,13,0,0,2,0,0,0,0,0,0,0,0,0,0,0
270531040005027,18,Como,37,37,1000000US270531040005027,"Block 5027, Block Group 5, Census Tract 1040, Hennepin County, Minnesota",114,92,3,4,8,0,0,7,114,110,89,3,4,8,0,0,6,4,3,0,0,0,0,0,1
270531040002018,18,Como,37,37,1000000US270531040002018,"Block 2018, Block Group 2, Census Tract 1040, Hennepin County, Minnesota",0,0,0,0,0,0,0,0,0,0,0,0,0,0,0,0,0,0,0,0,0,0,0,0,0
270531040005038,18,Como,37,37,1000000US270531040005038,"Block 5038, Block Group 5, Census Tract 1040, Hennepin County, Minnesota",66,63,0,0,3,0,0,0,66,63,60,0,0,3,0,0,0,3,3,0,0,0,0,0,0
270531040003004,18,Como,37,37,1000000US270531040003004,"Block 3004, Block Group 3, Census Tract 1040, Hennepin County, Minnesota",0,0,0,0,0,0,0,0,0,0,0,0,0,0,0,0,0,0,0,0,0,0,0,0,0
270531040001037,18,Como,37,37,1000000US270531040001037,"Block 1037, Block Group 1, Census Tract 1040, Hennepin County, Minnesota",0,0,0,0,0,0,0,0,0,0,0,0,0,0,0,0,0,0,0,0,0,0,0,0,0
270531040001029,18,Como,37,37,1000000US270531040001029,"Block 1029, Block Group 1, Census Tract 1040, Hennepin County, Minnesota",84,69,8,2,0,0,0,5,84,78,66,8,1,0,0,0,3,6,3,0,1,0,0,0,2
270531040001028,18,Como,37,37,1000000US270531040001028,"Block 1028, Block Group 1, Census Tract 1040, Hennepin County, Minnesota",72,71,0,0,0,0,0,1,72,71,70,0,0,0,0,0,1,1,1,0,0,0,0,0,0
270531040005030,18,Como,37,37,1000000US270531040005030,"Block 5030, Block Group 5, Census Tract 1040, Hennepin County, Minnesota",69,52,1,12,1,0,1,2,69,68,52,1,12,1,0,0,2,1,0,0,0,0,0,1,0
270531040001038,18,Como,37,37,1000000US270531040001038,"Block 1038, Block Group 1, Census Tract 1040, Hennepin County, Minnesota",142,131,2,1,2,0,2,4,142,136,126,2,1,2,0,1,4,6,5,0,0,0,0,1,0
270531040001039,18,Como,37,37,1000000US270531040001039,"Block 1039, Block Group 1, Census Tract 1040, Hennepin County, Minnesota",111,96,1,0,11,0,3,0,111,105,93,1,0,11,0,0,0,6,3,0,0,0,0,3,0
270531040003016,18,Como,37,37,1000000US270531040003016,"Block 3016, Block Group 3, Census Tract 1040, Hennepin County, Minnesota",84,77,1,0,1,0,2,3,84,82,75,1,0,1,0,2,3,2,2,0,0,0,0,0,0
270531040001033,18,Como,37,37,1000000US270531040001033,"Block 1033, Block Group 1, Census Tract 1040, Hennepin County, Minnesota",0,0,0,0,0,0,0,0,0,0,0,0,0,0,0,0,0,0,0,0,0,0,0,0,0
270531040002015,18,Como,37,37,1000000US270531040002015,"Block 2015, Block Group 2, Census Tract 1040, Hennepin County, Minnesota",77,66,8,0,1,0,0,2,77,77,66,8,0,1,0,0,2,0,0,0,0,0,0,0,0
270531040005035,18,Como,37,37,1000000US270531040005035,"Block 5035, Block Group 5, Census Tract 1040, Hennepin County, Minnesota",89,72,2,0,10,0,2,3,89,86,69,2,0,10,0,2,3,3,3,0,0,0,0,0,0
270531040003000,18,Como,37,37,1000000US270531040003000,"Block 3000, Block Group 3, Census Tract 1040, Hennepin County, Minnesota",145,125,9,0,5,0,4,2,145,135,122,7,0,5,0,0,1,10,3,2,0,0,0,4,1
270531040003020,18,Como,37,37,1000000US270531040003020,"Block 3020, Block Group 3, Census Tract 1040, Hennepin County, Minnesota",34,33,1,0,0,0,0,0,34,34,33,1,0,0,0,0,0,0,0,0,0,0,0,0,0
270531040003008,18,Como,37,37,1000000US270531040003008,"Block 3008, Block Group 3, Census Tract 1040, Hennepin County, Minnesota",14,14,0,0,0,0,0,0,14,14,14,0,0,0,0,0,0,0,0,0,0,0,0,0,0
270531040004004,18,Como,37,37,1000000US270531040004004,"Block 4004, Block Group 4, Census Tract 1040, Hennepin County, Minnesota",860,403,81,9,310,0,11,46,860,813,369,78,9,308,0,8,41,47,34,3,0,2,0,3,5
270531048005013,19,Cedar Riverside,38,38,1000000US270531048005013,"Block 5013, Block Group 5, Census Tract 1048, Hennepin County, Minnesota",3,0,3,0,0,0,0,0,3,3,0,3,0,0,0,0,0,0,0,0,0,0,0,0,0
270531048005006,19,Cedar Riverside,38,38,1000000US270531048005006,"Block 5006, Block Group 5, Census Tract 1048, Hennepin County, Minnesota",64,49,11,0,3,0,1,0,64,60,46,11,0,3,0,0,0,4,3,0,0,0,0,1,0
270531048005014,19,Cedar Riverside,38,38,1000000US270531048005014,"Block 5014, Block Group 5, Census Tract 1048, Hennepin County, Minnesota",0,0,0,0,0,0,0,0,0,0,0,0,0,0,0,0,0,0,0,0,0,0,0,0,0
270531048005015,19,Cedar Riverside,38,38,1000000US270531048005015,"Block 5015, Block Group 5, Census Tract 1048, Hennepin County, Minnesota",97,77,8,4,5,0,1,2,97,85,70,8,1,5,0,0,1,12,7,0,3,0,0,1,1
270531048005016,19,Cedar Riverside,38,38,1000000US270531048005016,"Block 5016, Block Group 5, Census Tract 1048, Hennepin County, Minnesota",25,15,10,0,0,0,0,0,25,25,15,10,0,0,0,0,0,0,0,0,0,0,0,0,0
270531048005001,19,Cedar Riverside,38,38,1000000US270531048005001,"Block 5001, Block Group 5, Census Tract 1048, Hennepin County, Minnesota",0,0,0,0,0,0,0,0,0,0,0,0,0,0,0,0,0,0,0,0,0,0,0,0,0
270531048003001,19,Cedar Riverside,38,38,1000000US270531048003001,"Block 3001, Block Group 3, Census Tract 1048, Hennepin County, Minnesota",578,438,44,6,52,0,14,24,578,547,421,43,6,52,0,3,22,31,17,1,0,0,0,11,2
270531048005012,19,Cedar Riverside,38,38,1000000US270531048005012,"Block 5012, Block Group 5, Census Tract 1048, Hennepin County, Minnesota",0,0,0,0,0,0,0,0,0,0,0,0,0,0,0,0,0,0,0,0,0,0,0,0,0
270531048005003,19,Cedar Riverside,38,38,1000000US270531048005003,"Block 5003, Block Group 5, Census Tract 1048, Hennepin County, Minnesota",995,764,30,2,151,0,8,40,995,966,745,29,2,151,0,1,38,29,19,1,0,0,0,7,2
270531048003010,19,Cedar Riverside,38,38,1000000US270531048003010,"Block 3010, Block Group 3, Census Tract 1048, Hennepin County, Minnesota",0,0,0,0,0,0,0,0,0,0,0,0,0,0,0,0,0,0,0,0,0,0,0,0,0
270531048005007,19,Cedar Riverside,38,38,1000000US270531048005007,"Block 5007, Block Group 5, Census Tract 1048, Hennepin County, Minnesota",137,74,47,5,1,0,0,10,137,136,73,47,5,1,0,0,10,1,1,0,0,0,0,0,0
270531048005005,19,Cedar Riverside,38,38,1000000US270531048005005,"Block 5005, Block Group 5, Census Tract 1048, Hennepin County, Minnesota",35,7,17,1,3,0,2,5,35,33,7,17,1,3,0,0,5,2,0,0,0,0,0,2,0
270531048005000,19,Cedar Riverside,38,38,1000000US270531048005000,"Block 5000, Block Group 5, Census Tract 1048, Hennepin County, Minnesota",0,0,0,0,0,0,0,0,0,0,0,0,0,0,0,0,0,0,0,0,0,0,0,0,0
270531048001012,19,Cedar Riverside,38,38,1000000US270531048001012,"Block 1012, Block Group 1, Census Tract 1048, Hennepin County, Minnesota",0,0,0,0,0,0,0,0,0,0,0,0,0,0,0,0,0,0,0,0,0,0,0,0,0
270531048001003,19,Cedar Riverside,38,38,1000000US270531048001003,"Block 1003, Block Group 1, Census Tract 1048, Hennepin County, Minnesota",0,0,0,0,0,0,0,0,0,0,0,0,0,0,0,0,0,0,0,0,0,0,0,0,0
270531048002006,19,Cedar Riverside,38,38,1000000US270531048002006,"Block 2006, Block Group 2, Census Tract 1048, Hennepin County, Minnesota",0,0,0,0,0,0,0,0,0,0,0,0,0,0,0,0,0,0,0,0,0,0,0,0,0
270531048001007,19,Cedar Riverside,38,38,1000000US270531048001007,"Block 1007, Block Group 1, Census Tract 1048, Hennepin County, Minnesota",1,1,0,0,0,0,0,0,1,1,1,0,0,0,0,0,0,0,0,0,0,0,0,0,0
270531048003004,19,Cedar Riverside,38,38,1000000US270531048003004,"Block 3004, Block Group 3, Census Tract 1048, Hennepin County, Minnesota",102,78,3,0,21,0,0,0,102,102,78,3,0,21,0,0,0,0,0,0,0,0,0,0,0
270531048001000,19,Cedar Riverside,38,38,1000000US270531048001000,"Block 1000, Block Group 1, Census Tract 1048, Hennepin County, Minnesota",0,0,0,0,0,0,0,0,0,0,0,0,0,0,0,0,0,0,0,0,0,0,0,0,0
270531048002000,19,Cedar Riverside,38,38,1000000US270531048002000,"Block 2000, Block Group 2, Census Tract 1048, Hennepin County, Minnesota",14,6,1,0,5,0,1,1,14,13,6,1,0,5,0,0,1,1,0,0,0,0,0,1,0
270531048001006,19,Cedar Riverside,38,38,1000000US270531048001006,"Block 1006, Block Group 1, Census Tract 1048, Hennepin County, Minnesota",282,226,3,0,41,0,2,10,282,272,218,3,0,41,0,0,10,10,8,0,0,0,0,2,0
270531048002001,19,Cedar Riverside,38,38,1000000US270531048002001,"Block 2001, Block Group 2, Census Tract 1048, Hennepin County, Minnesota",0,0,0,0,0,0,0,0,0,0,0,0,0,0,0,0,0,0,0,0,0,0,0,0,0
270531048003015,19,Cedar Riverside,38,38,1000000US270531048003015,"Block 3015, Block Group 3, Census Tract 1048, Hennepin County, Minnesota",66,16,37,3,3,0,0,7,66,62,15,35,3,3,0,0,6,4,1,2,0,0,0,0,1
270531048002003,19,Cedar Riverside,38,38,1000000US270531048002003,"Block 2003, Block Group 2, Census Tract 1048, Hennepin County, Minnesota",0,0,0,0,0,0,0,0,0,0,0,0,0,0,0,0,0,0,0,0,0,0,0,0,0
270531048003016,19,Cedar Riverside,38,38,1000000US270531048003016,"Block 3016, Block Group 3, Census Tract 1048, Hennepin County, Minnesota",38,12,22,0,3,0,0,1,38,38,12,22,0,3,0,0,1,0,0,0,0,0,0,0,0
270531048001013,19,Cedar Riverside,38,38,1000000US270531048001013,"Block 1013, Block Group 1, Census Tract 1048, Hennepin County, Minnesota",85,46,0,0,32,0,4,3,85,80,45,0,0,32,0,0,3,5,1,0,0,0,0,4,0
270531048003006,19,Cedar Riverside,38,38,1000000US270531048003006,"Block 3006, Block Group 3, Census Tract 1048, Hennepin County, Minnesota",137,83,33,3,7,0,5,6,137,127,78,33,3,7,0,1,5,10,5,0,0,0,0,4,1
270531048001001,19,Cedar Riverside,38,38,1000000US270531048001001,"Block 1001, Block Group 1, Census Tract 1048, Hennepin County, Minnesota",0,0,0,0,0,0,0,0,0,0,0,0,0,0,0,0,0,0,0,0,0,0,0,0,0
270531048001011,19,Cedar Riverside,38,38,1000000US270531048001011,"Block 1011, Block Group 1, Census Tract 1048, Hennepin County, Minnesota",496,336,18,1,124,0,2,15,496,484,329,18,1,123,0,0,13,12,7,0,0,1,0,2,2
270531048003005,19,Cedar Riverside,38,38,1000000US270531048003005,"Block 3005, Block Group 3, Census Tract 1048, Hennepin County, Minnesota",63,34,14,0,12,0,0,3,63,61,33,14,0,12,0,0,2,2,1,0,0,0,0,0,1
270530059012014,19,Cedar Riverside,38,38,1000000US270530059012014,"Block 2014, Block Group 2, Census Tract 59.01, Hennepin County, Minnesota",0,0,0,0,0,0,0,0,0,0,0,0,0,0,0,0,0,0,0,0,0,0,0,0,0
270531048002002,19,Cedar Riverside,38,38,1000000US270531048002002,"Block 2002, Block Group 2, Census Tract 1048, Hennepin County, Minnesota",2,2,0,0,0,0,0,0,2,2,2,0,0,0,0,0,0,0,0,0,0,0,0,0,0
270531048005011,19,Cedar Riverside,38,38,1000000US270531048005011,"Block 5011, Block Group 5, Census Tract 1048, Hennepin County, Minnesota",11,11,0,0,0,0,0,0,11,11,11,0,0,0,0,0,0,0,0,0,0,0,0,0,0
270531048005010,19,Cedar Riverside,38,38,1000000US270531048005010,"Block 5010, Block Group 5, Census Tract 1048, Hennepin County, Minnesota",0,0,0,0,0,0,0,0,0,0,0,0,0,0,0,0,0,0,0,0,0,0,0,0,0
270531048001009,19,Cedar Riverside,38,38,1000000US270531048001009,"Block 1009, Block Group 1, Census Tract 1048, Hennepin County, Minnesota",328,200,21,3,89,0,6,9,328,308,188,21,3,88,0,1,7,20,12,0,0,1,0,5,2
270531048003017,19,Cedar Riverside,38,38,1000000US270531048003017,"Block 3017, Block Group 3, Census Tract 1048, Hennepin County, Minnesota",113,19,64,1,16,0,1,12,113,112,18,64,1,16,0,1,12,1,1,0,0,0,0,0,0
270531048003012,19,Cedar Riverside,38,38,1000000US270531048003012,"Block 3012, Block Group 3, Census Tract 1048, Hennepin County, Minnesota",351,283,27,0,21,1,6,13,351,341,279,27,0,21,1,2,11,10,4,0,0,0,0,4,2
270531048003008,19,Cedar Riverside,38,38,1000000US270531048003008,"Block 3008, Block Group 3, Census Tract 1048, Hennepin County, Minnesota",0,0,0,0,0,0,0,0,0,0,0,0,0,0,0,0,0,0,0,0,0,0,0,0,0
270531048005002,19,Cedar Riverside,38,38,1000000US270531048005002,"Block 5002, Block Group 5, Census Tract 1048, Hennepin County, Minnesota",0,0,0,0,0,0,0,0,0,0,0,0,0,0,0,0,0,0,0,0,0,0,0,0,0
270531048003014,19,Cedar Riverside,38,38,1000000US270531048003014,"Block 3014, Block Group 3, Census Tract 1048, Hennepin County, Minnesota",120,28,75,1,9,0,6,1,120,113,27,75,1,9,0,0,1,7,1,0,0,0,0,6,0
270531048003003,19,Cedar Riverside,38,38,1000000US270531048003003,"Block 3003, Block Group 3, Census Tract 1048, Hennepin County, Minnesota",111,96,3,0,4,1,1,6,111,109,95,3,0,4,1,0,6,2,1,0,0,0,0,1,0
270531048005004,19,Cedar Riverside,38,38,1000000US270531048005004,"Block 5004, Block Group 5, Census Tract 1048, Hennepin County, Minnesota",0,0,0,0,0,0,0,0,0,0,0,0,0,0,0,0,0,0,0,0,0,0,0,0,0
270531048003002,19,Cedar Riverside,38,38,1000000US270531048003002,"Block 3002, Block Group 3, Census Tract 1048, Hennepin County, Minnesota",0,0,0,0,0,0,0,0,0,0,0,0,0,0,0,0,0,0,0,0,0,0,0,0,0
270531048001010,19,Cedar Riverside,38,38,1000000US270531048001010,"Block 1010, Block Group 1, Census Tract 1048, Hennepin County, Minnesota",79,53,4,0,17,0,4,1,79,79,53,4,0,17,0,4,1,0,0,0,0,0,0,0,0
270531048004000,19,Cedar Riverside,38,38,1000000US270531048004000,"Block 4000, Block Group 4, Census Tract 1048, Hennepin County, Minnesota",3043,100,2642,5,185,0,73,38,3043,2945,76,2640,5,185,0,1,38,98,24,2,0,0,0,72,0
270531048002007,19,Cedar Riverside,38,38,1000000US270531048002007,"Block 2007, Block Group 2, Census Tract 1048, Hennepin County, Minnesota",625,58,447,4,81,0,0,35,625,619,58,446,4,80,0,0,31,6,0,1,0,1,0,0,4
270531048001002,19,Cedar Riverside,38,38,1000000US270531048001002,"Block 1002, Block Group 1, Census Tract 1048, Hennepin County, Minnesota",0,0,0,0,0,0,0,0,0,0,0,0,0,0,0,0,0,0,0,0,0,0,0,0,0
270531048001008,19,Cedar Riverside,38,38,1000000US270531048001008,"Block 1008, Block Group 1, Census Tract 1048, Hennepin County, Minnesota",91,5,74,7,0,0,1,4,91,81,5,68,5,0,0,0,3,10,0,6,2,0,0,1,1
270531048001004,19,Cedar Riverside,38,38,1000000US270531048001004,"Block 1004, Block Group 1, Census Tract 1048, Hennepin County, Minnesota",0,0,0,0,0,0,0,0,0,0,0,0,0,0,0,0,0,0,0,0,0,0,0,0,0
270531048003007,19,Cedar Riverside,38,38,1000000US270531048003007,"Block 3007, Block Group 3, Census Tract 1048, Hennepin County, Minnesota",0,0,0,0,0,0,0,0,0,0,0,0,0,0,0,0,0,0,0,0,0,0,0,0,0
270531048003013,19,Cedar Riverside,38,38,1000000US270531048003013,"Block 3013, Block Group 3, Census Tract 1048, Hennepin County, Minnesota",2,2,0,0,0,0,0,0,2,2,2,0,0,0,0,0,0,0,0,0,0,0,0,0,0
270531048005008,19,Cedar Riverside,38,38,1000000US270531048005008,"Block 5008, Block Group 5, Census Tract 1048, Hennepin County, Minnesota",0,0,0,0,0,0,0,0,0,0,0,0,0,0,0,0,0,0,0,0,0,0,0,0,0
270531048003009,19,Cedar Riverside,38,38,1000000US270531048003009,"Block 3009, Block Group 3, Census Tract 1048, Hennepin County, Minnesota",0,0,0,0,0,0,0,0,0,0,0,0,0,0,0,0,0,0,0,0,0,0,0,0,0
270531048003011,19,Cedar Riverside,38,38,1000000US270531048003011,"Block 3011, Block Group 3, Census Tract 1048, Hennepin County, Minnesota",0,0,0,0,0,0,0,0,0,0,0,0,0,0,0,0,0,0,0,0,0,0,0,0,0
270531049005019,19,Cedar Riverside,38,38,1000000US270531049005019,"Block 5019, Block Group 5, Census Tract 1049, Hennepin County, Minnesota",0,0,0,0,0,0,0,0,0,0,0,0,0,0,0,0,0,0,0,0,0,0,0,0,0
270531048003000,19,Cedar Riverside,38,38,1000000US270531048003000,"Block 3000, Block Group 3, Census Tract 1048, Hennepin County, Minnesota",0,0,0,0,0,0,0,0,0,0,0,0,0,0,0,0,0,0,0,0,0,0,0,0,0
270531048005009,19,Cedar Riverside,38,38,1000000US270531048005009,"Block 5009, Block Group 5, Census Tract 1048, Hennepin County, Minnesota",0,0,0,0,0,0,0,0,0,0,0,0,0,0,0,0,0,0,0,0,0,0,0,0,0
270531256002002,20,Prospect Park - East River Road,39,39,1000000US270531256002002,"Block 2002, Block Group 2, Census Tract 1256, Hennepin County, Minnesota",0,0,0,0,0,0,0,0,0,0,0,0,0,0,0,0,0,0,0,0,0,0,0,0,0
270531049002001,20,Prospect Park - East River Road,39,39,1000000US270531049002001,"Block 2001, Block Group 2, Census Tract 1049, Hennepin County, Minnesota",0,0,0,0,0,0,0,0,0,0,0,0,0,0,0,0,0,0,0,0,0,0,0,0,0
270531049002004,20,Prospect Park - East River Road,39,39,1000000US270531049002004,"Block 2004, Block Group 2, Census Tract 1049, Hennepin County, Minnesota",569,341,9,3,199,0,4,13,569,557,333,9,3,199,0,0,13,12,8,0,0,0,0,4,0
270531256002005,20,Prospect Park - East River Road,39,39,1000000US270531256002005,"Block 2005, Block Group 2, Census Tract 1256, Hennepin County, Minnesota",0,0,0,0,0,0,0,0,0,0,0,0,0,0,0,0,0,0,0,0,0,0,0,0,0
270531049002010,20,Prospect Park - East River Road,39,39,1000000US270531049002010,"Block 2010, Block Group 2, Census Tract 1049, Hennepin County, Minnesota",158,102,2,0,52,0,0,2,158,157,101,2,0,52,0,0,2,1,1,0,0,0,0,0,0
270531049001004,20,Prospect Park - East River Road,39,39,1000000US270531049001004,"Block 1004, Block Group 1, Census Tract 1049, Hennepin County, Minnesota",0,0,0,0,0,0,0,0,0,0,0,0,0,0,0,0,0,0,0,0,0,0,0,0,0
270531049001006,20,Prospect Park - East River Road,39,39,1000000US270531049001006,"Block 1006, Block Group 1, Census Tract 1049, Hennepin County, Minnesota",862,671,33,4,133,0,7,14,862,845,658,33,4,133,0,3,14,17,13,0,0,0,0,4,0
270531256001008,20,Prospect Park - East River Road,39,39,1000000US270531256001008,"Block 1008, Block Group 1, Census Tract 1256, Hennepin County, Minnesota",59,57,1,0,0,0,0,1,59,55,54,1,0,0,0,0,0,4,3,0,0,0,0,0,1
270531049003011,20,Prospect Park - East River Road,39,39,1000000US270531049003011,"Block 3011, Block Group 3, Census Tract 1049, Hennepin County, Minnesota",0,0,0,0,0,0,0,0,0,0,0,0,0,0,0,0,0,0,0,0,0,0,0,0,0
270531049002002,20,Prospect Park - East River Road,39,39,1000000US270531049002002,"Block 2002, Block Group 2, Census Tract 1049, Hennepin County, Minnesota",0,0,0,0,0,0,0,0,0,0,0,0,0,0,0,0,0,0,0,0,0,0,0,0,0
270531256002003,20,Prospect Park - East River Road,39,39,1000000US270531256002003,"Block 2003, Block Group 2, Census Tract 1256, Hennepin County, Minnesota",639,394,65,3,148,1,4,24,639,618,377,65,3,148,1,0,24,21,17,0,0,0,0,4,0
270531256002032,20,Prospect Park - East River Road,39,39,1000000US270531256002032,"Block 2032, Block Group 2, Census Tract 1256, Hennepin County, Minnesota",0,0,0,0,0,0,0,0,0,0,0,0,0,0,0,0,0,0,0,0,0,0,0,0,0
270531049002005,20,Prospect Park - East River Road,39,39,1000000US270531049002005,"Block 2005, Block Group 2, Census Tract 1049, Hennepin County, Minnesota",14,10,0,0,3,0,1,0,14,12,9,0,0,3,0,0,0,2,1,0,0,0,0,1,0
270531049002007,20,Prospect Park - East River Road,39,39,1000000US270531049002007,"Block 2007, Block Group 2, Census Tract 1049, Hennepin County, Minnesota",274,176,2,1,82,0,4,9,274,270,175,2,0,82,0,2,9,4,1,0,1,0,0,2,0
270531256001010,20,Prospect Park - East River Road,39,39,1000000US270531256001010,"Block 1010, Block Group 1, Census Tract 1256, Hennepin County, Minnesota",0,0,0,0,0,0,0,0,0,0,0,0,0,0,0,0,0,0,0,0,0,0,0,0,0
270531256002008,20,Prospect Park - East River Road,39,39,1000000US270531256002008,"Block 2008, Block Group 2, Census Tract 1256, Hennepin County, Minnesota",73,63,7,1,2,0,0,0,73,70,60,7,1,2,0,0,0,3,3,0,0,0,0,0,0
270531049002012,20,Prospect Park - East River Road,39,39,1000000US270531049002012,"Block 2012, Block Group 2, Census Tract 1049, Hennepin County, Minnesota",46,39,2,0,5,0,0,0,46,46,39,2,0,5,0,0,0,0,0,0,0,0,0,0,0
270531049002013,20,Prospect Park - East River Road,39,39,1000000US270531049002013,"Block 2013, Block Group 2, Census Tract 1049, Hennepin County, Minnesota",34,31,0,0,3,0,0,0,34,33,30,0,0,3,0,0,0,1,1,0,0,0,0,0,0
270531256002027,20,Prospect Park - East River Road,39,39,1000000US270531256002027,"Block 2027, Block Group 2, Census Tract 1256, Hennepin County, Minnesota",141,123,0,0,10,0,1,7,141,135,119,0,0,10,0,0,6,6,4,0,0,0,0,1,1
270531049001011,20,Prospect Park - East River Road,39,39,1000000US270531049001011,"Block 1011, Block Group 1, Census Tract 1049, Hennepin County, Minnesota",179,10,150,7,10,0,0,2,179,179,10,150,7,10,0,0,2,0,0,0,0,0,0,0,0
270531049003013,20,Prospect Park - East River Road,39,39,1000000US270531049003013,"Block 3013, Block Group 3, Census Tract 1049, Hennepin County, Minnesota",0,0,0,0,0,0,0,0,0,0,0,0,0,0,0,0,0,0,0,0,0,0,0,0,0
270531049002008,20,Prospect Park - East River Road,39,39,1000000US270531049002008,"Block 2008, Block Group 2, Census Tract 1049, Hennepin County, Minnesota",0,0,0,0,0,0,0,0,0,0,0,0,0,0,0,0,0,0,0,0,0,0,0,0,0
270531049003000,20,Prospect Park - East River Road,39,39,1000000US270531049003000,"Block 3000, Block Group 3, Census Tract 1049, Hennepin County, Minnesota",0,0,0,0,0,0,0,0,0,0,0,0,0,0,0,0,0,0,0,0,0,0,0,0,0
270531049001002,20,Prospect Park - East River Road,39,39,1000000US270531049001002,"Block 1002, Block Group 1, Census Tract 1049, Hennepin County, Minnesota",0,0,0,0,0,0,0,0,0,0,0,0,0,0,0,0,0,0,0,0,0,0,0,0,0
270531049001001,20,Prospect Park - East River Road,39,39,1000000US270531049001001,"Block 1001, Block Group 1, Census Tract 1049, Hennepin County, Minnesota",161,106,4,0,42,0,1,8,161,156,103,4,0,42,0,1,6,5,3,0,0,0,0,0,2
270531256002013,20,Prospect Park - East River Road,39,39,1000000US270531256002013,"Block 2013, Block Group 2, Census Tract 1256, Hennepin County, Minnesota",0,0,0,0,0,0,0,0,0,0,0,0,0,0,0,0,0,0,0,0,0,0,0,0,0
270531049001010,20,Prospect Park - East River Road,39,39,1000000US270531049001010,"Block 1010, Block Group 1, Census Tract 1049, Hennepin County, Minnesota",79,0,70,0,4,0,0,5,79,78,0,69,0,4,0,0,5,1,0,1,0,0,0,0,0
270531049001009,20,Prospect Park - East River Road,39,39,1000000US270531049001009,"Block 1009, Block Group 1, Census Tract 1049, Hennepin County, Minnesota",41,39,0,0,1,0,1,0,41,36,34,0,0,1,0,1,0,5,5,0,0,0,0,0,0
270531049003004,20,Prospect Park - East River Road,39,39,1000000US270531049003004,"Block 3004, Block Group 3, Census Tract 1049, Hennepin County, Minnesota",0,0,0,0,0,0,0,0,0,0,0,0,0,0,0,0,0,0,0,0,0,0,0,0,0
270531049002011,20,Prospect Park - East River Road,39,39,1000000US270531049002011,"Block 2011, Block Group 2, Census Tract 1049, Hennepin County, Minnesota",189,129,4,0,49,0,1,6,189,183,124,4,0,49,0,0,6,6,5,0,0,0,0,1,0
270531256002012,20,Prospect Park - East River Road,39,39,1000000US270531256002012,"Block 2012, Block Group 2, Census Tract 1256, Hennepin County, Minnesota",0,0,0,0,0,0,0,0,0,0,0,0,0,0,0,0,0,0,0,0,0,0,0,0,0
270531256002029,20,Prospect Park - East River Road,39,39,1000000US270531256002029,"Block 2029, Block Group 2, Census Tract 1256, Hennepin County, Minnesota",73,65,2,1,0,0,1,4,73,70,63,2,1,0,0,0,4,3,2,0,0,0,0,1,0
270531049001007,20,Prospect Park - East River Road,39,39,1000000US270531049001007,"Block 1007, Block Group 1, Census Tract 1049, Hennepin County, Minnesota",30,27,1,0,0,0,2,0,30,27,26,1,0,0,0,0,0,3,1,0,0,0,0,2,0
270531049003010,20,Prospect Park - East River Road,39,39,1000000US270531049003010,"Block 3010, Block Group 3, Census Tract 1049, Hennepin County, Minnesota",23,19,0,0,4,0,0,0,23,23,19,0,0,4,0,0,0,0,0,0,0,0,0,0,0
270531049001003,20,Prospect Park - East River Road,39,39,1000000US270531049001003,"Block 1003, Block Group 1, Census Tract 1049, Hennepin County, Minnesota",0,0,0,0,0,0,0,0,0,0,0,0,0,0,0,0,0,0,0,0,0,0,0,0,0
270531256001007,20,Prospect Park - East River Road,39,39,1000000US270531256001007,"Block 1007, Block Group 1, Census Tract 1256, Hennepin County, Minnesota",0,0,0,0,0,0,0,0,0,0,0,0,0,0,0,0,0,0,0,0,0,0,0,0,0
270531049003003,20,Prospect Park - East River Road,39,39,1000000US270531049003003,"Block 3003, Block Group 3, Census Tract 1049, Hennepin County, Minnesota",162,129,5,0,26,0,0,2,162,160,128,4,0,26,0,0,2,2,1,1,0,0,0,0,0
270531049003002,20,Prospect Park - East River Road,39,39,1000000US270531049003002,"Block 3002, Block Group 3, Census Tract 1049, Hennepin County, Minnesota",129,75,3,1,46,0,1,3,129,127,74,3,1,46,0,0,3,2,1,0,0,0,0,1,0
270531049003005,20,Prospect Park - East River Road,39,39,1000000US270531049003005,"Block 3005, Block Group 3, Census Tract 1049, Hennepin County, Minnesota",27,26,0,1,0,0,0,0,27,27,26,0,1,0,0,0,0,0,0,0,0,0,0,0,0
270531256002001,20,Prospect Park - East River Road,39,39,1000000US270531256002001,"Block 2001, Block Group 2, Census Tract 1256, Hennepin County, Minnesota",2,1,0,0,0,0,0,1,2,2,1,0,0,0,0,0,1,0,0,0,0,0,0,0,0
270531256002022,20,Prospect Park - East River Road,39,39,1000000US270531256002022,"Block 2022, Block Group 2, Census Tract 1256, Hennepin County, Minnesota",0,0,0,0,0,0,0,0,0,0,0,0,0,0,0,0,0,0,0,0,0,0,0,0,0
270531049003001,20,Prospect Park - East River Road,39,39,1000000US270531049003001,"Block 3001, Block Group 3, Census Tract 1049, Hennepin County, Minnesota",553,389,7,1,141,0,5,10,553,541,378,7,1,141,0,4,10,12,11,0,0,0,0,1,0
270531049003009,20,Prospect Park - East River Road,39,39,1000000US270531049003009,"Block 3009, Block Group 3, Census Tract 1049, Hennepin County, Minnesota",72,62,1,2,7,0,0,0,72,70,60,1,2,7,0,0,0,2,2,0,0,0,0,0,0
270531049001005,20,Prospect Park - East River Road,39,39,1000000US270531049001005,"Block 1005, Block Group 1, Census Tract 1049, Hennepin County, Minnesota",0,0,0,0,0,0,0,0,0,0,0,0,0,0,0,0,0,0,0,0,0,0,0,0,0
270531049003006,20,Prospect Park - East River Road,39,39,1000000US270531049003006,"Block 3006, Block Group 3, Census Tract 1049, Hennepin County, Minnesota",75,51,11,0,10,0,1,2,75,73,50,11,0,10,0,0,2,2,1,0,0,0,0,1,0
270531256002017,20,Prospect Park - East River Road,39,39,1000000US270531256002017,"Block 2017, Block Group 2, Census Tract 1256, Hennepin County, Minnesota",86,76,0,1,4,0,1,4,86,85,76,0,1,4,0,0,4,1,0,0,0,0,0,1,0
270531256002019,20,Prospect Park - East River Road,39,39,1000000US270531256002019,"Block 2019, Block Group 2, Census Tract 1256, Hennepin County, Minnesota",0,0,0,0,0,0,0,0,0,0,0,0,0,0,0,0,0,0,0,0,0,0,0,0,0
270531256002024,20,Prospect Park - East River Road,39,39,1000000US270531256002024,"Block 2024, Block Group 2, Census Tract 1256, Hennepin County, Minnesota",0,0,0,0,0,0,0,0,0,0,0,0,0,0,0,0,0,0,0,0,0,0,0,0,0
270531256001003,20,Prospect Park - East River Road,39,39,1000000US270531256001003,"Block 1003, Block Group 1, Census Tract 1256, Hennepin County, Minnesota",54,48,2,0,2,0,0,2,54,53,48,1,0,2,0,0,2,1,0,1,0,0,0,0,0
270531256002009,20,Prospect Park - East River Road,39,39,1000000US270531256002009,"Block 2009, Block Group 2, Census Tract 1256, Hennepin County, Minnesota",104,83,6,0,8,0,3,4,104,101,82,6,0,8,0,2,3,3,1,0,0,0,0,1,1
270531256001012,20,Prospect Park - East River Road,39,39,1000000US270531256001012,"Block 1012, Block Group 1, Census Tract 1256, Hennepin County, Minnesota",68,57,3,0,6,0,2,0,68,66,57,3,0,6,0,0,0,2,0,0,0,0,0,2,0
270531049003014,20,Prospect Park - East River Road,39,39,1000000US270531049003014,"Block 3014, Block Group 3, Census Tract 1049, Hennepin County, Minnesota",342,272,27,8,26,1,4,4,342,334,266,27,8,26,1,2,4,8,6,0,0,0,0,2,0
270531049001000,20,Prospect Park - East River Road,39,39,1000000US270531049001000,"Block 1000, Block Group 1, Census Tract 1049, Hennepin County, Minnesota",58,55,0,0,1,0,0,2,58,57,54,0,0,1,0,0,2,1,1,0,0,0,0,0,0
270531256002011,20,Prospect Park - East River Road,39,39,1000000US270531256002011,"Block 2011, Block Group 2, Census Tract 1256, Hennepin County, Minnesota",0,0,0,0,0,0,0,0,0,0,0,0,0,0,0,0,0,0,0,0,0,0,0,0,0
270531049003008,20,Prospect Park - East River Road,39,39,1000000US270531049003008,"Block 3008, Block Group 3, Census Tract 1049, Hennepin County, Minnesota",0,0,0,0,0,0,0,0,0,0,0,0,0,0,0,0,0,0,0,0,0,0,0,0,0
270531256002025,20,Prospect Park - East River Road,39,39,1000000US270531256002025,"Block 2025, Block Group 2, Census Tract 1256, Hennepin County, Minnesota",89,88,0,0,1,0,0,0,89,89,88,0,0,1,0,0,0,0,0,0,0,0,0,0,0
270531256001006,20,Prospect Park - East River Road,39,39,1000000US270531256001006,"Block 1006, Block Group 1, Census Tract 1256, Hennepin County, Minnesota",0,0,0,0,0,0,0,0,0,0,0,0,0,0,0,0,0,0,0,0,0,0,0,0,0
270531256002015,20,Prospect Park - East River Road,39,39,1000000US270531256002015,"Block 2015, Block Group 2, Census Tract 1256, Hennepin County, Minnesota",50,45,0,0,1,0,3,1,50,44,42,0,0,1,0,0,1,6,3,0,0,0,0,3,0
270531256001011,20,Prospect Park - East River Road,39,39,1000000US270531256001011,"Block 1011, Block Group 1, Census Tract 1256, Hennepin County, Minnesota",2,2,0,0,0,0,0,0,2,2,2,0,0,0,0,0,0,0,0,0,0,0,0,0,0
270531256001022,20,Prospect Park - East River Road,39,39,1000000US270531256001022,"Block 1022, Block Group 1, Census Tract 1256, Hennepin County, Minnesota",62,61,0,0,1,0,0,0,62,61,60,0,0,1,0,0,0,1,1,0,0,0,0,0,0
270531256001021,20,Prospect Park - East River Road,39,39,1000000US270531256001021,"Block 1021, Block Group 1, Census Tract 1256, Hennepin County, Minnesota",0,0,0,0,0,0,0,0,0,0,0,0,0,0,0,0,0,0,0,0,0,0,0,0,0
270531256001020,20,Prospect Park - East River Road,39,39,1000000US270531256001020,"Block 1020, Block Group 1, Census Tract 1256, Hennepin County, Minnesota",110,92,4,1,10,0,1,2,110,106,90,4,1,10,0,0,1,4,2,0,0,0,0,1,1
270531256002021,20,Prospect Park - East River Road,39,39,1000000US270531256002021,"Block 2021, Block Group 2, Census Tract 1256, Hennepin County, Minnesota",50,41,2,0,4,0,3,0,50,49,40,2,0,4,0,3,0,1,1,0,0,0,0,0,0
270531256001019,20,Prospect Park - East River Road,39,39,1000000US270531256001019,"Block 1019, Block Group 1, Census Tract 1256, Hennepin County, Minnesota",0,0,0,0,0,0,0,0,0,0,0,0,0,0,0,0,0,0,0,0,0,0,0,0,0
270531256001005,20,Prospect Park - East River Road,39,39,1000000US270531256001005,"Block 1005, Block Group 1, Census Tract 1256, Hennepin County, Minnesota",70,59,0,0,5,0,1,5,70,69,58,0,0,5,0,1,5,1,1,0,0,0,0,0,0
270531256001000,20,Prospect Park - East River Road,39,39,1000000US270531256001000,"Block 1000, Block Group 1, Census Tract 1256, Hennepin County, Minnesota",81,69,1,2,6,0,0,3,81,80,68,1,2,6,0,0,3,1,1,0,0,0,0,0,0
270531256002023,20,Prospect Park - East River Road,39,39,1000000US270531256002023,"Block 2023, Block Group 2, Census Tract 1256, Hennepin County, Minnesota",62,58,0,0,4,0,0,0,62,61,57,0,0,4,0,0,0,1,1,0,0,0,0,0,0
270531256002018,20,Prospect Park - East River Road,39,39,1000000US270531256002018,"Block 2018, Block Group 2, Census Tract 1256, Hennepin County, Minnesota",103,97,4,0,1,0,1,0,103,96,91,4,0,1,0,0,0,7,6,0,0,0,0,1,0
270531256002020,20,Prospect Park - East River Road,39,39,1000000US270531256002020,"Block 2020, Block Group 2, Census Tract 1256, Hennepin County, Minnesota",61,46,0,0,15,0,0,0,61,60,45,0,0,15,0,0,0,1,1,0,0,0,0,0,0
270531256001016,20,Prospect Park - East River Road,39,39,1000000US270531256001016,"Block 1016, Block Group 1, Census Tract 1256, Hennepin County, Minnesota",0,0,0,0,0,0,0,0,0,0,0,0,0,0,0,0,0,0,0,0,0,0,0,0,0
270531256001001,20,Prospect Park - East River Road,39,39,1000000US270531256001001,"Block 1001, Block Group 1, Census Tract 1256, Hennepin County, Minnesota",74,68,2,0,2,0,0,2,74,73,67,2,0,2,0,0,2,1,1,0,0,0,0,0,0
270531256001018,20,Prospect Park - East River Road,39,39,1000000US270531256001018,"Block 1018, Block Group 1, Census Tract 1256, Hennepin County, Minnesota",38,37,1,0,0,0,0,0,38,36,35,1,0,0,0,0,0,2,2,0,0,0,0,0,0
270531049005006,20,Prospect Park - East River Road,39,39,1000000US270531049005006,"Block 5006, Block Group 5, Census Tract 1049, Hennepin County, Minnesota",0,0,0,0,0,0,0,0,0,0,0,0,0,0,0,0,0,0,0,0,0,0,0,0,0
270531049003007,20,Prospect Park - East River Road,39,39,1000000US270531049003007,"Block 3007, Block Group 3, Census Tract 1049, Hennepin County, Minnesota",41,32,0,0,9,0,0,0,41,41,32,0,0,9,0,0,0,0,0,0,0,0,0,0,0
270531049002006,20,Prospect Park - East River Road,39,39,1000000US270531049002006,"Block 2006, Block Group 2, Census Tract 1049, Hennepin County, Minnesota",0,0,0,0,0,0,0,0,0,0,0,0,0,0,0,0,0,0,0,0,0,0,0,0,0
270531049002000,20,Prospect Park - East River Road,39,39,1000000US270531049002000,"Block 2000, Block Group 2, Census Tract 1049, Hennepin County, Minnesota",0,0,0,0,0,0,0,0,0,0,0,0,0,0,0,0,0,0,0,0,0,0,0,0,0
270531256002026,20,Prospect Park - East River Road,39,39,1000000US270531256002026,"Block 2026, Block Group 2, Census Tract 1256, Hennepin County, Minnesota",116,110,0,0,6,0,0,0,116,115,109,0,0,6,0,0,0,1,1,0,0,0,0,0,0
270531256001013,20,Prospect Park - East River Road,39,39,1000000US270531256001013,"Block 1013, Block Group 1, Census Tract 1256, Hennepin County, Minnesota",0,0,0,0,0,0,0,0,0,0,0,0,0,0,0,0,0,0,0,0,0,0,0,0,0
270531256002014,20,Prospect Park - East River Road,39,39,1000000US270531256002014,"Block 2014, Block Group 2, Census Tract 1256, Hennepin County, Minnesota",191,158,4,0,20,0,1,8,191,188,156,4,0,20,0,0,8,3,2,0,0,0,0,1,0
270531049001012,20,Prospect Park - East River Road,39,39,1000000US270531049001012,"Block 1012, Block Group 1, Census Tract 1049, Hennepin County, Minnesota",158,2,131,8,11,0,0,6,158,151,1,131,6,11,0,0,2,7,1,0,2,0,0,0,4
270531256002010,20,Prospect Park - East River Road,39,39,1000000US270531256002010,"Block 2010, Block Group 2, Census Tract 1256, Hennepin County, Minnesota",0,0,0,0,0,0,0,0,0,0,0,0,0,0,0,0,0,0,0,0,0,0,0,0,0
270531256002028,20,Prospect Park - East River Road,39,39,1000000US270531256002028,"Block 2028, Block Group 2, Census Tract 1256, Hennepin County, Minnesota",58,50,0,0,7,0,1,0,58,57,50,0,0,7,0,0,0,1,0,0,0,0,0,1,0
270531256001017,20,Prospect Park - East River Road,39,39,1000000US270531256001017,"Block 1017, Block Group 1, Census Tract 1256, Hennepin County, Minnesota",0,0,0,0,0,0,0,0,0,0,0,0,0,0,0,0,0,0,0,0,0,0,0,0,0
270531256001015,20,Prospect Park - East River Road,39,39,1000000US270531256001015,"Block 1015, Block Group 1, Census Tract 1256, Hennepin County, Minnesota",0,0,0,0,0,0,0,0,0,0,0,0,0,0,0,0,0,0,0,0,0,0,0,0,0
270531256002030,20,Prospect Park - East River Road,39,39,1000000US270531256002030,"Block 2030, Block Group 2, Census Tract 1256, Hennepin County, Minnesota",0,0,0,0,0,0,0,0,0,0,0,0,0,0,0,0,0,0,0,0,0,0,0,0,0
270531256002031,20,Prospect Park - East River Road,39,39,1000000US270531256002031,"Block 2031, Block Group 2, Census Tract 1256, Hennepin County, Minnesota",0,0,0,0,0,0,0,0,0,0,0,0,0,0,0,0,0,0,0,0,0,0,0,0,0
270531256002004,20,Prospect Park - East River Road,39,39,1000000US270531256002004,"Block 2004, Block Group 2, Census Tract 1256, Hennepin County, Minnesota",0,0,0,0,0,0,0,0,0,0,0,0,0,0,0,0,0,0,0,0,0,0,0,0,0
270531049002003,20,Prospect Park - East River Road,39,39,1000000US270531049002003,"Block 2003, Block Group 2, Census Tract 1049, Hennepin County, Minnesota",3,1,2,0,0,0,0,0,3,3,1,2,0,0,0,0,0,0,0,0,0,0,0,0,0
270531049005004,20,Prospect Park - East River Road,39,39,1000000US270531049005004,"Block 5004, Block Group 5, Census Tract 1049, Hennepin County, Minnesota",0,0,0,0,0,0,0,0,0,0,0,0,0,0,0,0,0,0,0,0,0,0,0,0,0
270531049002009,20,Prospect Park - East River Road,39,39,1000000US270531049002009,"Block 2009, Block Group 2, Census Tract 1049, Hennepin County, Minnesota",61,55,1,0,2,0,1,2,61,59,54,1,0,2,0,0,2,2,1,0,0,0,0,1,0
270531049001008,20,Prospect Park - East River Road,39,39,1000000US270531049001008,"Block 1008, Block Group 1, Census Tract 1049, Hennepin County, Minnesota",219,41,123,0,46,0,0,9,219,219,41,123,0,46,0,0,9,0,0,0,0,0,0,0,0
270531256001002,20,Prospect Park - East River Road,39,39,1000000US270531256001002,"Block 1002, Block Group 1, Census Tract 1256, Hennepin County, Minnesota",172,142,6,0,17,0,1,6,172,168,138,6,0,17,0,1,6,4,4,0,0,0,0,0,0
270531256002016,20,Prospect Park - East River Road,39,39,1000000US270531256002016,"Block 2016, Block Group 2, Census Tract 1256, Hennepin County, Minnesota",22,22,0,0,0,0,0,0,22,21,21,0,0,0,0,0,0,1,1,0,0,0,0,0,0
270531256001009,20,Prospect Park - East River Road,39,39,1000000US270531256001009,"Block 1009, Block Group 1, Census Tract 1256, Hennepin County, Minnesota",139,124,5,0,2,0,0,8,139,138,124,5,0,2,0,0,7,1,0,0,0,0,0,0,1
270531256001004,20,Prospect Park - East River Road,39,39,1000000US270531256001004,"Block 1004, Block Group 1, Census Tract 1256, Hennepin County, Minnesota",49,43,0,0,2,0,0,4,49,49,43,0,0,2,0,0,4,0,0,0,0,0,0,0,0
270531256002006,20,Prospect Park - East River Road,39,39,1000000US270531256002006,"Block 2006, Block Group 2, Census Tract 1256, Hennepin County, Minnesota",0,0,0,0,0,0,0,0,0,0,0,0,0,0,0,0,0,0,0,0,0,0,0,0,0
270531256002000,20,Prospect Park - East River Road,39,39,1000000US270531256002000,"Block 2000, Block Group 2, Census Tract 1256, Hennepin County, Minnesota",0,0,0,0,0,0,0,0,0,0,0,0,0,0,0,0,0,0,0,0,0,0,0,0,0
270531049003012,20,Prospect Park - East River Road,39,39,1000000US270531049003012,"Block 3012, Block Group 3, Census Tract 1049, Hennepin County, Minnesota",0,0,0,0,0,0,0,0,0,0,0,0,0,0,0,0,0,0,0,0,0,0,0,0,0
270531049005023,21,University of Minnesota,40,40,1000000US270531049005023,"Block 5023, Block Group 5, Census Tract 1049, Hennepin County, Minnesota",1,0,0,0,0,0,0,1,1,1,0,0,0,0,0,0,1,0,0,0,0,0,0,0,0
270531049004000,21,University of Minnesota,40,40,1000000US270531049004000,"Block 4000, Block Group 4, Census Tract 1049, Hennepin County, Minnesota",0,0,0,0,0,0,0,0,0,0,0,0,0,0,0,0,0,0,0,0,0,0,0,0,0
270531049005002,21,University of Minnesota,40,40,1000000US270531049005002,"Block 5002, Block Group 5, Census Tract 1049, Hennepin County, Minnesota",0,0,0,0,0,0,0,0,0,0,0,0,0,0,0,0,0,0,0,0,0,0,0,0,0
270531049004011,21,University of Minnesota,40,40,1000000US270531049004011,"Block 4011, Block Group 4, Census Tract 1049, Hennepin County, Minnesota",0,0,0,0,0,0,0,0,0,0,0,0,0,0,0,0,0,0,0,0,0,0,0,0,0
270531049005003,21,University of Minnesota,40,40,1000000US270531049005003,"Block 5003, Block Group 5, Census Tract 1049, Hennepin County, Minnesota",0,0,0,0,0,0,0,0,0,0,0,0,0,0,0,0,0,0,0,0,0,0,0,0,0
270531049004012,21,University of Minnesota,40,40,1000000US270531049004012,"Block 4012, Block Group 4, Census Tract 1049, Hennepin County, Minnesota",0,0,0,0,0,0,0,0,0,0,0,0,0,0,0,0,0,0,0,0,0,0,0,0,0
270531049004007,21,University of Minnesota,40,40,1000000US270531049004007,"Block 4007, Block Group 4, Census Tract 1049, Hennepin County, Minnesota",0,0,0,0,0,0,0,0,0,0,0,0,0,0,0,0,0,0,0,0,0,0,0,0,0
270531048001005,21,University of Minnesota,40,40,1000000US270531048001005,"Block 1005, Block Group 1, Census Tract 1048, Hennepin County, Minnesota",0,0,0,0,0,0,0,0,0,0,0,0,0,0,0,0,0,0,0,0,0,0,0,0,0
270531049005008,21,University of Minnesota,40,40,1000000US270531049005008,"Block 5008, Block Group 5, Census Tract 1049, Hennepin County, Minnesota",57,54,0,0,2,0,1,0,57,56,54,0,0,2,0,0,0,1,0,0,0,0,0,1,0
270531049004013,21,University of Minnesota,40,40,1000000US270531049004013,"Block 4013, Block Group 4, Census Tract 1049, Hennepin County, Minnesota",0,0,0,0,0,0,0,0,0,0,0,0,0,0,0,0,0,0,0,0,0,0,0,0,0
270531049005018,21,University of Minnesota,40,40,1000000US270531049005018,"Block 5018, Block Group 5, Census Tract 1049, Hennepin County, Minnesota",0,0,0,0,0,0,0,0,0,0,0,0,0,0,0,0,0,0,0,0,0,0,0,0,0
270531049004008,21,University of Minnesota,40,40,1000000US270531049004008,"Block 4008, Block Group 4, Census Tract 1049, Hennepin County, Minnesota",0,0,0,0,0,0,0,0,0,0,0,0,0,0,0,0,0,0,0,0,0,0,0,0,0
270531049004016,21,University of Minnesota,40,40,1000000US270531049004016,"Block 4016, Block Group 4, Census Tract 1049, Hennepin County, Minnesota",0,0,0,0,0,0,0,0,0,0,0,0,0,0,0,0,0,0,0,0,0,0,0,0,0
270531049005000,21,University of Minnesota,40,40,1000000US270531049005000,"Block 5000, Block Group 5, Census Tract 1049, Hennepin County, Minnesota",244,207,11,0,22,0,0,4,244,241,205,11,0,22,0,0,3,3,2,0,0,0,0,0,1
270531049005009,21,University of Minnesota,40,40,1000000US270531049005009,"Block 5009, Block Group 5, Census Tract 1049, Hennepin County, Minnesota",50,49,0,0,1,0,0,0,50,50,49,0,0,1,0,0,0,0,0,0,0,0,0,0,0
270531049005015,21,University of Minnesota,40,40,1000000US270531049005015,"Block 5015, Block Group 5, Census Tract 1049, Hennepin County, Minnesota",670,528,44,2,54,0,11,31,670,638,511,44,1,54,0,0,28,32,17,0,1,0,0,11,3
270531049005014,21,University of Minnesota,40,40,1000000US270531049005014,"Block 5014, Block Group 5, Census Tract 1049, Hennepin County, Minnesota",0,0,0,0,0,0,0,0,0,0,0,0,0,0,0,0,0,0,0,0,0,0,0,0,0
270531049005011,21,University of Minnesota,40,40,1000000US270531049005011,"Block 5011, Block Group 5, Census Tract 1049, Hennepin County, Minnesota",0,0,0,0,0,0,0,0,0,0,0,0,0,0,0,0,0,0,0,0,0,0,0,0,0
270531256002007,21,University of Minnesota,40,40,1000000US270531256002007,"Block 2007, Block Group 2, Census Tract 1256, Hennepin County, Minnesota",0,0,0,0,0,0,0,0,0,0,0,0,0,0,0,0,0,0,0,0,0,0,0,0,0
270531049005020,21,University of Minnesota,40,40,1000000US270531049005020,"Block 5020, Block Group 5, Census Tract 1049, Hennepin County, Minnesota",0,0,0,0,0,0,0,0,0,0,0,0,0,0,0,0,0,0,0,0,0,0,0,0,0
270531049005012,21,University of Minnesota,40,40,1000000US270531049005012,"Block 5012, Block Group 5, Census Tract 1049, Hennepin County, Minnesota",0,0,0,0,0,0,0,0,0,0,0,0,0,0,0,0,0,0,0,0,0,0,0,0,0
270531049004015,21,University of Minnesota,40,40,1000000US270531049004015,"Block 4015, Block Group 4, Census Tract 1049, Hennepin County, Minnesota",0,0,0,0,0,0,0,0,0,0,0,0,0,0,0,0,0,0,0,0,0,0,0,0,0
270531049004005,21,University of Minnesota,40,40,1000000US270531049004005,"Block 4005, Block Group 4, Census Tract 1049, Hennepin County, Minnesota",0,0,0,0,0,0,0,0,0,0,0,0,0,0,0,0,0,0,0,0,0,0,0,0,0
270531049004006,21,University of Minnesota,40,40,1000000US270531049004006,"Block 4006, Block Group 4, Census Tract 1049, Hennepin County, Minnesota",0,0,0,0,0,0,0,0,0,0,0,0,0,0,0,0,0,0,0,0,0,0,0,0,0
270531049004014,21,University of Minnesota,40,40,1000000US270531049004014,"Block 4014, Block Group 4, Census Tract 1049, Hennepin County, Minnesota",31,15,4,7,5,0,0,0,31,29,15,4,5,5,0,0,0,2,0,0,2,0,0,0,0
270531049004003,21,University of Minnesota,40,40,1000000US270531049004003,"Block 4003, Block Group 4, Census Tract 1049, Hennepin County, Minnesota",1000,702,48,2,205,0,5,38,1000,980,690,48,2,203,0,4,33,20,12,0,0,2,0,1,5
270531049005005,21,University of Minnesota,40,40,1000000US270531049005005,"Block 5005, Block Group 5, Census Tract 1049, Hennepin County, Minnesota",0,0,0,0,0,0,0,0,0,0,0,0,0,0,0,0,0,0,0,0,0,0,0,0,0
270531049005021,21,University of Minnesota,40,40,1000000US270531049005021,"Block 5021, Block Group 5, Census Tract 1049, Hennepin County, Minnesota",122,112,2,0,2,1,1,4,122,120,111,2,0,2,1,0,4,2,1,0,0,0,0,1,0
270531049005001,21,University of Minnesota,40,40,1000000US270531049005001,"Block 5001, Block Group 5, Census Tract 1049, Hennepin County, Minnesota",0,0,0,0,0,0,0,0,0,0,0,0,0,0,0,0,0,0,0,0,0,0,0,0,0
270531049005007,21,University of Minnesota,40,40,1000000US270531049005007,"Block 5007, Block Group 5, Census Tract 1049, Hennepin County, Minnesota",239,227,1,0,8,0,0,3,239,235,223,1,0,8,0,0,3,4,4,0,0,0,0,0,0
270531049004001,21,University of Minnesota,40,40,1000000US270531049004001,"Block 4001, Block Group 4, Census Tract 1049, Hennepin County, Minnesota",38,27,0,0,8,0,1,2,38,34,24,0,0,8,0,1,1,4,3,0,0,0,0,0,1
270531049005024,21,University of Minnesota,40,40,1000000US270531049005024,"Block 5024, Block Group 5, Census Tract 1049, Hennepin County, Minnesota",0,0,0,0,0,0,0,0,0,0,0,0,0,0,0,0,0,0,0,0,0,0,0,0,0
270531049004004,21,University of Minnesota,40,40,1000000US270531049004004,"Block 4004, Block Group 4, Census Tract 1049, Hennepin County, Minnesota",0,0,0,0,0,0,0,0,0,0,0,0,0,0,0,0,0,0,0,0,0,0,0,0,0
270531049005022,21,University of Minnesota,40,40,1000000US270531049005022,"Block 5022, Block Group 5, Census Tract 1049, Hennepin County, Minnesota",104,93,2,0,2,1,4,2,104,97,89,2,0,2,1,1,2,7,4,0,0,0,0,3,0
270531049004010,21,University of Minnesota,40,40,1000000US270531049004010,"Block 4010, Block Group 4, Census Tract 1049, Hennepin County, Minnesota",2848,2483,47,8,210,0,10,90,2848,2794,2446,46,5,210,0,4,83,54,37,1,3,0,0,6,7
270531049005010,21,University of Minnesota,40,40,1000000US270531049005010,"Block 5010, Block Group 5, Census Tract 1049, Hennepin County, Minnesota",17,17,0,0,0,0,0,0,17,17,17,0,0,0,0,0,0,0,0,0,0,0,0,0,0
270531049004002,21,University of Minnesota,40,40,1000000US270531049004002,"Block 4002, Block Group 4, Census Tract 1049, Hennepin County, Minnesota",0,0,0,0,0,0,0,0,0,0,0,0,0,0,0,0,0,0,0,0,0,0,0,0,0
270531049005013,21,University of Minnesota,40,40,1000000US270531049005013,"Block 5013, Block Group 5, Census Tract 1049, Hennepin County, Minnesota",0,0,0,0,0,0,0,0,0,0,0,0,0,0,0,0,0,0,0,0,0,0,0,0,0
270531049004009,21,University of Minnesota,40,40,1000000US270531049004009,"Block 4009, Block Group 4, Census Tract 1049, Hennepin County, Minnesota",0,0,0,0,0,0,0,0,0,0,0,0,0,0,0,0,0,0,0,0,0,0,0,0,0
270531021003002,22,Jordan,24,24,1000000US270531021003002,"Block 3002, Block Group 3, Census Tract 1021, Hennepin County, Minnesota",35,6,25,2,0,0,0,2,35,35,6,25,2,0,0,0,2,0,0,0,0,0,0,0,0
270531021003001,22,Jordan,24,24,1000000US270531021003001,"Block 3001, Block Group 3, Census Tract 1021, Hennepin County, Minnesota",97,18,62,6,4,0,0,7,97,92,14,61,6,4,0,0,7,5,4,1,0,0,0,0,0
270531257003017,22,Jordan,24,24,1000000US270531257003017,"Block 3017, Block Group 3, Census Tract 1257, Hennepin County, Minnesota",92,31,41,0,0,0,15,5,92,66,20,41,0,0,0,0,5,26,11,0,0,0,0,15,0
270531257003019,22,Jordan,24,24,1000000US270531257003019,"Block 3019, Block Group 3, Census Tract 1257, Hennepin County, Minnesota",84,14,55,2,5,0,0,8,84,83,14,55,2,5,0,0,7,1,0,0,0,0,0,0,1
270531021001008,22,Jordan,24,24,1000000US270531021001008,"Block 1008, Block Group 1, Census Tract 1021, Hennepin County, Minnesota",74,29,39,0,1,0,1,4,74,69,24,39,0,1,0,1,4,5,5,0,0,0,0,0,0
270531257003002,22,Jordan,24,24,1000000US270531257003002,"Block 3002, Block Group 3, Census Tract 1257, Hennepin County, Minnesota",93,12,51,3,16,0,3,8,93,87,9,51,3,16,0,0,8,6,3,0,0,0,0,3,0
270531257003012,22,Jordan,24,24,1000000US270531257003012,"Block 3012, Block Group 3, Census Tract 1257, Hennepin County, Minnesota",86,16,52,0,16,0,0,2,86,83,16,49,0,16,0,0,2,3,0,3,0,0,0,0,0
270531257003018,22,Jordan,24,24,1000000US270531257003018,"Block 3018, Block Group 3, Census Tract 1257, Hennepin County, Minnesota",94,16,53,1,10,0,11,3,94,82,16,53,1,10,0,0,2,12,0,0,0,0,0,11,1
270531021001000,22,Jordan,24,24,1000000US270531021001000,"Block 1000, Block Group 1, Census Tract 1021, Hennepin County, Minnesota",40,6,13,1,12,0,0,8,40,40,6,13,1,12,0,0,8,0,0,0,0,0,0,0,0
270531021001006,22,Jordan,24,24,1000000US270531021001006,"Block 1006, Block Group 1, Census Tract 1021, Hennepin County, Minnesota",79,14,56,0,0,0,0,9,79,63,10,52,0,0,0,0,1,16,4,4,0,0,0,0,8
270531021001001,22,Jordan,24,24,1000000US270531021001001,"Block 1001, Block Group 1, Census Tract 1021, Hennepin County, Minnesota",42,8,28,1,4,0,1,0,42,41,8,28,1,4,0,0,0,1,0,0,0,0,0,1,0
270531021002003,22,Jordan,24,24,1000000US270531021002003,"Block 2003, Block Group 2, Census Tract 1021, Hennepin County, Minnesota",0,0,0,0,0,0,0,0,0,0,0,0,0,0,0,0,0,0,0,0,0,0,0,0,0
270531021001010,22,Jordan,24,24,1000000US270531021001010,"Block 1010, Block Group 1, Census Tract 1021, Hennepin County, Minnesota",18,1,10,0,7,0,0,0,18,18,1,10,0,7,0,0,0,0,0,0,0,0,0,0,0
270531021001007,22,Jordan,24,24,1000000US270531021001007,"Block 1007, Block Group 1, Census Tract 1021, Hennepin County, Minnesota",48,5,15,0,27,0,0,1,48,48,5,15,0,27,0,0,1,0,0,0,0,0,0,0,0
270531021002008,22,Jordan,24,24,1000000US270531021002008,"Block 2008, Block Group 2, Census Tract 1021, Hennepin County, Minnesota",0,0,0,0,0,0,0,0,0,0,0,0,0,0,0,0,0,0,0,0,0,0,0,0,0
270531021002002,22,Jordan,24,24,1000000US270531021002002,"Block 2002, Block Group 2, Census Tract 1021, Hennepin County, Minnesota",125,15,80,0,20,0,7,3,125,115,15,80,0,20,0,0,0,10,0,0,0,0,0,7,3
270531021001015,22,Jordan,24,24,1000000US270531021001015,"Block 1015, Block Group 1, Census Tract 1021, Hennepin County, Minnesota",33,9,19,0,3,0,2,0,33,29,7,19,0,3,0,0,0,4,2,0,0,0,0,2,0
270531021001011,22,Jordan,24,24,1000000US270531021001011,"Block 1011, Block Group 1, Census Tract 1021, Hennepin County, Minnesota",48,4,31,1,10,0,0,2,48,48,4,31,1,10,0,0,2,0,0,0,0,0,0,0,0
270531013001008,22,Jordan,24,24,1000000US270531013001008,"Block 1008, Block Group 1, Census Tract 1013, Hennepin County, Minnesota",53,13,32,1,0,0,7,0,53,41,8,32,1,0,0,0,0,12,5,0,0,0,0,7,0
270531257002009,22,Jordan,24,24,1000000US270531257002009,"Block 2009, Block Group 2, Census Tract 1257, Hennepin County, Minnesota",78,21,27,1,23,0,5,1,78,70,18,27,1,23,0,0,1,8,3,0,0,0,0,5,0
270531021001005,22,Jordan,24,24,1000000US270531021001005,"Block 1005, Block Group 1, Census Tract 1021, Hennepin County, Minnesota",17,3,14,0,0,0,0,0,17,17,3,14,0,0,0,0,0,0,0,0,0,0,0,0,0
270531013001000,22,Jordan,24,24,1000000US270531013001000,"Block 1000, Block Group 1, Census Tract 1013, Hennepin County, Minnesota",72,15,30,0,19,0,0,8,72,72,15,30,0,19,0,0,8,0,0,0,0,0,0,0,0
270531013002008,22,Jordan,24,24,1000000US270531013002008,"Block 2008, Block Group 2, Census Tract 1013, Hennepin County, Minnesota",45,4,34,3,3,0,0,1,45,45,4,34,3,3,0,0,1,0,0,0,0,0,0,0,0
270531257002005,22,Jordan,24,24,1000000US270531257002005,"Block 2005, Block Group 2, Census Tract 1257, Hennepin County, Minnesota",79,15,33,1,7,0,10,13,79,65,14,33,0,7,0,0,11,14,1,0,1,0,0,10,2
270531021003005,22,Jordan,24,24,1000000US270531021003005,"Block 3005, Block Group 3, Census Tract 1021, Hennepin County, Minnesota",19,0,11,0,8,0,0,0,19,19,0,11,0,8,0,0,0,0,0,0,0,0,0,0,0
270531257001009,22,Jordan,24,24,1000000US270531257001009,"Block 1009, Block Group 1, Census Tract 1257, Hennepin County, Minnesota",90,21,32,0,33,0,0,4,90,90,21,32,0,33,0,0,4,0,0,0,0,0,0,0,0
270531257002002,22,Jordan,24,24,1000000US270531257002002,"Block 2002, Block Group 2, Census Tract 1257, Hennepin County, Minnesota",92,27,37,0,16,0,8,4,92,77,21,37,0,16,0,0,3,15,6,0,0,0,0,8,1
270531257003016,22,Jordan,24,24,1000000US270531257003016,"Block 3016, Block Group 3, Census Tract 1257, Hennepin County, Minnesota",91,24,27,0,34,0,6,0,91,85,24,27,0,34,0,0,0,6,0,0,0,0,0,6,0
270531013002002,22,Jordan,24,24,1000000US270531013002002,"Block 2002, Block Group 2, Census Tract 1013, Hennepin County, Minnesota",72,22,37,1,10,0,0,2,72,72,22,37,1,10,0,0,2,0,0,0,0,0,0,0,0
270531013002006,22,Jordan,24,24,1000000US270531013002006,"Block 2006, Block Group 2, Census Tract 1013, Hennepin County, Minnesota",98,13,58,0,9,0,5,13,98,85,10,52,0,9,0,1,13,13,3,6,0,0,0,4,0
270531257003006,22,Jordan,24,24,1000000US270531257003006,"Block 3006, Block Group 3, Census Tract 1257, Hennepin County, Minnesota",0,0,0,0,0,0,0,0,0,0,0,0,0,0,0,0,0,0,0,0,0,0,0,0,0
270531257003007,22,Jordan,24,24,1000000US270531257003007,"Block 3007, Block Group 3, Census Tract 1257, Hennepin County, Minnesota",50,2,41,0,7,0,0,0,50,50,2,41,0,7,0,0,0,0,0,0,0,0,0,0,0
270531021002009,22,Jordan,24,24,1000000US270531021002009,"Block 2009, Block Group 2, Census Tract 1021, Hennepin County, Minnesota",23,0,15,0,7,0,0,1,23,23,0,15,0,7,0,0,1,0,0,0,0,0,0,0,0
270531021001014,22,Jordan,24,24,1000000US270531021001014,"Block 1014, Block Group 1, Census Tract 1021, Hennepin County, Minnesota",57,5,45,3,1,0,1,2,57,56,5,45,3,1,0,0,2,1,0,0,0,0,0,1,0
270531013001014,22,Jordan,24,24,1000000US270531013001014,"Block 1014, Block Group 1, Census Tract 1013, Hennepin County, Minnesota",0,0,0,0,0,0,0,0,0,0,0,0,0,0,0,0,0,0,0,0,0,0,0,0,0
270531013001007,22,Jordan,24,24,1000000US270531013001007,"Block 1007, Block Group 1, Census Tract 1013, Hennepin County, Minnesota",0,0,0,0,0,0,0,0,0,0,0,0,0,0,0,0,0,0,0,0,0,0,0,0,0
270531013001006,22,Jordan,24,24,1000000US270531013001006,"Block 1006, Block Group 1, Census Tract 1013, Hennepin County, Minnesota",24,19,5,0,0,0,0,0,24,23,18,5,0,0,0,0,0,1,1,0,0,0,0,0,0
270531257001005,22,Jordan,24,24,1000000US270531257001005,"Block 1005, Block Group 1, Census Tract 1257, Hennepin County, Minnesota",42,6,25,0,11,0,0,0,42,42,6,25,0,11,0,0,0,0,0,0,0,0,0,0,0
270531257002003,22,Jordan,24,24,1000000US270531257002003,"Block 2003, Block Group 2, Census Tract 1257, Hennepin County, Minnesota",71,23,36,0,4,0,7,1,71,64,23,36,0,4,0,0,1,7,0,0,0,0,0,7,0
270531257001002,22,Jordan,24,24,1000000US270531257001002,"Block 1002, Block Group 1, Census Tract 1257, Hennepin County, Minnesota",114,10,53,1,42,0,7,1,114,104,9,50,1,42,0,1,1,10,1,3,0,0,0,6,0
270531257001001,22,Jordan,24,24,1000000US270531257001001,"Block 1001, Block Group 1, Census Tract 1257, Hennepin County, Minnesota",92,22,54,1,8,0,6,1,92,87,22,54,1,8,0,1,1,5,0,0,0,0,0,5,0
270531257002001,22,Jordan,24,24,1000000US270531257002001,"Block 2001, Block Group 2, Census Tract 1257, Hennepin County, Minnesota",70,25,18,1,16,0,5,5,70,69,24,18,1,16,0,5,5,1,1,0,0,0,0,0,0
270531257003008,22,Jordan,24,24,1000000US270531257003008,"Block 3008, Block Group 3, Census Tract 1257, Hennepin County, Minnesota",55,16,31,0,0,0,0,8,55,54,15,31,0,0,0,0,8,1,1,0,0,0,0,0,0
270531257003011,22,Jordan,24,24,1000000US270531257003011,"Block 3011, Block Group 3, Census Tract 1257, Hennepin County, Minnesota",97,23,36,1,24,0,6,7,97,90,23,35,1,24,0,0,7,7,0,1,0,0,0,6,0
270531257003010,22,Jordan,24,24,1000000US270531257003010,"Block 3010, Block Group 3, Census Tract 1257, Hennepin County, Minnesota",80,13,60,1,0,0,2,4,80,78,13,60,1,0,0,0,4,2,0,0,0,0,0,2,0
270531013001004,22,Jordan,24,24,1000000US270531013001004,"Block 1004, Block Group 1, Census Tract 1013, Hennepin County, Minnesota",101,12,52,0,33,0,0,4,101,94,6,51,0,33,0,0,4,7,6,1,0,0,0,0,0
270531013001010,22,Jordan,24,24,1000000US270531013001010,"Block 1010, Block Group 1, Census Tract 1013, Hennepin County, Minnesota",81,22,49,0,5,0,0,5,81,81,22,49,0,5,0,0,5,0,0,0,0,0,0,0,0
270531257001003,22,Jordan,24,24,1000000US270531257001003,"Block 1003, Block Group 1, Census Tract 1257, Hennepin County, Minnesota",93,12,43,0,22,0,10,6,93,83,12,43,0,22,0,0,6,10,0,0,0,0,0,10,0
270531021003004,22,Jordan,24,24,1000000US270531021003004,"Block 3004, Block Group 3, Census Tract 1021, Hennepin County, Minnesota",93,28,33,10,8,0,3,11,93,82,23,33,8,8,0,0,10,11,5,0,2,0,0,3,1
270531021003007,22,Jordan,24,24,1000000US270531021003007,"Block 3007, Block Group 3, Census Tract 1021, Hennepin County, Minnesota",14,2,12,0,0,0,0,0,14,14,2,12,0,0,0,0,0,0,0,0,0,0,0,0,0
270531021002007,22,Jordan,24,24,1000000US270531021002007,"Block 2007, Block Group 2, Census Tract 1021, Hennepin County, Minnesota",127,18,67,1,16,0,7,18,127,108,12,64,1,16,0,0,15,19,6,3,0,0,0,7,3
270531013001005,22,Jordan,24,24,1000000US270531013001005,"Block 1005, Block Group 1, Census Tract 1013, Hennepin County, Minnesota",83,24,32,0,6,0,16,5,83,60,20,30,0,6,0,0,4,23,4,2,0,0,0,16,1
270531013002001,22,Jordan,24,24,1000000US270531013002001,"Block 2001, Block Group 2, Census Tract 1013, Hennepin County, Minnesota",93,14,56,0,18,0,0,5,93,93,14,56,0,18,0,0,5,0,0,0,0,0,0,0,0
270531257002007,22,Jordan,24,24,1000000US270531257002007,"Block 2007, Block Group 2, Census Tract 1257, Hennepin County, Minnesota",96,12,29,0,51,0,0,4,96,93,9,29,0,51,0,0,4,3,3,0,0,0,0,0,0
270531257001006,22,Jordan,24,24,1000000US270531257001006,"Block 1006, Block Group 1, Census Tract 1257, Hennepin County, Minnesota",115,28,50,0,12,0,6,19,115,106,28,50,0,12,0,0,16,9,0,0,0,0,0,6,3
270531257001004,22,Jordan,24,24,1000000US270531257001004,"Block 1004, Block Group 1, Census Tract 1257, Hennepin County, Minnesota",130,30,81,0,8,0,7,4,130,113,20,81,0,8,0,0,4,17,10,0,0,0,0,7,0
270531013002009,22,Jordan,24,24,1000000US270531013002009,"Block 2009, Block Group 2, Census Tract 1013, Hennepin County, Minnesota",72,10,58,1,0,0,0,3,72,71,10,58,1,0,0,0,2,1,0,0,0,0,0,0,1
270531021003008,22,Jordan,24,24,1000000US270531021003008,"Block 3008, Block Group 3, Census Tract 1021, Hennepin County, Minnesota",74,10,42,0,19,0,2,1,74,70,8,42,0,19,0,0,1,4,2,0,0,0,0,2,0
270531257003004,22,Jordan,24,24,1000000US270531257003004,"Block 3004, Block Group 3, Census Tract 1257, Hennepin County, Minnesota",63,21,30,1,5,1,1,4,63,60,21,28,1,5,1,0,4,3,0,2,0,0,0,1,0
270531021002000,22,Jordan,24,24,1000000US270531021002000,"Block 2000, Block Group 2, Census Tract 1021, Hennepin County, Minnesota",0,0,0,0,0,0,0,0,0,0,0,0,0,0,0,0,0,0,0,0,0,0,0,0,0
270531013001013,22,Jordan,24,24,1000000US270531013001013,"Block 1013, Block Group 1, Census Tract 1013, Hennepin County, Minnesota",93,8,41,0,40,0,1,3,93,84,2,41,0,40,0,0,1,9,6,0,0,0,0,1,2
270531257001007,22,Jordan,24,24,1000000US270531257001007,"Block 1007, Block Group 1, Census Tract 1257, Hennepin County, Minnesota",99,20,50,0,18,0,3,8,99,96,20,50,0,18,0,0,8,3,0,0,0,0,0,3,0
270531257002004,22,Jordan,24,24,1000000US270531257002004,"Block 2004, Block Group 2, Census Tract 1257, Hennepin County, Minnesota",63,14,25,5,12,0,0,7,63,59,14,25,5,12,0,0,3,4,0,0,0,0,0,0,4
270531021003006,22,Jordan,24,24,1000000US270531021003006,"Block 3006, Block Group 3, Census Tract 1021, Hennepin County, Minnesota",177,11,76,5,56,0,9,20,177,176,11,76,5,56,0,9,19,1,0,0,0,0,0,0,1
270531021003003,22,Jordan,24,24,1000000US270531021003003,"Block 3003, Block Group 3, Census Tract 1021, Hennepin County, Minnesota",15,2,9,3,0,0,0,1,15,14,2,8,3,0,0,0,1,1,0,1,0,0,0,0,0
270531257002008,22,Jordan,24,24,1000000US270531257002008,"Block 2008, Block Group 2, Census Tract 1257, Hennepin County, Minnesota",116,17,67,0,24,0,0,8,116,103,17,54,0,24,0,0,8,13,0,13,0,0,0,0,0
270531257002010,22,Jordan,24,24,1000000US270531257002010,"Block 2010, Block Group 2, Census Tract 1257, Hennepin County, Minnesota",75,8,28,0,26,0,13,0,75,63,8,28,0,26,0,1,0,12,0,0,0,0,0,12,0
270531021003009,22,Jordan,24,24,1000000US270531021003009,"Block 3009, Block Group 3, Census Tract 1021, Hennepin County, Minnesota",99,12,25,0,41,0,10,11,99,82,9,25,0,41,0,0,7,17,3,0,0,0,0,10,4
270531021002004,22,Jordan,24,24,1000000US270531021002004,"Block 2004, Block Group 2, Census Tract 1021, Hennepin County, Minnesota",196,52,83,10,30,0,11,10,196,177,44,83,9,30,0,1,10,19,8,0,1,0,0,10,0
270531257003015,22,Jordan,24,24,1000000US270531257003015,"Block 3015, Block Group 3, Census Tract 1257, Hennepin County, Minnesota",120,23,62,5,30,0,0,0,120,120,23,62,5,30,0,0,0,0,0,0,0,0,0,0,0
270531257001000,22,Jordan,24,24,1000000US270531257001000,"Block 1000, Block Group 1, Census Tract 1257, Hennepin County, Minnesota",82,19,46,0,11,0,3,3,82,76,18,46,0,11,0,0,1,6,1,0,0,0,0,3,2
270531257003001,22,Jordan,24,24,1000000US270531257003001,"Block 3001, Block Group 3, Census Tract 1257, Hennepin County, Minnesota",21,7,10,0,4,0,0,0,21,20,6,10,0,4,0,0,0,1,1,0,0,0,0,0,0
270531013002004,22,Jordan,24,24,1000000US270531013002004,"Block 2004, Block Group 2, Census Tract 1013, Hennepin County, Minnesota",11,0,3,0,0,0,8,0,11,3,0,3,0,0,0,0,0,8,0,0,0,0,0,8,0
270531013002005,22,Jordan,24,24,1000000US270531013002005,"Block 2005, Block Group 2, Census Tract 1013, Hennepin County, Minnesota",0,0,0,0,0,0,0,0,0,0,0,0,0,0,0,0,0,0,0,0,0,0,0,0,0
270531013002010,22,Jordan,24,24,1000000US270531013002010,"Block 2010, Block Group 2, Census Tract 1013, Hennepin County, Minnesota",20,6,9,0,0,0,5,0,20,14,5,9,0,0,0,0,0,6,1,0,0,0,0,5,0
270531021002005,22,Jordan,24,24,1000000US270531021002005,"Block 2005, Block Group 2, Census Tract 1021, Hennepin County, Minnesota",136,22,73,1,32,0,5,3,136,129,22,73,0,32,0,0,2,7,0,0,1,0,0,5,1
270531021001004,22,Jordan,24,24,1000000US270531021001004,"Block 1004, Block Group 1, Census Tract 1021, Hennepin County, Minnesota",84,14,51,9,7,0,0,3,84,84,14,51,9,7,0,0,3,0,0,0,0,0,0,0,0
270531257003009,22,Jordan,24,24,1000000US270531257003009,"Block 3009, Block Group 3, Census Tract 1257, Hennepin County, Minnesota",116,63,48,3,1,0,0,1,116,115,62,48,3,1,0,0,1,1,1,0,0,0,0,0,0
270531013001009,22,Jordan,24,24,1000000US270531013001009,"Block 1009, Block Group 1, Census Tract 1013, Hennepin County, Minnesota",72,6,44,0,15,0,6,1,72,66,6,44,0,15,0,0,1,6,0,0,0,0,0,6,0
270531013001011,22,Jordan,24,24,1000000US270531013001011,"Block 1011, Block Group 1, Census Tract 1013, Hennepin County, Minnesota",100,25,37,0,20,0,10,8,100,88,24,37,0,19,0,1,7,12,1,0,0,1,0,9,1
270531257003005,22,Jordan,24,24,1000000US270531257003005,"Block 3005, Block Group 3, Census Tract 1257, Hennepin County, Minnesota",0,0,0,0,0,0,0,0,0,0,0,0,0,0,0,0,0,0,0,0,0,0,0,0,0
270531257003003,22,Jordan,24,24,1000000US270531257003003,"Block 3003, Block Group 3, Census Tract 1257, Hennepin County, Minnesota",74,17,28,0,24,0,5,0,74,69,17,28,0,24,0,0,0,5,0,0,0,0,0,5,0
270531021003010,22,Jordan,24,24,1000000US270531021003010,"Block 3010, Block Group 3, Census Tract 1021, Hennepin County, Minnesota",40,11,21,6,0,0,0,2,40,37,11,21,3,0,0,0,2,3,0,0,3,0,0,0,0
270531021002006,22,Jordan,24,24,1000000US270531021002006,"Block 2006, Block Group 2, Census Tract 1021, Hennepin County, Minnesota",84,7,41,2,31,0,2,1,84,79,7,41,0,31,0,0,0,5,0,0,2,0,0,2,1
270531013002007,22,Jordan,24,24,1000000US270531013002007,"Block 2007, Block Group 2, Census Tract 1013, Hennepin County, Minnesota",85,17,36,0,30,0,0,2,85,81,14,36,0,30,0,0,1,4,3,0,0,0,0,0,1
270531257002006,22,Jordan,24,24,1000000US270531257002006,"Block 2006, Block Group 2, Census Tract 1257, Hennepin County, Minnesota",95,25,44,0,18,0,4,4,95,74,12,44,0,14,0,0,4,21,13,0,0,4,0,4,0
270531021001002,22,Jordan,24,24,1000000US270531021001002,"Block 1002, Block Group 1, Census Tract 1021, Hennepin County, Minnesota",23,5,7,0,9,0,0,2,23,21,3,7,0,9,0,0,2,2,2,0,0,0,0,0,0
270531257003000,22,Jordan,24,24,1000000US270531257003000,"Block 3000, Block Group 3, Census Tract 1257, Hennepin County, Minnesota",51,15,28,0,6,0,0,2,51,50,14,28,0,6,0,0,2,1,1,0,0,0,0,0,0
270531013002003,22,Jordan,24,24,1000000US270531013002003,"Block 2003, Block Group 2, Census Tract 1013, Hennepin County, Minnesota",76,12,42,2,12,0,2,6,76,72,10,42,2,12,0,0,6,4,2,0,0,0,0,2,0
270531013001002,22,Jordan,24,24,1000000US270531013001002,"Block 1002, Block Group 1, Census Tract 1013, Hennepin County, Minnesota",77,12,20,0,24,0,6,15,77,59,9,20,0,24,0,0,6,18,3,0,0,0,0,6,9
270531257003014,22,Jordan,24,24,1000000US270531257003014,"Block 3014, Block Group 3, Census Tract 1257, Hennepin County, Minnesota",91,20,59,0,3,0,6,3,91,80,15,59,0,3,0,0,3,11,5,0,0,0,0,6,0
270531257003013,22,Jordan,24,24,1000000US270531257003013,"Block 3013, Block Group 3, Census Tract 1257, Hennepin County, Minnesota",108,12,62,0,25,0,0,9,108,99,12,56,0,25,0,0,6,9,0,6,0,0,0,0,3
270531257002000,22,Jordan,24,24,1000000US270531257002000,"Block 2000, Block Group 2, Census Tract 1257, Hennepin County, Minnesota",79,29,24,0,21,0,2,3,79,78,28,24,0,21,0,2,3,1,1,0,0,0,0,0,0
270531257001011,22,Jordan,24,24,1000000US270531257001011,"Block 1011, Block Group 1, Census Tract 1257, Hennepin County, Minnesota",71,14,34,0,17,0,0,6,71,71,14,34,0,17,0,0,6,0,0,0,0,0,0,0,0
270531021001013,22,Jordan,24,24,1000000US270531021001013,"Block 1013, Block Group 1, Census Tract 1021, Hennepin County, Minnesota",71,14,11,0,16,0,28,2,71,44,14,11,0,16,0,1,2,27,0,0,0,0,0,27,0
270531021001009,22,Jordan,24,24,1000000US270531021001009,"Block 1009, Block Group 1, Census Tract 1021, Hennepin County, Minnesota",47,10,21,0,14,0,0,2,47,47,10,21,0,14,0,0,2,0,0,0,0,0,0,0,0
270531021001012,22,Jordan,24,24,1000000US270531021001012,"Block 1012, Block Group 1, Census Tract 1021, Hennepin County, Minnesota",14,0,11,0,0,0,0,3,14,14,0,11,0,0,0,0,3,0,0,0,0,0,0,0,0
270531013001001,22,Jordan,24,24,1000000US270531013001001,"Block 1001, Block Group 1, Census Tract 1013, Hennepin County, Minnesota",64,14,38,2,0,0,1,9,64,57,14,38,2,0,0,0,3,7,0,0,0,0,0,1,6
270531013001012,22,Jordan,24,24,1000000US270531013001012,"Block 1012, Block Group 1, Census Tract 1013, Hennepin County, Minnesota",50,8,25,0,9,0,0,8,50,50,8,25,0,9,0,0,8,0,0,0,0,0,0,0,0
270531013002000,22,Jordan,24,24,1000000US270531013002000,"Block 2000, Block Group 2, Census Tract 1013, Hennepin County, Minnesota",68,22,26,0,8,0,10,2,68,57,21,26,0,8,0,0,2,11,1,0,0,0,0,10,0
270531257001008,22,Jordan,24,24,1000000US270531257001008,"Block 1008, Block Group 1, Census Tract 1257, Hennepin County, Minnesota",99,10,64,0,15,0,5,5,99,88,10,63,0,15,0,0,0,11,0,1,0,0,0,5,5
270531257001010,22,Jordan,24,24,1000000US270531257001010,"Block 1010, Block Group 1, Census Tract 1257, Hennepin County, Minnesota",89,31,32,2,20,0,0,4,89,76,25,27,0,20,0,0,4,13,6,5,2,0,0,0,0
270531013001003,22,Jordan,24,24,1000000US270531013001003,"Block 1003, Block Group 1, Census Tract 1013, Hennepin County, Minnesota",94,18,61,0,2,0,9,4,94,82,15,61,0,2,0,0,4,12,3,0,0,0,0,9,0
270531021003000,22,Jordan,24,24,1000000US270531021003000,"Block 3000, Block Group 3, Census Tract 1021, Hennepin County, Minnesota",39,6,5,0,27,0,0,1,39,39,6,5,0,27,0,0,1,0,0,0,0,0,0,0,0
270531021002001,22,Jordan,24,24,1000000US270531021002001,"Block 2001, Block Group 2, Census Tract 1021, Hennepin County, Minnesota",123,24,52,7,22,0,0,18,123,114,24,51,0,22,0,0,17,9,0,1,7,0,0,0,1
270531021001003,22,Jordan,24,24,1000000US270531021001003,"Block 1003, Block Group 1, Census Tract 1021, Hennepin County, Minnesota",49,3,14,1,18,0,10,3,49,37,3,14,1,18,0,0,1,12,0,0,0,0,0,10,2
270531023001004,23,Hawthorne,25,25,1000000US270531023001004,"Block 1004, Block Group 1, Census Tract 1023, Hennepin County, Minnesota",0,0,0,0,0,0,0,0,0,0,0,0,0,0,0,0,0,0,0,0,0,0,0,0,0
270531016002009,23,Hawthorne,25,25,1000000US270531016002009,"Block 2009, Block Group 2, Census Tract 1016, Hennepin County, Minnesota",42,15,9,0,16,0,0,2,42,42,15,9,0,16,0,0,2,0,0,0,0,0,0,0,0
270531016003004,23,Hawthorne,25,25,1000000US270531016003004,"Block 3004, Block Group 3, Census Tract 1016, Hennepin County, Minnesota",100,20,47,8,16,0,0,9,100,95,20,47,4,16,0,0,8,5,0,0,4,0,0,0,1
270531016002010,23,Hawthorne,25,25,1000000US270531016002010,"Block 2010, Block Group 2, Census Tract 1016, Hennepin County, Minnesota",51,12,20,2,4,0,10,3,51,38,12,19,1,4,0,0,2,13,0,1,1,0,0,10,1
270531016001015,23,Hawthorne,25,25,1000000US270531016001015,"Block 1015, Block Group 1, Census Tract 1016, Hennepin County, Minnesota",29,6,10,0,13,0,0,0,29,29,6,10,0,13,0,0,0,0,0,0,0,0,0,0,0
270531016002017,23,Hawthorne,25,25,1000000US270531016002017,"Block 2017, Block Group 2, Census Tract 1016, Hennepin County, Minnesota",95,23,44,2,19,0,0,7,95,93,23,42,2,19,0,0,7,2,0,2,0,0,0,0,0
270531016003003,23,Hawthorne,25,25,1000000US270531016003003,"Block 3003, Block Group 3, Census Tract 1016, Hennepin County, Minnesota",110,24,48,1,26,0,6,5,110,102,23,48,0,26,0,0,5,8,1,0,1,0,0,6,0
270530022001005,23,Hawthorne,25,25,1000000US270530022001005,"Block 1005, Block Group 1, Census Tract 22, Hennepin County, Minnesota",65,12,29,7,16,0,0,1,65,62,9,29,7,16,0,0,1,3,3,0,0,0,0,0,0
270530022001003,23,Hawthorne,25,25,1000000US270530022001003,"Block 1003, Block Group 1, Census Tract 22, Hennepin County, Minnesota",26,9,17,0,0,0,0,0,26,26,9,17,0,0,0,0,0,0,0,0,0,0,0,0,0
270531016001009,23,Hawthorne,25,25,1000000US270531016001009,"Block 1009, Block Group 1, Census Tract 1016, Hennepin County, Minnesota",0,0,0,0,0,0,0,0,0,0,0,0,0,0,0,0,0,0,0,0,0,0,0,0,0
270531016001006,23,Hawthorne,25,25,1000000US270531016001006,"Block 1006, Block Group 1, Census Tract 1016, Hennepin County, Minnesota",0,0,0,0,0,0,0,0,0,0,0,0,0,0,0,0,0,0,0,0,0,0,0,0,0
270531016001020,23,Hawthorne,25,25,1000000US270531016001020,"Block 1020, Block Group 1, Census Tract 1016, Hennepin County, Minnesota",0,0,0,0,0,0,0,0,0,0,0,0,0,0,0,0,0,0,0,0,0,0,0,0,0
270531023001003,23,Hawthorne,25,25,1000000US270531023001003,"Block 1003, Block Group 1, Census Tract 1023, Hennepin County, Minnesota",0,0,0,0,0,0,0,0,0,0,0,0,0,0,0,0,0,0,0,0,0,0,0,0,0
270531016001008,23,Hawthorne,25,25,1000000US270531016001008,"Block 1008, Block Group 1, Census Tract 1016, Hennepin County, Minnesota",0,0,0,0,0,0,0,0,0,0,0,0,0,0,0,0,0,0,0,0,0,0,0,0,0
270531016001018,23,Hawthorne,25,25,1000000US270531016001018,"Block 1018, Block Group 1, Census Tract 1016, Hennepin County, Minnesota",0,0,0,0,0,0,0,0,0,0,0,0,0,0,0,0,0,0,0,0,0,0,0,0,0
270531023001018,23,Hawthorne,25,25,1000000US270531023001018,"Block 1018, Block Group 1, Census Tract 1023, Hennepin County, Minnesota",0,0,0,0,0,0,0,0,0,0,0,0,0,0,0,0,0,0,0,0,0,0,0,0,0
270531023001001,23,Hawthorne,25,25,1000000US270531023001001,"Block 1001, Block Group 1, Census Tract 1023, Hennepin County, Minnesota",0,0,0,0,0,0,0,0,0,0,0,0,0,0,0,0,0,0,0,0,0,0,0,0,0
270531023001023,23,Hawthorne,25,25,1000000US270531023001023,"Block 1023, Block Group 1, Census Tract 1023, Hennepin County, Minnesota",0,0,0,0,0,0,0,0,0,0,0,0,0,0,0,0,0,0,0,0,0,0,0,0,0
270531023001006,23,Hawthorne,25,25,1000000US270531023001006,"Block 1006, Block Group 1, Census Tract 1023, Hennepin County, Minnesota",0,0,0,0,0,0,0,0,0,0,0,0,0,0,0,0,0,0,0,0,0,0,0,0,0
270531016001019,23,Hawthorne,25,25,1000000US270531016001019,"Block 1019, Block Group 1, Census Tract 1016, Hennepin County, Minnesota",0,0,0,0,0,0,0,0,0,0,0,0,0,0,0,0,0,0,0,0,0,0,0,0,0
270531023001021,23,Hawthorne,25,25,1000000US270531023001021,"Block 1021, Block Group 1, Census Tract 1023, Hennepin County, Minnesota",43,32,11,0,0,0,0,0,43,43,32,11,0,0,0,0,0,0,0,0,0,0,0,0,0
270531016001021,23,Hawthorne,25,25,1000000US270531016001021,"Block 1021, Block Group 1, Census Tract 1016, Hennepin County, Minnesota",0,0,0,0,0,0,0,0,0,0,0,0,0,0,0,0,0,0,0,0,0,0,0,0,0
270531016001000,23,Hawthorne,25,25,1000000US270531016001000,"Block 1000, Block Group 1, Census Tract 1016, Hennepin County, Minnesota",0,0,0,0,0,0,0,0,0,0,0,0,0,0,0,0,0,0,0,0,0,0,0,0,0
270530017002010,23,Hawthorne,25,25,1000000US270530017002010,"Block 2010, Block Group 2, Census Tract 17, Hennepin County, Minnesota",0,0,0,0,0,0,0,0,0,0,0,0,0,0,0,0,0,0,0,0,0,0,0,0,0
270530022002004,23,Hawthorne,25,25,1000000US270530022002004,"Block 2004, Block Group 2, Census Tract 22, Hennepin County, Minnesota",32,14,10,3,4,0,0,1,32,32,14,10,3,4,0,0,1,0,0,0,0,0,0,0,0
270530022002012,23,Hawthorne,25,25,1000000US270530022002012,"Block 2012, Block Group 2, Census Tract 22, Hennepin County, Minnesota",67,3,0,0,63,0,0,1,67,65,1,0,0,63,0,0,1,2,2,0,0,0,0,0,0
270530022002000,23,Hawthorne,25,25,1000000US270530022002000,"Block 2000, Block Group 2, Census Tract 22, Hennepin County, Minnesota",65,9,45,0,0,0,10,1,65,55,9,45,0,0,0,0,1,10,0,0,0,0,0,10,0
270531023001024,23,Hawthorne,25,25,1000000US270531023001024,"Block 1024, Block Group 1, Census Tract 1023, Hennepin County, Minnesota",10,6,0,4,0,0,0,0,10,10,6,0,4,0,0,0,0,0,0,0,0,0,0,0,0
270531023001022,23,Hawthorne,25,25,1000000US270531023001022,"Block 1022, Block Group 1, Census Tract 1023, Hennepin County, Minnesota",0,0,0,0,0,0,0,0,0,0,0,0,0,0,0,0,0,0,0,0,0,0,0,0,0
270531023001020,23,Hawthorne,25,25,1000000US270531023001020,"Block 1020, Block Group 1, Census Tract 1023, Hennepin County, Minnesota",0,0,0,0,0,0,0,0,0,0,0,0,0,0,0,0,0,0,0,0,0,0,0,0,0
270531023001017,23,Hawthorne,25,25,1000000US270531023001017,"Block 1017, Block Group 1, Census Tract 1023, Hennepin County, Minnesota",0,0,0,0,0,0,0,0,0,0,0,0,0,0,0,0,0,0,0,0,0,0,0,0,0
270530022002013,23,Hawthorne,25,25,1000000US270530022002013,"Block 2013, Block Group 2, Census Tract 22, Hennepin County, Minnesota",0,0,0,0,0,0,0,0,0,0,0,0,0,0,0,0,0,0,0,0,0,0,0,0,0
270530022002011,23,Hawthorne,25,25,1000000US270530022002011,"Block 2011, Block Group 2, Census Tract 22, Hennepin County, Minnesota",4,3,0,0,0,0,0,1,4,4,3,0,0,0,0,0,1,0,0,0,0,0,0,0,0
270531023001013,23,Hawthorne,25,25,1000000US270531023001013,"Block 1013, Block Group 1, Census Tract 1023, Hennepin County, Minnesota",56,11,37,0,3,0,0,5,56,56,11,37,0,3,0,0,5,0,0,0,0,0,0,0,0
270530022002009,23,Hawthorne,25,25,1000000US270530022002009,"Block 2009, Block Group 2, Census Tract 22, Hennepin County, Minnesota",67,21,28,1,10,0,3,4,67,61,15,28,1,10,0,3,4,6,6,0,0,0,0,0,0
270531023001012,23,Hawthorne,25,25,1000000US270531023001012,"Block 1012, Block Group 1, Census Tract 1023, Hennepin County, Minnesota",63,13,17,0,29,0,3,1,63,60,13,17,0,29,0,0,1,3,0,0,0,0,0,3,0
270531023001008,23,Hawthorne,25,25,1000000US270531023001008,"Block 1008, Block Group 1, Census Tract 1023, Hennepin County, Minnesota",92,25,38,0,14,0,4,11,92,73,11,38,0,14,0,0,10,19,14,0,0,0,0,4,1
270531023001019,23,Hawthorne,25,25,1000000US270531023001019,"Block 1019, Block Group 1, Census Tract 1023, Hennepin County, Minnesota",2,2,0,0,0,0,0,0,2,2,2,0,0,0,0,0,0,0,0,0,0,0,0,0,0
270531023001028,23,Hawthorne,25,25,1000000US270531023001028,"Block 1028, Block Group 1, Census Tract 1023, Hennepin County, Minnesota",0,0,0,0,0,0,0,0,0,0,0,0,0,0,0,0,0,0,0,0,0,0,0,0,0
270531023001009,23,Hawthorne,25,25,1000000US270531023001009,"Block 1009, Block Group 1, Census Tract 1023, Hennepin County, Minnesota",72,4,37,0,17,0,5,9,72,67,4,37,0,17,0,0,9,5,0,0,0,0,0,5,0
270531023001029,23,Hawthorne,25,25,1000000US270531023001029,"Block 1029, Block Group 1, Census Tract 1023, Hennepin County, Minnesota",7,2,5,0,0,0,0,0,7,7,2,5,0,0,0,0,0,0,0,0,0,0,0,0,0
270531016001017,23,Hawthorne,25,25,1000000US270531016001017,"Block 1017, Block Group 1, Census Tract 1016, Hennepin County, Minnesota",0,0,0,0,0,0,0,0,0,0,0,0,0,0,0,0,0,0,0,0,0,0,0,0,0
270531023001002,23,Hawthorne,25,25,1000000US270531023001002,"Block 1002, Block Group 1, Census Tract 1023, Hennepin County, Minnesota",0,0,0,0,0,0,0,0,0,0,0,0,0,0,0,0,0,0,0,0,0,0,0,0,0
270531016001022,23,Hawthorne,25,25,1000000US270531016001022,"Block 1022, Block Group 1, Census Tract 1016, Hennepin County, Minnesota",0,0,0,0,0,0,0,0,0,0,0,0,0,0,0,0,0,0,0,0,0,0,0,0,0
270531016003001,23,Hawthorne,25,25,1000000US270531016003001,"Block 3001, Block Group 3, Census Tract 1016, Hennepin County, Minnesota",111,19,29,0,34,0,20,9,111,80,12,29,0,34,0,0,5,31,7,0,0,0,0,20,4
270530022001007,23,Hawthorne,25,25,1000000US270530022001007,"Block 1007, Block Group 1, Census Tract 22, Hennepin County, Minnesota",47,6,41,0,0,0,0,0,47,40,5,35,0,0,0,0,0,7,1,6,0,0,0,0,0
270531016001013,23,Hawthorne,25,25,1000000US270531016001013,"Block 1013, Block Group 1, Census Tract 1016, Hennepin County, Minnesota",55,9,20,14,12,0,0,0,55,44,9,20,3,12,0,0,0,11,0,0,11,0,0,0,0
270531016001014,23,Hawthorne,25,25,1000000US270531016001014,"Block 1014, Block Group 1, Census Tract 1016, Hennepin County, Minnesota",35,8,15,0,0,0,3,9,35,32,8,15,0,0,0,0,9,3,0,0,0,0,0,3,0
270531016003006,23,Hawthorne,25,25,1000000US270531016003006,"Block 3006, Block Group 3, Census Tract 1016, Hennepin County, Minnesota",86,3,65,0,18,0,0,0,86,86,3,65,0,18,0,0,0,0,0,0,0,0,0,0,0
270530022001014,23,Hawthorne,25,25,1000000US270530022001014,"Block 1014, Block Group 1, Census Tract 22, Hennepin County, Minnesota",35,5,3,1,11,0,13,2,35,21,5,3,0,11,0,0,2,14,0,0,1,0,0,13,0
270531016001007,23,Hawthorne,25,25,1000000US270531016001007,"Block 1007, Block Group 1, Census Tract 1016, Hennepin County, Minnesota",0,0,0,0,0,0,0,0,0,0,0,0,0,0,0,0,0,0,0,0,0,0,0,0,0
270531016001001,23,Hawthorne,25,25,1000000US270531016001001,"Block 1001, Block Group 1, Census Tract 1016, Hennepin County, Minnesota",0,0,0,0,0,0,0,0,0,0,0,0,0,0,0,0,0,0,0,0,0,0,0,0,0
270531016001003,23,Hawthorne,25,25,1000000US270531016001003,"Block 1003, Block Group 1, Census Tract 1016, Hennepin County, Minnesota",0,0,0,0,0,0,0,0,0,0,0,0,0,0,0,0,0,0,0,0,0,0,0,0,0
270531016001024,23,Hawthorne,25,25,1000000US270531016001024,"Block 1024, Block Group 1, Census Tract 1016, Hennepin County, Minnesota",0,0,0,0,0,0,0,0,0,0,0,0,0,0,0,0,0,0,0,0,0,0,0,0,0
270531023001000,23,Hawthorne,25,25,1000000US270531023001000,"Block 1000, Block Group 1, Census Tract 1023, Hennepin County, Minnesota",0,0,0,0,0,0,0,0,0,0,0,0,0,0,0,0,0,0,0,0,0,0,0,0,0
270531016003005,23,Hawthorne,25,25,1000000US270531016003005,"Block 3005, Block Group 3, Census Tract 1016, Hennepin County, Minnesota",107,5,51,0,37,0,0,14,107,106,5,51,0,37,0,0,13,1,0,0,0,0,0,0,1
270531016003002,23,Hawthorne,25,25,1000000US270531016003002,"Block 3002, Block Group 3, Census Tract 1016, Hennepin County, Minnesota",109,15,39,0,40,0,0,15,109,101,7,39,0,40,0,0,15,8,8,0,0,0,0,0,0
270530022001013,23,Hawthorne,25,25,1000000US270530022001013,"Block 1013, Block Group 1, Census Tract 22, Hennepin County, Minnesota",59,17,25,4,12,0,0,1,59,59,17,25,4,12,0,0,1,0,0,0,0,0,0,0,0
270530022001002,23,Hawthorne,25,25,1000000US270530022001002,"Block 1002, Block Group 1, Census Tract 22, Hennepin County, Minnesota",39,15,21,0,3,0,0,0,39,33,9,21,0,3,0,0,0,6,6,0,0,0,0,0,0
270530022001001,23,Hawthorne,25,25,1000000US270530022001001,"Block 1001, Block Group 1, Census Tract 22, Hennepin County, Minnesota",22,7,9,0,0,0,0,6,22,20,6,9,0,0,0,0,5,2,1,0,0,0,0,0,1
270530022001000,23,Hawthorne,25,25,1000000US270530022001000,"Block 1000, Block Group 1, Census Tract 22, Hennepin County, Minnesota",61,7,43,0,0,0,4,7,61,57,7,43,0,0,0,0,7,4,0,0,0,0,0,4,0
270530022001009,23,Hawthorne,25,25,1000000US270530022001009,"Block 1009, Block Group 1, Census Tract 22, Hennepin County, Minnesota",85,6,18,0,29,0,21,11,85,61,3,18,0,29,0,0,11,24,3,0,0,0,0,21,0
270531023001027,23,Hawthorne,25,25,1000000US270531023001027,"Block 1027, Block Group 1, Census Tract 1023, Hennepin County, Minnesota",0,0,0,0,0,0,0,0,0,0,0,0,0,0,0,0,0,0,0,0,0,0,0,0,0
270531016002003,23,Hawthorne,25,25,1000000US270531016002003,"Block 2003, Block Group 2, Census Tract 1016, Hennepin County, Minnesota",11,6,5,0,0,0,0,0,11,9,6,3,0,0,0,0,0,2,0,2,0,0,0,0,0
270531016002007,23,Hawthorne,25,25,1000000US270531016002007,"Block 2007, Block Group 2, Census Tract 1016, Hennepin County, Minnesota",131,19,59,9,21,0,2,21,131,120,19,54,7,21,0,0,19,11,0,5,2,0,0,2,2
270531016002011,23,Hawthorne,25,25,1000000US270531016002011,"Block 2011, Block Group 2, Census Tract 1016, Hennepin County, Minnesota",66,16,29,0,21,0,0,0,66,60,11,28,0,21,0,0,0,6,5,1,0,0,0,0,0
270530022001012,23,Hawthorne,25,25,1000000US270530022001012,"Block 1012, Block Group 1, Census Tract 22, Hennepin County, Minnesota",47,10,21,2,11,0,3,0,47,44,10,21,2,11,0,0,0,3,0,0,0,0,0,3,0
270531023001016,23,Hawthorne,25,25,1000000US270531023001016,"Block 1016, Block Group 1, Census Tract 1023, Hennepin County, Minnesota",67,7,57,0,0,0,0,3,67,67,7,57,0,0,0,0,3,0,0,0,0,0,0,0,0
270531016002005,23,Hawthorne,25,25,1000000US270531016002005,"Block 2005, Block Group 2, Census Tract 1016, Hennepin County, Minnesota",94,13,73,0,0,0,3,5,94,87,12,72,0,0,0,0,3,7,1,1,0,0,0,3,2
270531016002004,23,Hawthorne,25,25,1000000US270531016002004,"Block 2004, Block Group 2, Census Tract 1016, Hennepin County, Minnesota",56,11,31,0,0,0,9,5,56,47,11,31,0,0,0,0,5,9,0,0,0,0,0,9,0
270531016002006,23,Hawthorne,25,25,1000000US270531016002006,"Block 2006, Block Group 2, Census Tract 1016, Hennepin County, Minnesota",73,14,52,0,2,0,3,2,73,73,14,52,0,2,0,3,2,0,0,0,0,0,0,0,0
270530022001006,23,Hawthorne,25,25,1000000US270530022001006,"Block 1006, Block Group 1, Census Tract 22, Hennepin County, Minnesota",53,10,26,0,11,0,3,3,53,48,5,26,0,11,0,3,3,5,5,0,0,0,0,0,0
270531023001010,23,Hawthorne,25,25,1000000US270531023001010,"Block 1010, Block Group 1, Census Tract 1023, Hennepin County, Minnesota",99,12,70,1,10,0,0,6,99,99,12,70,1,10,0,0,6,0,0,0,0,0,0,0,0
270531016001016,23,Hawthorne,25,25,1000000US270531016001016,"Block 1016, Block Group 1, Census Tract 1016, Hennepin County, Minnesota",110,10,60,0,27,0,0,13,110,108,10,60,0,25,0,0,13,2,0,0,0,2,0,0,0
270531023001014,23,Hawthorne,25,25,1000000US270531023001014,"Block 1014, Block Group 1, Census Tract 1023, Hennepin County, Minnesota",53,10,25,0,6,0,12,0,53,41,9,25,0,6,0,1,0,12,1,0,0,0,0,11,0
270531016002016,23,Hawthorne,25,25,1000000US270531016002016,"Block 2016, Block Group 2, Census Tract 1016, Hennepin County, Minnesota",130,14,73,0,36,0,0,7,130,129,13,73,0,36,0,0,7,1,1,0,0,0,0,0,0
270531016002012,23,Hawthorne,25,25,1000000US270531016002012,"Block 2012, Block Group 2, Census Tract 1016, Hennepin County, Minnesota",17,6,7,4,0,0,0,0,17,16,5,7,4,0,0,0,0,1,1,0,0,0,0,0,0
270531023001011,23,Hawthorne,25,25,1000000US270531023001011,"Block 1011, Block Group 1, Census Tract 1023, Hennepin County, Minnesota",81,15,49,3,9,0,2,3,81,75,14,46,3,9,0,0,3,6,1,3,0,0,0,2,0
270531023001026,23,Hawthorne,25,25,1000000US270531023001026,"Block 1026, Block Group 1, Census Tract 1023, Hennepin County, Minnesota",0,0,0,0,0,0,0,0,0,0,0,0,0,0,0,0,0,0,0,0,0,0,0,0,0
270531016002008,23,Hawthorne,25,25,1000000US270531016002008,"Block 2008, Block Group 2, Census Tract 1016, Hennepin County, Minnesota",34,15,12,0,7,0,0,0,34,26,7,12,0,7,0,0,0,8,8,0,0,0,0,0,0
270531016002001,23,Hawthorne,25,25,1000000US270531016002001,"Block 2001, Block Group 2, Census Tract 1016, Hennepin County, Minnesota",0,0,0,0,0,0,0,0,0,0,0,0,0,0,0,0,0,0,0,0,0,0,0,0,0
270531016002000,23,Hawthorne,25,25,1000000US270531016002000,"Block 2000, Block Group 2, Census Tract 1016, Hennepin County, Minnesota",9,2,7,0,0,0,0,0,9,9,2,7,0,0,0,0,0,0,0,0,0,0,0,0,0
270531016002014,23,Hawthorne,25,25,1000000US270531016002014,"Block 2014, Block Group 2, Census Tract 1016, Hennepin County, Minnesota",40,11,19,0,5,0,5,0,40,35,11,19,0,5,0,0,0,5,0,0,0,0,0,5,0
270530022001008,23,Hawthorne,25,25,1000000US270530022001008,"Block 1008, Block Group 1, Census Tract 22, Hennepin County, Minnesota",79,10,56,0,13,0,0,0,79,69,0,56,0,13,0,0,0,10,10,0,0,0,0,0,0
270531016003000,23,Hawthorne,25,25,1000000US270531016003000,"Block 3000, Block Group 3, Census Tract 1016, Hennepin County, Minnesota",27,0,15,0,12,0,0,0,27,27,0,15,0,12,0,0,0,0,0,0,0,0,0,0,0
270530022001011,23,Hawthorne,25,25,1000000US270530022001011,"Block 1011, Block Group 1, Census Tract 22, Hennepin County, Minnesota",67,8,9,5,21,0,15,9,67,38,1,9,5,21,0,0,2,29,7,0,0,0,0,15,7
270531023001015,23,Hawthorne,25,25,1000000US270531023001015,"Block 1015, Block Group 1, Census Tract 1023, Hennepin County, Minnesota",46,8,24,2,10,0,0,2,46,46,8,24,2,10,0,0,2,0,0,0,0,0,0,0,0
270530022001010,23,Hawthorne,25,25,1000000US270530022001010,"Block 1010, Block Group 1, Census Tract 22, Hennepin County, Minnesota",34,6,10,0,18,0,0,0,34,33,5,10,0,18,0,0,0,1,1,0,0,0,0,0,0
270531016001005,23,Hawthorne,25,25,1000000US270531016001005,"Block 1005, Block Group 1, Census Tract 1016, Hennepin County, Minnesota",0,0,0,0,0,0,0,0,0,0,0,0,0,0,0,0,0,0,0,0,0,0,0,0,0
270531016003007,23,Hawthorne,25,25,1000000US270531016003007,"Block 3007, Block Group 3, Census Tract 1016, Hennepin County, Minnesota",111,17,64,3,11,0,1,15,111,110,17,64,3,11,0,0,15,1,0,0,0,0,0,1,0
270531016001010,23,Hawthorne,25,25,1000000US270531016001010,"Block 1010, Block Group 1, Census Tract 1016, Hennepin County, Minnesota",86,11,40,0,24,0,11,0,86,75,11,40,0,24,0,0,0,11,0,0,0,0,0,11,0
270531023001007,23,Hawthorne,25,25,1000000US270531023001007,"Block 1007, Block Group 1, Census Tract 1023, Hennepin County, Minnesota",12,1,9,0,1,0,0,1,12,12,1,9,0,1,0,0,1,0,0,0,0,0,0,0,0
270531023001005,23,Hawthorne,25,25,1000000US270531023001005,"Block 1005, Block Group 1, Census Tract 1023, Hennepin County, Minnesota",0,0,0,0,0,0,0,0,0,0,0,0,0,0,0,0,0,0,0,0,0,0,0,0,0
270530022002003,23,Hawthorne,25,25,1000000US270530022002003,"Block 2003, Block Group 2, Census Tract 22, Hennepin County, Minnesota",44,16,22,0,0,0,0,6,44,41,16,20,0,0,0,0,5,3,0,2,0,0,0,0,1
270530022001004,23,Hawthorne,25,25,1000000US270530022001004,"Block 1004, Block Group 1, Census Tract 22, Hennepin County, Minnesota",43,18,13,1,5,0,0,6,43,42,18,13,0,5,0,0,6,1,0,0,1,0,0,0,0
270531016002002,23,Hawthorne,25,25,1000000US270531016002002,"Block 2002, Block Group 2, Census Tract 1016, Hennepin County, Minnesota",19,4,0,0,11,0,3,1,19,15,4,0,0,11,0,0,0,4,0,0,0,0,0,3,1
270531016001002,23,Hawthorne,25,25,1000000US270531016001002,"Block 1002, Block Group 1, Census Tract 1016, Hennepin County, Minnesota",0,0,0,0,0,0,0,0,0,0,0,0,0,0,0,0,0,0,0,0,0,0,0,0,0
270531016001023,23,Hawthorne,25,25,1000000US270531016001023,"Block 1023, Block Group 1, Census Tract 1016, Hennepin County, Minnesota",0,0,0,0,0,0,0,0,0,0,0,0,0,0,0,0,0,0,0,0,0,0,0,0,0
270531016001004,23,Hawthorne,25,25,1000000US270531016001004,"Block 1004, Block Group 1, Census Tract 1016, Hennepin County, Minnesota",0,0,0,0,0,0,0,0,0,0,0,0,0,0,0,0,0,0,0,0,0,0,0,0,0
270530022002005,23,Hawthorne,25,25,1000000US270530022002005,"Block 2005, Block Group 2, Census Tract 22, Hennepin County, Minnesota",31,2,29,0,0,0,0,0,31,31,2,29,0,0,0,0,0,0,0,0,0,0,0,0,0
270530022002006,23,Hawthorne,25,25,1000000US270530022002006,"Block 2006, Block Group 2, Census Tract 22, Hennepin County, Minnesota",56,6,25,3,6,0,11,5,56,43,6,23,3,6,0,0,5,13,0,2,0,0,0,11,0
270530022002002,23,Hawthorne,25,25,1000000US270530022002002,"Block 2002, Block Group 2, Census Tract 22, Hennepin County, Minnesota",47,12,19,0,12,0,0,4,47,47,12,19,0,12,0,0,4,0,0,0,0,0,0,0,0
270530022002001,23,Hawthorne,25,25,1000000US270530022002001,"Block 2001, Block Group 2, Census Tract 22, Hennepin County, Minnesota",83,18,12,0,21,0,22,10,83,53,7,12,0,21,0,3,10,30,11,0,0,0,0,19,0
270530022002007,23,Hawthorne,25,25,1000000US270530022002007,"Block 2007, Block Group 2, Census Tract 22, Hennepin County, Minnesota",107,13,65,0,20,0,2,7,107,104,13,65,0,20,0,1,5,3,0,0,0,0,0,1,2
270530022002008,23,Hawthorne,25,25,1000000US270530022002008,"Block 2008, Block Group 2, Census Tract 22, Hennepin County, Minnesota",62,7,28,0,24,0,0,3,62,62,7,28,0,24,0,0,3,0,0,0,0,0,0,0,0
270530022002010,23,Hawthorne,25,25,1000000US270530022002010,"Block 2010, Block Group 2, Census Tract 22, Hennepin County, Minnesota",0,0,0,0,0,0,0,0,0,0,0,0,0,0,0,0,0,0,0,0,0,0,0,0,0
270531023001025,23,Hawthorne,25,25,1000000US270531023001025,"Block 1025, Block Group 1, Census Tract 1023, Hennepin County, Minnesota",0,0,0,0,0,0,0,0,0,0,0,0,0,0,0,0,0,0,0,0,0,0,0,0,0
270531016002015,23,Hawthorne,25,25,1000000US270531016002015,"Block 2015, Block Group 2, Census Tract 1016, Hennepin County, Minnesota",69,12,37,0,10,0,0,10,69,64,12,37,0,10,0,0,5,5,0,0,0,0,0,0,5
270531016001011,23,Hawthorne,25,25,1000000US270531016001011,"Block 1011, Block Group 1, Census Tract 1016, Hennepin County, Minnesota",223,42,161,4,6,0,0,10,223,216,41,158,4,6,0,0,7,7,1,3,0,0,0,0,3
270531016002013,23,Hawthorne,25,25,1000000US270531016002013,"Block 2013, Block Group 2, Census Tract 1016, Hennepin County, Minnesota",68,26,22,3,16,0,0,1,68,62,20,22,3,16,0,0,1,6,6,0,0,0,0,0,0
270531016001012,23,Hawthorne,25,25,1000000US270531016001012,"Block 1012, Block Group 1, Census Tract 1016, Hennepin County, Minnesota",53,13,18,10,7,0,0,5,53,39,6,18,3,7,0,0,5,14,7,0,7,0,0,0,0
270531023001030,23,Hawthorne,25,25,1000000US270531023001030,"Block 1030, Block Group 1, Census Tract 1023, Hennepin County, Minnesota",0,0,0,0,0,0,0,0,0,0,0,0,0,0,0,0,0,0,0,0,0,0,0,0,0
270531016003008,23,Hawthorne,25,25,1000000US270531016003008,"Block 3008, Block Group 3, Census Tract 1016, Hennepin County, Minnesota",80,17,42,1,3,0,6,11,80,79,17,42,0,3,0,6,11,1,0,0,1,0,0,0,0
270530027002014,24,Willard - Hay,26,26,1000000US270530027002014,"Block 2014, Block Group 2, Census Tract 27, Hennepin County, Minnesota",88,7,51,0,15,0,0,15,88,84,6,51,0,15,0,0,12,4,1,0,0,0,0,0,3
270530032001007,24,Willard - Hay,26,26,1000000US270530032001007,"Block 1007, Block Group 1, Census Tract 32, Hennepin County, Minnesota",25,20,2,0,0,0,0,3,25,25,20,2,0,0,0,0,3,0,0,0,0,0,0,0,0
270530032001006,24,Willard - Hay,26,26,1000000US270530032001006,"Block 1006, Block Group 1, Census Tract 32, Hennepin County, Minnesota",44,20,23,1,0,0,0,0,44,44,20,23,1,0,0,0,0,0,0,0,0,0,0,0,0
270530032001005,24,Willard - Hay,26,26,1000000US270530032001005,"Block 1005, Block Group 1, Census Tract 32, Hennepin County, Minnesota",35,15,18,0,0,0,0,2,35,35,15,18,0,0,0,0,2,0,0,0,0,0,0,0,0
270530032001016,24,Willard - Hay,26,26,1000000US270530032001016,"Block 1016, Block Group 1, Census Tract 32, Hennepin County, Minnesota",34,5,28,0,0,0,0,1,34,34,5,28,0,0,0,0,1,0,0,0,0,0,0,0,0
270530032002009,24,Willard - Hay,26,26,1000000US270530032002009,"Block 2009, Block Group 2, Census Tract 32, Hennepin County, Minnesota",62,13,32,0,0,0,15,2,62,48,13,32,0,0,0,1,2,14,0,0,0,0,0,14,0
270530027002007,24,Willard - Hay,26,26,1000000US270530027002007,"Block 2007, Block Group 2, Census Tract 27, Hennepin County, Minnesota",66,8,48,0,9,0,1,0,66,65,8,47,0,9,0,1,0,1,0,1,0,0,0,0,0
270530027002006,24,Willard - Hay,26,26,1000000US270530027002006,"Block 2006, Block Group 2, Census Tract 27, Hennepin County, Minnesota",78,14,47,6,0,0,5,6,78,64,13,45,0,0,0,0,6,14,1,2,6,0,0,5,0
270530027001013,24,Willard - Hay,26,26,1000000US270530027001013,"Block 1013, Block Group 1, Census Tract 27, Hennepin County, Minnesota",73,8,51,0,9,0,3,2,73,71,8,51,0,9,0,1,2,2,0,0,0,0,0,2,0
270530032002006,24,Willard - Hay,26,26,1000000US270530032002006,"Block 2006, Block Group 2, Census Tract 32, Hennepin County, Minnesota",57,10,26,0,12,0,0,9,57,57,10,26,0,12,0,0,9,0,0,0,0,0,0,0,0
270530032001011,24,Willard - Hay,26,26,1000000US270530032001011,"Block 1011, Block Group 1, Census Tract 32, Hennepin County, Minnesota",38,11,27,0,0,0,0,0,38,38,11,27,0,0,0,0,0,0,0,0,0,0,0,0,0
270530032001013,24,Willard - Hay,26,26,1000000US270530032001013,"Block 1013, Block Group 1, Census Tract 32, Hennepin County, Minnesota",0,0,0,0,0,0,0,0,0,0,0,0,0,0,0,0,0,0,0,0,0,0,0,0,0
270530032002010,24,Willard - Hay,26,26,1000000US270530032002010,"Block 2010, Block Group 2, Census Tract 32, Hennepin County, Minnesota",59,15,28,1,5,0,0,10,59,57,15,28,1,5,0,0,8,2,0,0,0,0,0,0,2
270531020001012,24,Willard - Hay,26,26,1000000US270531020001012,"Block 1012, Block Group 1, Census Tract 1020, Hennepin County, Minnesota",98,17,55,2,16,0,0,8,98,91,12,54,2,16,0,0,7,7,5,1,0,0,0,0,1
270531028003003,24,Willard - Hay,26,26,1000000US270531028003003,"Block 3003, Block Group 3, Census Tract 1028, Hennepin County, Minnesota",72,7,47,0,18,0,0,0,72,67,2,47,0,18,0,0,0,5,5,0,0,0,0,0,0
270531028002016,24,Willard - Hay,26,26,1000000US270531028002016,"Block 2016, Block Group 2, Census Tract 1028, Hennepin County, Minnesota",61,8,52,1,0,0,0,0,61,61,8,52,1,0,0,0,0,0,0,0,0,0,0,0,0
270531028002011,24,Willard - Hay,26,26,1000000US270531028002011,"Block 2011, Block Group 2, Census Tract 1028, Hennepin County, Minnesota",0,0,0,0,0,0,0,0,0,0,0,0,0,0,0,0,0,0,0,0,0,0,0,0,0
270531028002006,24,Willard - Hay,26,26,1000000US270531028002006,"Block 2006, Block Group 2, Census Tract 1028, Hennepin County, Minnesota",46,3,28,1,13,0,0,1,46,46,3,28,1,13,0,0,1,0,0,0,0,0,0,0,0
270530032002011,24,Willard - Hay,26,26,1000000US270530032002011,"Block 2011, Block Group 2, Census Tract 32, Hennepin County, Minnesota",72,30,21,9,1,0,11,0,72,45,16,19,9,1,0,0,0,27,14,2,0,0,0,11,0
270530032002007,24,Willard - Hay,26,26,1000000US270530032002007,"Block 2007, Block Group 2, Census Tract 32, Hennepin County, Minnesota",41,3,30,0,5,0,0,3,41,40,3,29,0,5,0,0,3,1,0,1,0,0,0,0,0
270531028003017,24,Willard - Hay,26,26,1000000US270531028003017,"Block 3017, Block Group 3, Census Tract 1028, Hennepin County, Minnesota",140,11,99,0,21,0,5,4,140,128,11,92,0,21,0,0,4,12,0,7,0,0,0,5,0
270530032002000,24,Willard - Hay,26,26,1000000US270530032002000,"Block 2000, Block Group 2, Census Tract 32, Hennepin County, Minnesota",111,8,81,1,14,0,5,2,111,108,6,80,1,14,0,5,2,3,2,1,0,0,0,0,0
270531028003002,24,Willard - Hay,26,26,1000000US270531028003002,"Block 3002, Block Group 3, Census Tract 1028, Hennepin County, Minnesota",50,3,35,0,12,0,0,0,50,49,2,35,0,12,0,0,0,1,1,0,0,0,0,0,0
270531028003004,24,Willard - Hay,26,26,1000000US270531028003004,"Block 3004, Block Group 3, Census Tract 1028, Hennepin County, Minnesota",62,4,36,0,17,0,5,0,62,57,4,36,0,17,0,0,0,5,0,0,0,0,0,5,0
270531028002009,24,Willard - Hay,26,26,1000000US270531028002009,"Block 2009, Block Group 2, Census Tract 1028, Hennepin County, Minnesota",17,0,16,1,0,0,0,0,17,16,0,15,1,0,0,0,0,1,0,1,0,0,0,0,0
270531020001002,24,Willard - Hay,26,26,1000000US270531020001002,"Block 1002, Block Group 1, Census Tract 1020, Hennepin County, Minnesota",117,25,64,0,8,0,7,13,117,106,22,64,0,8,0,0,12,11,3,0,0,0,0,7,1
270531028003011,24,Willard - Hay,26,26,1000000US270531028003011,"Block 3011, Block Group 3, Census Tract 1028, Hennepin County, Minnesota",56,17,22,0,0,0,15,2,56,32,10,22,0,0,0,0,0,24,7,0,0,0,0,15,2
270531028003014,24,Willard - Hay,26,26,1000000US270531028003014,"Block 3014, Block Group 3, Census Tract 1028, Hennepin County, Minnesota",44,3,41,0,0,0,0,0,44,44,3,41,0,0,0,0,0,0,0,0,0,0,0,0,0
270531028003016,24,Willard - Hay,26,26,1000000US270531028003016,"Block 3016, Block Group 3, Census Tract 1028, Hennepin County, Minnesota",61,8,44,0,0,0,0,9,61,56,3,44,0,0,0,0,9,5,5,0,0,0,0,0,0
270531028003007,24,Willard - Hay,26,26,1000000US270531028003007,"Block 3007, Block Group 3, Census Tract 1028, Hennepin County, Minnesota",76,2,31,6,17,0,10,10,76,66,2,31,6,17,0,0,10,10,0,0,0,0,0,10,0
270530032002016,24,Willard - Hay,26,26,1000000US270530032002016,"Block 2016, Block Group 2, Census Tract 32, Hennepin County, Minnesota",0,0,0,0,0,0,0,0,0,0,0,0,0,0,0,0,0,0,0,0,0,0,0,0,0
270531028002002,24,Willard - Hay,26,26,1000000US270531028002002,"Block 2002, Block Group 2, Census Tract 1028, Hennepin County, Minnesota",64,9,47,0,0,0,0,8,64,63,8,47,0,0,0,0,8,1,1,0,0,0,0,0,0
270531028002013,24,Willard - Hay,26,26,1000000US270531028002013,"Block 2013, Block Group 2, Census Tract 1028, Hennepin County, Minnesota",68,10,30,5,15,0,6,2,68,62,10,30,5,15,0,0,2,6,0,0,0,0,0,6,0
270531028002015,24,Willard - Hay,26,26,1000000US270531028002015,"Block 2015, Block Group 2, Census Tract 1028, Hennepin County, Minnesota",55,2,37,3,0,0,7,6,55,42,2,37,3,0,0,0,0,13,0,0,0,0,0,7,6
270530027001010,24,Willard - Hay,26,26,1000000US270530027001010,"Block 1010, Block Group 1, Census Tract 27, Hennepin County, Minnesota",89,8,34,12,30,0,4,1,89,81,8,30,12,30,0,0,1,8,0,4,0,0,0,4,0
270531020003010,24,Willard - Hay,26,26,1000000US270531020003010,"Block 3010, Block Group 3, Census Tract 1020, Hennepin County, Minnesota",28,8,12,0,8,0,0,0,28,24,4,12,0,8,0,0,0,4,4,0,0,0,0,0,0
270531028003001,24,Willard - Hay,26,26,1000000US270531028003001,"Block 3001, Block Group 3, Census Tract 1028, Hennepin County, Minnesota",47,2,39,0,0,0,0,6,47,47,2,39,0,0,0,0,6,0,0,0,0,0,0,0,0
270531028003005,24,Willard - Hay,26,26,1000000US270531028003005,"Block 3005, Block Group 3, Census Tract 1028, Hennepin County, Minnesota",75,2,43,0,30,0,0,0,75,74,2,43,0,29,0,0,0,1,0,0,0,1,0,0,0
270531028002008,24,Willard - Hay,26,26,1000000US270531028002008,"Block 2008, Block Group 2, Census Tract 1028, Hennepin County, Minnesota",17,0,11,6,0,0,0,0,17,17,0,11,6,0,0,0,0,0,0,0,0,0,0,0,0
270530032001019,24,Willard - Hay,26,26,1000000US270530032001019,"Block 1019, Block Group 1, Census Tract 32, Hennepin County, Minnesota",6,0,6,0,0,0,0,0,6,6,0,6,0,0,0,0,0,0,0,0,0,0,0,0,0
270530027001000,24,Willard - Hay,26,26,1000000US270530027001000,"Block 1000, Block Group 1, Census Tract 27, Hennepin County, Minnesota",76,11,49,1,3,0,0,12,76,72,10,48,1,3,0,0,10,4,1,1,0,0,0,0,2
270530027001009,24,Willard - Hay,26,26,1000000US270530027001009,"Block 1009, Block Group 1, Census Tract 27, Hennepin County, Minnesota",129,17,73,0,17,0,12,10,129,111,11,73,0,17,0,0,10,18,6,0,0,0,0,12,0
270530027001001,24,Willard - Hay,26,26,1000000US270530027001001,"Block 1001, Block Group 1, Census Tract 27, Hennepin County, Minnesota",70,13,36,0,18,0,0,3,70,70,13,36,0,18,0,0,3,0,0,0,0,0,0,0,0
270531028003012,24,Willard - Hay,26,26,1000000US270531028003012,"Block 3012, Block Group 3, Census Tract 1028, Hennepin County, Minnesota",86,8,40,17,10,0,0,11,86,84,8,40,17,10,0,0,9,2,0,0,0,0,0,0,2
270530027001006,24,Willard - Hay,26,26,1000000US270530027001006,"Block 1006, Block Group 1, Census Tract 27, Hennepin County, Minnesota",53,6,40,0,0,0,0,7,53,53,6,40,0,0,0,0,7,0,0,0,0,0,0,0,0
270531028002014,24,Willard - Hay,26,26,1000000US270531028002014,"Block 2014, Block Group 2, Census Tract 1028, Hennepin County, Minnesota",84,8,57,0,19,0,0,0,84,80,5,56,0,19,0,0,0,4,3,1,0,0,0,0,0
270531028002003,24,Willard - Hay,26,26,1000000US270531028002003,"Block 2003, Block Group 2, Census Tract 1028, Hennepin County, Minnesota",62,9,50,0,0,0,0,3,62,57,9,46,0,0,0,0,2,5,0,4,0,0,0,0,1
270531028002004,24,Willard - Hay,26,26,1000000US270531028002004,"Block 2004, Block Group 2, Census Tract 1028, Hennepin County, Minnesota",84,2,38,2,21,0,20,1,84,63,2,38,1,21,0,0,1,21,0,0,1,0,0,20,0
270530027001011,24,Willard - Hay,26,26,1000000US270530027001011,"Block 1011, Block Group 1, Census Tract 27, Hennepin County, Minnesota",0,0,0,0,0,0,0,0,0,0,0,0,0,0,0,0,0,0,0,0,0,0,0,0,0
270531020003001,24,Willard - Hay,26,26,1000000US270531020003001,"Block 3001, Block Group 3, Census Tract 1020, Hennepin County, Minnesota",0,0,0,0,0,0,0,0,0,0,0,0,0,0,0,0,0,0,0,0,0,0,0,0,0
270531028002000,24,Willard - Hay,26,26,1000000US270531028002000,"Block 2000, Block Group 2, Census Tract 1028, Hennepin County, Minnesota",13,13,0,0,0,0,0,0,13,2,2,0,0,0,0,0,0,11,11,0,0,0,0,0,0
270531020002002,24,Willard - Hay,26,26,1000000US270531020002002,"Block 2002, Block Group 2, Census Tract 1020, Hennepin County, Minnesota",12,6,6,0,0,0,0,0,12,12,6,6,0,0,0,0,0,0,0,0,0,0,0,0,0
270531020002003,24,Willard - Hay,26,26,1000000US270531020002003,"Block 2003, Block Group 2, Census Tract 1020, Hennepin County, Minnesota",68,38,13,2,7,0,0,8,68,65,38,13,2,7,0,0,5,3,0,0,0,0,0,0,3
270531020002008,24,Willard - Hay,26,26,1000000US270531020002008,"Block 2008, Block Group 2, Census Tract 1020, Hennepin County, Minnesota",80,38,33,1,5,0,0,3,80,80,38,33,1,5,0,0,3,0,0,0,0,0,0,0,0
270531020003006,24,Willard - Hay,26,26,1000000US270531020003006,"Block 3006, Block Group 3, Census Tract 1020, Hennepin County, Minnesota",31,7,22,0,1,0,0,1,31,31,7,22,0,1,0,0,1,0,0,0,0,0,0,0,0
270531020002007,24,Willard - Hay,26,26,1000000US270531020002007,"Block 2007, Block Group 2, Census Tract 1020, Hennepin County, Minnesota",44,13,17,1,0,0,1,12,44,39,11,17,1,0,0,1,9,5,2,0,0,0,0,0,3
270531020002010,24,Willard - Hay,26,26,1000000US270531020002010,"Block 2010, Block Group 2, Census Tract 1020, Hennepin County, Minnesota",104,32,52,4,11,0,0,5,104,96,32,44,4,11,0,0,5,8,0,8,0,0,0,0,0
270531020003008,24,Willard - Hay,26,26,1000000US270531020003008,"Block 3008, Block Group 3, Census Tract 1020, Hennepin County, Minnesota",58,26,14,0,10,0,4,4,58,53,26,14,0,10,0,0,3,5,0,0,0,0,0,4,1
270530032001010,24,Willard - Hay,26,26,1000000US270530032001010,"Block 1010, Block Group 1, Census Tract 32, Hennepin County, Minnesota",38,14,19,0,0,0,0,5,38,38,14,19,0,0,0,0,5,0,0,0,0,0,0,0,0
270530032001014,24,Willard - Hay,26,26,1000000US270530032001014,"Block 1014, Block Group 1, Census Tract 32, Hennepin County, Minnesota",28,4,21,0,0,0,1,2,28,26,4,21,0,0,0,0,1,2,0,0,0,0,0,1,1
270530032001020,24,Willard - Hay,26,26,1000000US270530032001020,"Block 1020, Block Group 1, Census Tract 32, Hennepin County, Minnesota",17,9,7,0,0,0,0,1,17,17,9,7,0,0,0,0,1,0,0,0,0,0,0,0,0
270530032001012,24,Willard - Hay,26,26,1000000US270530032001012,"Block 1012, Block Group 1, Census Tract 32, Hennepin County, Minnesota",63,18,41,0,0,0,0,4,63,63,18,41,0,0,0,0,4,0,0,0,0,0,0,0,0
270530032001002,24,Willard - Hay,26,26,1000000US270530032001002,"Block 1002, Block Group 1, Census Tract 32, Hennepin County, Minnesota",58,9,38,0,2,0,3,6,58,55,7,38,0,2,0,2,6,3,2,0,0,0,0,1,0
270530032002002,24,Willard - Hay,26,26,1000000US270530032002002,"Block 2002, Block Group 2, Census Tract 32, Hennepin County, Minnesota",71,7,52,0,8,0,0,4,71,71,7,52,0,8,0,0,4,0,0,0,0,0,0,0,0
270531020001008,24,Willard - Hay,26,26,1000000US270531020001008,"Block 1008, Block Group 1, Census Tract 1020, Hennepin County, Minnesota",93,26,54,0,0,0,3,10,93,89,25,54,0,0,0,0,10,4,1,0,0,0,0,3,0
270530027001002,24,Willard - Hay,26,26,1000000US270530027001002,"Block 1002, Block Group 1, Census Tract 27, Hennepin County, Minnesota",77,12,38,0,19,0,0,8,77,75,12,37,0,19,0,0,7,2,0,1,0,0,0,0,1
270530027002008,24,Willard - Hay,26,26,1000000US270530027002008,"Block 2008, Block Group 2, Census Tract 27, Hennepin County, Minnesota",59,15,25,0,6,0,5,8,59,53,14,25,0,6,0,0,8,6,1,0,0,0,0,5,0
270530027002015,24,Willard - Hay,26,26,1000000US270530027002015,"Block 2015, Block Group 2, Census Tract 27, Hennepin County, Minnesota",60,15,40,1,0,0,0,4,60,60,15,40,1,0,0,0,4,0,0,0,0,0,0,0,0
270530027002010,24,Willard - Hay,26,26,1000000US270530027002010,"Block 2010, Block Group 2, Census Tract 27, Hennepin County, Minnesota",82,12,52,0,10,0,1,7,82,80,12,51,0,10,0,0,7,2,0,1,0,0,0,1,0
270531028003010,24,Willard - Hay,26,26,1000000US270531028003010,"Block 3010, Block Group 3, Census Tract 1028, Hennepin County, Minnesota",77,0,63,1,12,0,0,1,77,77,0,63,1,12,0,0,1,0,0,0,0,0,0,0,0
270531028003006,24,Willard - Hay,26,26,1000000US270531028003006,"Block 3006, Block Group 3, Census Tract 1028, Hennepin County, Minnesota",42,9,16,6,5,0,0,6,42,41,9,15,6,5,0,0,6,1,0,1,0,0,0,0,0
270531028003015,24,Willard - Hay,26,26,1000000US270531028003015,"Block 3015, Block Group 3, Census Tract 1028, Hennepin County, Minnesota",39,3,23,0,7,0,0,6,39,38,3,22,0,7,0,0,6,1,0,1,0,0,0,0,0
270531028002007,24,Willard - Hay,26,26,1000000US270531028002007,"Block 2007, Block Group 2, Census Tract 1028, Hennepin County, Minnesota",0,0,0,0,0,0,0,0,0,0,0,0,0,0,0,0,0,0,0,0,0,0,0,0,0
270531028003008,24,Willard - Hay,26,26,1000000US270531028003008,"Block 3008, Block Group 3, Census Tract 1028, Hennepin County, Minnesota",72,7,43,0,0,0,14,8,72,57,7,42,0,0,0,0,8,15,0,1,0,0,0,14,0
270531020003007,24,Willard - Hay,26,26,1000000US270531020003007,"Block 3007, Block Group 3, Census Tract 1020, Hennepin County, Minnesota",28,4,15,6,3,0,0,0,28,23,4,15,1,3,0,0,0,5,0,0,5,0,0,0,0
270530032001018,24,Willard - Hay,26,26,1000000US270530032001018,"Block 1018, Block Group 1, Census Tract 32, Hennepin County, Minnesota",45,5,32,0,8,0,0,0,45,45,5,32,0,8,0,0,0,0,0,0,0,0,0,0,0
270531028002001,24,Willard - Hay,26,26,1000000US270531028002001,"Block 2001, Block Group 2, Census Tract 1028, Hennepin County, Minnesota",56,12,32,6,2,0,1,3,56,53,11,32,6,2,0,0,2,3,1,0,0,0,0,1,1
270531020003002,24,Willard - Hay,26,26,1000000US270531020003002,"Block 3002, Block Group 3, Census Tract 1020, Hennepin County, Minnesota",0,0,0,0,0,0,0,0,0,0,0,0,0,0,0,0,0,0,0,0,0,0,0,0,0
270531020003004,24,Willard - Hay,26,26,1000000US270531020003004,"Block 3004, Block Group 3, Census Tract 1020, Hennepin County, Minnesota",23,16,3,0,0,0,0,4,23,23,16,3,0,0,0,0,4,0,0,0,0,0,0,0,0
270531020002005,24,Willard - Hay,26,26,1000000US270531020002005,"Block 2005, Block Group 2, Census Tract 1020, Hennepin County, Minnesota",0,0,0,0,0,0,0,0,0,0,0,0,0,0,0,0,0,0,0,0,0,0,0,0,0
270531020002015,24,Willard - Hay,26,26,1000000US270531020002015,"Block 2015, Block Group 2, Census Tract 1020, Hennepin County, Minnesota",10,5,5,0,0,0,0,0,10,10,5,5,0,0,0,0,0,0,0,0,0,0,0,0,0
270531020001004,24,Willard - Hay,26,26,1000000US270531020001004,"Block 1004, Block Group 1, Census Tract 1020, Hennepin County, Minnesota",69,22,28,0,7,0,0,12,69,67,22,28,0,7,0,0,10,2,0,0,0,0,0,0,2
270531020002000,24,Willard - Hay,26,26,1000000US270531020002000,"Block 2000, Block Group 2, Census Tract 1020, Hennepin County, Minnesota",68,47,8,0,0,0,0,13,68,63,42,8,0,0,0,0,13,5,5,0,0,0,0,0,0
270531020002004,24,Willard - Hay,26,26,1000000US270531020002004,"Block 2004, Block Group 2, Census Tract 1020, Hennepin County, Minnesota",0,0,0,0,0,0,0,0,0,0,0,0,0,0,0,0,0,0,0,0,0,0,0,0,0
270531020002014,24,Willard - Hay,26,26,1000000US270531020002014,"Block 2014, Block Group 2, Census Tract 1020, Hennepin County, Minnesota",99,12,46,1,32,0,0,8,99,99,12,46,1,32,0,0,8,0,0,0,0,0,0,0,0
270531020003009,24,Willard - Hay,26,26,1000000US270531020003009,"Block 3009, Block Group 3, Census Tract 1020, Hennepin County, Minnesota",74,35,23,0,0,0,5,11,74,63,29,23,0,0,0,0,11,11,6,0,0,0,0,5,0
270531020001010,24,Willard - Hay,26,26,1000000US270531020001010,"Block 1010, Block Group 1, Census Tract 1020, Hennepin County, Minnesota",29,3,13,0,0,0,8,5,29,21,3,13,0,0,0,0,5,8,0,0,0,0,0,8,0
270531020002012,24,Willard - Hay,26,26,1000000US270531020002012,"Block 2012, Block Group 2, Census Tract 1020, Hennepin County, Minnesota",30,4,19,1,0,0,0,6,30,26,2,19,0,0,0,0,5,4,2,0,1,0,0,0,1
270531020001000,24,Willard - Hay,26,26,1000000US270531020001000,"Block 1000, Block Group 1, Census Tract 1020, Hennepin County, Minnesota",6,0,6,0,0,0,0,0,6,6,0,6,0,0,0,0,0,0,0,0,0,0,0,0,0
270531020001014,24,Willard - Hay,26,26,1000000US270531020001014,"Block 1014, Block Group 1, Census Tract 1020, Hennepin County, Minnesota",45,20,19,1,0,0,0,5,45,33,11,19,0,0,0,0,3,12,9,0,1,0,0,0,2
270530027002000,24,Willard - Hay,26,26,1000000US270530027002000,"Block 2000, Block Group 2, Census Tract 27, Hennepin County, Minnesota",115,5,71,0,34,0,0,5,115,113,4,71,0,34,0,0,4,2,1,0,0,0,0,0,1
270531020002011,24,Willard - Hay,26,26,1000000US270531020002011,"Block 2011, Block Group 2, Census Tract 1020, Hennepin County, Minnesota",88,19,49,0,15,0,5,0,88,75,13,47,0,15,0,0,0,13,6,2,0,0,0,5,0
270530027002012,24,Willard - Hay,26,26,1000000US270530027002012,"Block 2012, Block Group 2, Census Tract 27, Hennepin County, Minnesota",74,23,37,0,9,0,1,4,74,70,23,37,0,9,0,0,1,4,0,0,0,0,0,1,3
270530027001007,24,Willard - Hay,26,26,1000000US270530027001007,"Block 1007, Block Group 1, Census Tract 27, Hennepin County, Minnesota",91,5,64,5,16,0,1,0,91,90,5,63,5,16,0,1,0,1,0,1,0,0,0,0,0
270530027001005,24,Willard - Hay,26,26,1000000US270530027001005,"Block 1005, Block Group 1, Census Tract 27, Hennepin County, Minnesota",115,15,74,0,15,0,10,1,115,99,9,74,0,15,0,0,1,16,6,0,0,0,0,10,0
270530027001014,24,Willard - Hay,26,26,1000000US270530027001014,"Block 1014, Block Group 1, Census Tract 27, Hennepin County, Minnesota",98,9,58,0,26,0,0,5,98,96,9,56,0,26,0,0,5,2,0,2,0,0,0,0,0
270530032001008,24,Willard - Hay,26,26,1000000US270530032001008,"Block 1008, Block Group 1, Census Tract 32, Hennepin County, Minnesota",17,7,9,0,0,0,1,0,17,16,7,9,0,0,0,0,0,1,0,0,0,0,0,1,0
270530032002012,24,Willard - Hay,26,26,1000000US270530032002012,"Block 2012, Block Group 2, Census Tract 32, Hennepin County, Minnesota",18,5,10,0,2,0,1,0,18,17,5,10,0,2,0,0,0,1,0,0,0,0,0,1,0
270530032001015,24,Willard - Hay,26,26,1000000US270530032001015,"Block 1015, Block Group 1, Census Tract 32, Hennepin County, Minnesota",37,9,28,0,0,0,0,0,37,37,9,28,0,0,0,0,0,0,0,0,0,0,0,0,0
270531020003000,24,Willard - Hay,26,26,1000000US270531020003000,"Block 3000, Block Group 3, Census Tract 1020, Hennepin County, Minnesota",0,0,0,0,0,0,0,0,0,0,0,0,0,0,0,0,0,0,0,0,0,0,0,0,0
270531020003005,24,Willard - Hay,26,26,1000000US270531020003005,"Block 3005, Block Group 3, Census Tract 1020, Hennepin County, Minnesota",23,15,8,0,0,0,0,0,23,23,15,8,0,0,0,0,0,0,0,0,0,0,0,0,0
270530027002003,24,Willard - Hay,26,26,1000000US270530027002003,"Block 2003, Block Group 2, Census Tract 27, Hennepin County, Minnesota",68,22,33,0,0,0,7,6,68,59,20,33,0,0,0,0,6,9,2,0,0,0,0,7,0
270531020003013,24,Willard - Hay,26,26,1000000US270531020003013,"Block 3013, Block Group 3, Census Tract 1020, Hennepin County, Minnesota",85,22,53,1,1,0,0,8,85,84,22,52,1,1,0,0,8,1,0,1,0,0,0,0,0
270531020003012,24,Willard - Hay,26,26,1000000US270531020003012,"Block 3012, Block Group 3, Census Tract 1020, Hennepin County, Minnesota",61,12,39,0,0,0,4,6,61,56,12,38,0,0,0,0,6,5,0,1,0,0,0,4,0
270531020002009,24,Willard - Hay,26,26,1000000US270531020002009,"Block 2009, Block Group 2, Census Tract 1020, Hennepin County, Minnesota",70,28,29,0,1,0,9,3,70,61,28,29,0,1,0,0,3,9,0,0,0,0,0,9,0
270531020002013,24,Willard - Hay,26,26,1000000US270531020002013,"Block 2013, Block Group 2, Census Tract 1020, Hennepin County, Minnesota",0,0,0,0,0,0,0,0,0,0,0,0,0,0,0,0,0,0,0,0,0,0,0,0,0
270531020001001,24,Willard - Hay,26,26,1000000US270531020001001,"Block 1001, Block Group 1, Census Tract 1020, Hennepin County, Minnesota",30,5,22,0,2,0,0,1,30,27,4,20,0,2,0,0,1,3,1,2,0,0,0,0,0
270531020003003,24,Willard - Hay,26,26,1000000US270531020003003,"Block 3003, Block Group 3, Census Tract 1020, Hennepin County, Minnesota",0,0,0,0,0,0,0,0,0,0,0,0,0,0,0,0,0,0,0,0,0,0,0,0,0
270530027002011,24,Willard - Hay,26,26,1000000US270530027002011,"Block 2011, Block Group 2, Census Tract 27, Hennepin County, Minnesota",96,8,50,0,19,0,3,16,96,91,7,49,0,19,0,0,16,5,1,1,0,0,0,3,0
270530027002002,24,Willard - Hay,26,26,1000000US270530027002002,"Block 2002, Block Group 2, Census Tract 27, Hennepin County, Minnesota",74,29,24,0,10,0,3,8,74,68,23,24,0,10,0,3,8,6,6,0,0,0,0,0,0
270530032002013,24,Willard - Hay,26,26,1000000US270530032002013,"Block 2013, Block Group 2, Census Tract 32, Hennepin County, Minnesota",86,11,50,6,10,0,6,3,86,78,11,50,6,10,0,0,1,8,0,0,0,0,0,6,2
270530032002001,24,Willard - Hay,26,26,1000000US270530032002001,"Block 2001, Block Group 2, Census Tract 32, Hennepin County, Minnesota",118,16,71,5,2,0,15,9,118,89,13,67,0,2,0,0,7,29,3,4,5,0,0,15,2
270531020001003,24,Willard - Hay,26,26,1000000US270531020001003,"Block 1003, Block Group 1, Census Tract 1020, Hennepin County, Minnesota",51,9,14,0,22,0,0,6,51,50,8,14,0,22,0,0,6,1,1,0,0,0,0,0,0
270531020003015,24,Willard - Hay,26,26,1000000US270531020003015,"Block 3015, Block Group 3, Census Tract 1020, Hennepin County, Minnesota",84,30,45,0,7,0,1,1,84,79,30,40,0,7,0,1,1,5,0,5,0,0,0,0,0
270531020003011,24,Willard - Hay,26,26,1000000US270531020003011,"Block 3011, Block Group 3, Census Tract 1020, Hennepin County, Minnesota",34,7,11,0,5,0,0,11,34,28,7,11,0,5,0,0,5,6,0,0,0,0,0,0,6
270531020001005,24,Willard - Hay,26,26,1000000US270531020001005,"Block 1005, Block Group 1, Census Tract 1020, Hennepin County, Minnesota",0,0,0,0,0,0,0,0,0,0,0,0,0,0,0,0,0,0,0,0,0,0,0,0,0
270530027001003,24,Willard - Hay,26,26,1000000US270530027001003,"Block 1003, Block Group 1, Census Tract 27, Hennepin County, Minnesota",144,11,105,9,7,0,1,11,144,136,9,105,9,7,0,0,6,8,2,0,0,0,0,1,5
270530027002005,24,Willard - Hay,26,26,1000000US270530027002005,"Block 2005, Block Group 2, Census Tract 27, Hennepin County, Minnesota",81,8,51,2,20,0,0,0,81,75,8,45,2,20,0,0,0,6,0,6,0,0,0,0,0
270530027001008,24,Willard - Hay,26,26,1000000US270530027001008,"Block 1008, Block Group 1, Census Tract 27, Hennepin County, Minnesota",76,22,51,0,0,0,0,3,76,75,21,51,0,0,0,0,3,1,1,0,0,0,0,0,0
270530032002015,24,Willard - Hay,26,26,1000000US270530032002015,"Block 2015, Block Group 2, Census Tract 32, Hennepin County, Minnesota",0,0,0,0,0,0,0,0,0,0,0,0,0,0,0,0,0,0,0,0,0,0,0,0,0
270530032002014,24,Willard - Hay,26,26,1000000US270530032002014,"Block 2014, Block Group 2, Census Tract 32, Hennepin County, Minnesota",0,0,0,0,0,0,0,0,0,0,0,0,0,0,0,0,0,0,0,0,0,0,0,0,0
270530032001017,24,Willard - Hay,26,26,1000000US270530032001017,"Block 1017, Block Group 1, Census Tract 32, Hennepin County, Minnesota",53,19,25,3,0,0,6,0,53,47,19,25,3,0,0,0,0,6,0,0,0,0,0,6,0
270530032001001,24,Willard - Hay,26,26,1000000US270530032001001,"Block 1001, Block Group 1, Census Tract 32, Hennepin County, Minnesota",72,9,36,0,16,0,8,3,72,60,5,36,0,16,0,0,3,12,4,0,0,0,0,8,0
270530032002003,24,Willard - Hay,26,26,1000000US270530032002003,"Block 2003, Block Group 2, Census Tract 32, Hennepin County, Minnesota",75,6,54,7,0,0,1,7,75,70,4,54,6,0,0,0,6,5,2,0,1,0,0,1,1
270530027001004,24,Willard - Hay,26,26,1000000US270530027001004,"Block 1004, Block Group 1, Census Tract 27, Hennepin County, Minnesota",112,14,78,3,2,0,12,3,112,92,9,75,3,2,0,0,3,20,5,3,0,0,0,12,0
270530027002009,24,Willard - Hay,26,26,1000000US270530027002009,"Block 2009, Block Group 2, Census Tract 27, Hennepin County, Minnesota",55,16,26,0,0,0,7,6,55,47,15,26,0,0,0,0,6,8,1,0,0,0,0,7,0
270530027002013,24,Willard - Hay,26,26,1000000US270530027002013,"Block 2013, Block Group 2, Census Tract 27, Hennepin County, Minnesota",98,15,61,0,2,0,12,8,98,83,13,59,0,2,0,1,8,15,2,2,0,0,0,11,0
270531020001007,24,Willard - Hay,26,26,1000000US270531020001007,"Block 1007, Block Group 1, Census Tract 1020, Hennepin County, Minnesota",0,0,0,0,0,0,0,0,0,0,0,0,0,0,0,0,0,0,0,0,0,0,0,0,0
270531020001009,24,Willard - Hay,26,26,1000000US270531020001009,"Block 1009, Block Group 1, Census Tract 1020, Hennepin County, Minnesota",81,25,30,0,15,0,0,11,81,73,20,30,0,15,0,0,8,8,5,0,0,0,0,0,3
270531020001015,24,Willard - Hay,26,26,1000000US270531020001015,"Block 1015, Block Group 1, Census Tract 1020, Hennepin County, Minnesota",82,9,46,1,8,0,9,9,82,69,5,46,1,8,0,0,9,13,4,0,0,0,0,9,0
270531020002006,24,Willard - Hay,26,26,1000000US270531020002006,"Block 2006, Block Group 2, Census Tract 1020, Hennepin County, Minnesota",0,0,0,0,0,0,0,0,0,0,0,0,0,0,0,0,0,0,0,0,0,0,0,0,0
270531028003013,24,Willard - Hay,26,26,1000000US270531028003013,"Block 3013, Block Group 3, Census Tract 1028, Hennepin County, Minnesota",50,3,31,0,15,0,0,1,50,50,3,31,0,15,0,0,1,0,0,0,0,0,0,0,0
270531028002010,24,Willard - Hay,26,26,1000000US270531028002010,"Block 2010, Block Group 2, Census Tract 1028, Hennepin County, Minnesota",53,13,39,1,0,0,0,0,53,50,10,39,1,0,0,0,0,3,3,0,0,0,0,0,0
270531020001011,24,Willard - Hay,26,26,1000000US270531020001011,"Block 1011, Block Group 1, Census Tract 1020, Hennepin County, Minnesota",55,16,29,0,2,0,0,8,55,55,16,29,0,2,0,0,8,0,0,0,0,0,0,0,0
270531028002012,24,Willard - Hay,26,26,1000000US270531028002012,"Block 2012, Block Group 2, Census Tract 1028, Hennepin County, Minnesota",54,25,24,1,0,0,0,4,54,54,25,24,1,0,0,0,4,0,0,0,0,0,0,0,0
270531020001016,24,Willard - Hay,26,26,1000000US270531020001016,"Block 1016, Block Group 1, Census Tract 1020, Hennepin County, Minnesota",107,12,59,0,23,0,9,4,107,91,12,54,0,23,0,0,2,16,0,5,0,0,0,9,2
270530032001000,24,Willard - Hay,26,26,1000000US270530032001000,"Block 1000, Block Group 1, Census Tract 32, Hennepin County, Minnesota",64,12,33,1,15,0,0,3,64,64,12,33,1,15,0,0,3,0,0,0,0,0,0,0,0
270531028003000,24,Willard - Hay,26,26,1000000US270531028003000,"Block 3000, Block Group 3, Census Tract 1028, Hennepin County, Minnesota",59,4,32,0,10,11,0,2,59,59,4,32,0,10,11,0,2,0,0,0,0,0,0,0,0
270531028003009,24,Willard - Hay,26,26,1000000US270531028003009,"Block 3009, Block Group 3, Census Tract 1028, Hennepin County, Minnesota",55,4,28,0,15,0,1,7,55,49,4,24,0,15,0,0,6,6,0,4,0,0,0,1,1
270531020002001,24,Willard - Hay,26,26,1000000US270531020002001,"Block 2001, Block Group 2, Census Tract 1020, Hennepin County, Minnesota",0,0,0,0,0,0,0,0,0,0,0,0,0,0,0,0,0,0,0,0,0,0,0,0,0
270531028002005,24,Willard - Hay,26,26,1000000US270531028002005,"Block 2005, Block Group 2, Census Tract 1028, Hennepin County, Minnesota",90,3,39,0,43,0,5,0,90,84,3,39,0,42,0,0,0,6,0,0,0,1,0,5,0
270531020001006,24,Willard - Hay,26,26,1000000US270531020001006,"Block 1006, Block Group 1, Census Tract 1020, Hennepin County, Minnesota",12,2,10,0,0,0,0,0,12,8,2,6,0,0,0,0,0,4,0,4,0,0,0,0,0
270531020003014,24,Willard - Hay,26,26,1000000US270531020003014,"Block 3014, Block Group 3, Census Tract 1020, Hennepin County, Minnesota",55,8,37,0,10,0,0,0,55,55,8,37,0,10,0,0,0,0,0,0,0,0,0,0,0
270530027002001,24,Willard - Hay,26,26,1000000US270530027002001,"Block 2001, Block Group 2, Census Tract 27, Hennepin County, Minnesota",116,17,92,1,4,0,1,1,116,114,17,91,1,4,0,0,1,2,0,1,0,0,0,1,0
270531020001013,24,Willard - Hay,26,26,1000000US270531020001013,"Block 1013, Block Group 1, Census Tract 1020, Hennepin County, Minnesota",97,19,62,2,6,0,0,8,97,95,19,62,2,6,0,0,6,2,0,0,0,0,0,0,2
270530027002004,24,Willard - Hay,26,26,1000000US270530027002004,"Block 2004, Block Group 2, Census Tract 27, Hennepin County, Minnesota",82,11,61,0,0,0,10,0,82,68,8,60,0,0,0,0,0,14,3,1,0,0,0,10,0
270530032001004,24,Willard - Hay,26,26,1000000US270530032001004,"Block 1004, Block Group 1, Census Tract 32, Hennepin County, Minnesota",47,14,30,0,0,0,0,3,47,46,14,29,0,0,0,0,3,1,0,1,0,0,0,0,0
270530032001003,24,Willard - Hay,26,26,1000000US270530032001003,"Block 1003, Block Group 1, Census Tract 32, Hennepin County, Minnesota",102,9,83,0,5,0,0,5,102,97,8,80,0,5,0,0,4,5,1,3,0,0,0,0,1
270530032002005,24,Willard - Hay,26,26,1000000US270530032002005,"Block 2005, Block Group 2, Census Tract 32, Hennepin County, Minnesota",87,9,58,0,15,0,0,5,87,87,9,58,0,15,0,0,5,0,0,0,0,0,0,0,0
270530032002004,24,Willard - Hay,26,26,1000000US270530032002004,"Block 2004, Block Group 2, Census Tract 32, Hennepin County, Minnesota",89,8,49,2,23,0,0,7,89,89,8,49,2,23,0,0,7,0,0,0,0,0,0,0,0
270530027001012,24,Willard - Hay,26,26,1000000US270530027001012,"Block 1012, Block Group 1, Census Tract 27, Hennepin County, Minnesota",88,8,56,1,17,0,0,6,88,87,7,56,1,17,0,0,6,1,1,0,0,0,0,0,0
270530032002008,24,Willard - Hay,26,26,1000000US270530032002008,"Block 2008, Block Group 2, Census Tract 32, Hennepin County, Minnesota",43,8,34,0,0,0,0,1,43,43,8,34,0,0,0,0,1,0,0,0,0,0,0,0,0
270531023002012,25,Near - North,27,27,1000000US270531023002012,"Block 2012, Block Group 2, Census Tract 1023, Hennepin County, Minnesota",0,0,0,0,0,0,0,0,0,0,0,0,0,0,0,0,0,0,0,0,0,0,0,0,0
270531034001014,25,Near - North,27,27,1000000US270531034001014,"Block 1014, Block Group 1, Census Tract 1034, Hennepin County, Minnesota",0,0,0,0,0,0,0,0,0,0,0,0,0,0,0,0,0,0,0,0,0,0,0,0,0
270531023002016,25,Near - North,27,27,1000000US270531023002016,"Block 2016, Block Group 2, Census Tract 1023, Hennepin County, Minnesota",8,3,3,0,2,0,0,0,8,8,3,3,0,2,0,0,0,0,0,0,0,0,0,0,0
270531023002003,25,Near - North,27,27,1000000US270531023002003,"Block 2003, Block Group 2, Census Tract 1023, Hennepin County, Minnesota",0,0,0,0,0,0,0,0,0,0,0,0,0,0,0,0,0,0,0,0,0,0,0,0,0
270530033002010,25,Near - North,27,27,1000000US270530033002010,"Block 2010, Block Group 2, Census Tract 33, Hennepin County, Minnesota",84,3,65,0,11,0,0,5,84,83,3,64,0,11,0,0,5,1,0,1,0,0,0,0,0
270530033002003,25,Near - North,27,27,1000000US270530033002003,"Block 2003, Block Group 2, Census Tract 33, Hennepin County, Minnesota",92,3,72,1,11,0,0,5,92,88,3,68,1,11,0,0,5,4,0,4,0,0,0,0,0
270531028001004,25,Near - North,27,27,1000000US270531028001004,"Block 1004, Block Group 1, Census Tract 1028, Hennepin County, Minnesota",42,16,19,3,1,0,0,3,42,42,16,19,3,1,0,0,3,0,0,0,0,0,0,0,0
270531028001011,25,Near - North,27,27,1000000US270531028001011,"Block 1011, Block Group 1, Census Tract 1028, Hennepin County, Minnesota",88,12,49,0,18,0,0,9,88,84,12,49,0,18,0,0,5,4,0,0,0,0,0,0,4
270531028001010,25,Near - North,27,27,1000000US270531028001010,"Block 1010, Block Group 1, Census Tract 1028, Hennepin County, Minnesota",119,13,78,11,0,0,3,14,119,119,13,78,11,0,0,3,14,0,0,0,0,0,0,0,0
270530033001004,25,Near - North,27,27,1000000US270530033001004,"Block 1004, Block Group 1, Census Tract 33, Hennepin County, Minnesota",102,11,67,0,10,0,6,8,102,92,11,65,0,10,0,0,6,10,0,2,0,0,0,6,2
270530033001002,25,Near - North,27,27,1000000US270530033001002,"Block 1002, Block Group 1, Census Tract 33, Hennepin County, Minnesota",99,4,79,0,14,0,0,2,99,98,3,79,0,14,0,0,2,1,1,0,0,0,0,0,0
270530033001006,25,Near - North,27,27,1000000US270530033001006,"Block 1006, Block Group 1, Census Tract 33, Hennepin County, Minnesota",61,14,28,3,11,0,0,5,61,47,0,28,3,11,0,0,5,14,14,0,0,0,0,0,0
270531023002018,25,Near - North,27,27,1000000US270531023002018,"Block 2018, Block Group 2, Census Tract 1023, Hennepin County, Minnesota",0,0,0,0,0,0,0,0,0,0,0,0,0,0,0,0,0,0,0,0,0,0,0,0,0
270531028001001,25,Near - North,27,27,1000000US270531028001001,"Block 1001, Block Group 1, Census Tract 1028, Hennepin County, Minnesota",96,24,50,4,0,0,6,12,96,92,24,47,4,0,0,5,12,4,0,3,0,0,0,1,0
270531029001004,25,Near - North,27,27,1000000US270531029001004,"Block 1004, Block Group 1, Census Tract 1029, Hennepin County, Minnesota",0,0,0,0,0,0,0,0,0,0,0,0,0,0,0,0,0,0,0,0,0,0,0,0,0
270531028001007,25,Near - North,27,27,1000000US270531028001007,"Block 1007, Block Group 1, Census Tract 1028, Hennepin County, Minnesota",0,0,0,0,0,0,0,0,0,0,0,0,0,0,0,0,0,0,0,0,0,0,0,0,0
270530033001005,25,Near - North,27,27,1000000US270530033001005,"Block 1005, Block Group 1, Census Tract 33, Hennepin County, Minnesota",72,9,29,1,15,0,11,7,72,63,9,29,1,15,0,2,7,9,0,0,0,0,0,9,0
270530033001007,25,Near - North,27,27,1000000US270530033001007,"Block 1007, Block Group 1, Census Tract 33, Hennepin County, Minnesota",74,5,45,3,10,0,6,5,74,63,1,44,3,10,0,0,5,11,4,1,0,0,0,6,0
270530033001001,25,Near - North,27,27,1000000US270530033001001,"Block 1001, Block Group 1, Census Tract 33, Hennepin County, Minnesota",107,17,25,0,42,0,8,15,107,97,16,25,0,41,0,0,15,10,1,0,0,1,0,8,0
270530033002013,25,Near - North,27,27,1000000US270530033002013,"Block 2013, Block Group 2, Census Tract 33, Hennepin County, Minnesota",0,0,0,0,0,0,0,0,0,0,0,0,0,0,0,0,0,0,0,0,0,0,0,0,0
270531028001003,25,Near - North,27,27,1000000US270531028001003,"Block 1003, Block Group 1, Census Tract 1028, Hennepin County, Minnesota",48,23,18,1,0,0,0,6,48,48,23,18,1,0,0,0,6,0,0,0,0,0,0,0,0
270530033002004,25,Near - North,27,27,1000000US270530033002004,"Block 2004, Block Group 2, Census Tract 33, Hennepin County, Minnesota",88,1,58,7,0,0,14,8,88,69,1,58,2,0,0,0,8,19,0,0,5,0,0,14,0
270530033002006,25,Near - North,27,27,1000000US270530033002006,"Block 2006, Block Group 2, Census Tract 33, Hennepin County, Minnesota",42,0,7,0,24,0,11,0,42,31,0,7,0,24,0,0,0,11,0,0,0,0,0,11,0
270530033001008,25,Near - North,27,27,1000000US270530033001008,"Block 1008, Block Group 1, Census Tract 33, Hennepin County, Minnesota",54,5,36,0,0,0,0,13,54,51,2,36,0,0,0,0,13,3,3,0,0,0,0,0,0
270530033002008,25,Near - North,27,27,1000000US270530033002008,"Block 2008, Block Group 2, Census Tract 33, Hennepin County, Minnesota",84,7,48,0,24,0,2,3,84,82,7,48,0,24,0,0,3,2,0,0,0,0,0,2,0
270530033002007,25,Near - North,27,27,1000000US270530033002007,"Block 2007, Block Group 2, Census Tract 33, Hennepin County, Minnesota",101,15,50,0,29,0,0,7,101,101,15,50,0,29,0,0,7,0,0,0,0,0,0,0,0
270530033002014,25,Near - North,27,27,1000000US270530033002014,"Block 2014, Block Group 2, Census Tract 33, Hennepin County, Minnesota",53,9,30,0,12,0,2,0,53,49,7,30,0,12,0,0,0,4,2,0,0,0,0,2,0
270530033002017,25,Near - North,27,27,1000000US270530033002017,"Block 2017, Block Group 2, Census Tract 33, Hennepin County, Minnesota",10,5,1,0,0,0,0,4,10,6,2,1,0,0,0,0,3,4,3,0,0,0,0,0,1
270530033001003,25,Near - North,27,27,1000000US270530033001003,"Block 1003, Block Group 1, Census Tract 33, Hennepin County, Minnesota",138,7,83,1,37,0,8,2,138,128,7,83,0,37,0,0,1,10,0,0,1,0,0,8,1
270531034001004,25,Near - North,27,27,1000000US270531034001004,"Block 1004, Block Group 1, Census Tract 1034, Hennepin County, Minnesota",0,0,0,0,0,0,0,0,0,0,0,0,0,0,0,0,0,0,0,0,0,0,0,0,0
270530033002012,25,Near - North,27,27,1000000US270530033002012,"Block 2012, Block Group 2, Census Tract 33, Hennepin County, Minnesota",0,0,0,0,0,0,0,0,0,0,0,0,0,0,0,0,0,0,0,0,0,0,0,0,0
270530033002016,25,Near - North,27,27,1000000US270530033002016,"Block 2016, Block Group 2, Census Tract 33, Hennepin County, Minnesota",26,4,20,0,0,0,0,2,26,26,4,20,0,0,0,0,2,0,0,0,0,0,0,0,0
270530033001010,25,Near - North,27,27,1000000US270530033001010,"Block 1010, Block Group 1, Census Tract 33, Hennepin County, Minnesota",29,6,22,0,0,0,1,0,29,27,6,20,0,0,0,1,0,2,0,2,0,0,0,0,0
270530033002015,25,Near - North,27,27,1000000US270530033002015,"Block 2015, Block Group 2, Census Tract 33, Hennepin County, Minnesota",50,5,15,0,26,0,0,4,50,50,5,15,0,26,0,0,4,0,0,0,0,0,0,0,0
270531029001020,25,Near - North,27,27,1000000US270531029001020,"Block 1020, Block Group 1, Census Tract 1029, Hennepin County, Minnesota",49,22,11,1,11,0,2,2,49,49,22,11,1,11,0,2,2,0,0,0,0,0,0,0,0
270531029001017,25,Near - North,27,27,1000000US270531029001017,"Block 1017, Block Group 1, Census Tract 1029, Hennepin County, Minnesota",67,16,42,0,7,0,0,2,67,67,16,42,0,7,0,0,2,0,0,0,0,0,0,0,0
270531029001005,25,Near - North,27,27,1000000US270531029001005,"Block 1005, Block Group 1, Census Tract 1029, Hennepin County, Minnesota",0,0,0,0,0,0,0,0,0,0,0,0,0,0,0,0,0,0,0,0,0,0,0,0,0
270531029001001,25,Near - North,27,27,1000000US270531029001001,"Block 1001, Block Group 1, Census Tract 1029, Hennepin County, Minnesota",20,3,7,10,0,0,0,0,20,20,3,7,10,0,0,0,0,0,0,0,0,0,0,0,0
270531029001023,25,Near - North,27,27,1000000US270531029001023,"Block 1023, Block Group 1, Census Tract 1029, Hennepin County, Minnesota",30,13,3,0,9,0,0,5,30,26,13,1,0,9,0,0,3,4,0,2,0,0,0,0,2
270531029001019,25,Near - North,27,27,1000000US270531029001019,"Block 1019, Block Group 1, Census Tract 1029, Hennepin County, Minnesota",48,20,28,0,0,0,0,0,48,48,20,28,0,0,0,0,0,0,0,0,0,0,0,0,0
270531029001018,25,Near - North,27,27,1000000US270531029001018,"Block 1018, Block Group 1, Census Tract 1029, Hennepin County, Minnesota",34,18,15,0,0,0,0,1,34,34,18,15,0,0,0,0,1,0,0,0,0,0,0,0,0
270531034001002,25,Near - North,27,27,1000000US270531034001002,"Block 1002, Block Group 1, Census Tract 1034, Hennepin County, Minnesota",0,0,0,0,0,0,0,0,0,0,0,0,0,0,0,0,0,0,0,0,0,0,0,0,0
270531029001008,25,Near - North,27,27,1000000US270531029001008,"Block 1008, Block Group 1, Census Tract 1029, Hennepin County, Minnesota",0,0,0,0,0,0,0,0,0,0,0,0,0,0,0,0,0,0,0,0,0,0,0,0,0
270531023002019,25,Near - North,27,27,1000000US270531023002019,"Block 2019, Block Group 2, Census Tract 1023, Hennepin County, Minnesota",0,0,0,0,0,0,0,0,0,0,0,0,0,0,0,0,0,0,0,0,0,0,0,0,0
270531023002025,25,Near - North,27,27,1000000US270531023002025,"Block 2025, Block Group 2, Census Tract 1023, Hennepin County, Minnesota",0,0,0,0,0,0,0,0,0,0,0,0,0,0,0,0,0,0,0,0,0,0,0,0,0
270531023002007,25,Near - North,27,27,1000000US270531023002007,"Block 2007, Block Group 2, Census Tract 1023, Hennepin County, Minnesota",0,0,0,0,0,0,0,0,0,0,0,0,0,0,0,0,0,0,0,0,0,0,0,0,0
270531028001002,25,Near - North,27,27,1000000US270531028001002,"Block 1002, Block Group 1, Census Tract 1028, Hennepin County, Minnesota",109,41,43,0,17,0,0,8,109,109,41,43,0,17,0,0,8,0,0,0,0,0,0,0,0
270531028001005,25,Near - North,27,27,1000000US270531028001005,"Block 1005, Block Group 1, Census Tract 1028, Hennepin County, Minnesota",91,31,52,0,2,0,0,6,91,89,30,51,0,2,0,0,6,2,1,1,0,0,0,0,0
270530033001011,25,Near - North,27,27,1000000US270530033001011,"Block 1011, Block Group 1, Census Tract 33, Hennepin County, Minnesota",0,0,0,0,0,0,0,0,0,0,0,0,0,0,0,0,0,0,0,0,0,0,0,0,0
270531034001006,25,Near - North,27,27,1000000US270531034001006,"Block 1006, Block Group 1, Census Tract 1034, Hennepin County, Minnesota",414,172,38,0,9,0,169,26,414,56,12,34,0,9,0,0,1,358,160,4,0,0,0,169,25
270531029001011,25,Near - North,27,27,1000000US270531029001011,"Block 1011, Block Group 1, Census Tract 1029, Hennepin County, Minnesota",0,0,0,0,0,0,0,0,0,0,0,0,0,0,0,0,0,0,0,0,0,0,0,0,0
270531029001014,25,Near - North,27,27,1000000US270531029001014,"Block 1014, Block Group 1, Census Tract 1029, Hennepin County, Minnesota",70,12,20,0,38,0,0,0,70,70,12,20,0,38,0,0,0,0,0,0,0,0,0,0,0
270531029001006,25,Near - North,27,27,1000000US270531029001006,"Block 1006, Block Group 1, Census Tract 1029, Hennepin County, Minnesota",43,3,25,0,8,0,0,7,43,43,3,25,0,8,0,0,7,0,0,0,0,0,0,0,0
270531029001002,25,Near - North,27,27,1000000US270531029001002,"Block 1002, Block Group 1, Census Tract 1029, Hennepin County, Minnesota",21,4,5,0,0,0,12,0,21,5,0,5,0,0,0,0,0,16,4,0,0,0,0,12,0
270531029001027,25,Near - North,27,27,1000000US270531029001027,"Block 1027, Block Group 1, Census Tract 1029, Hennepin County, Minnesota",36,8,27,0,0,0,0,1,36,35,7,27,0,0,0,0,1,1,1,0,0,0,0,0,0
270531029001028,25,Near - North,27,27,1000000US270531029001028,"Block 1028, Block Group 1, Census Tract 1029, Hennepin County, Minnesota",43,3,9,0,19,0,12,0,43,31,3,9,0,19,0,0,0,12,0,0,0,0,0,12,0
270531034001001,25,Near - North,27,27,1000000US270531034001001,"Block 1001, Block Group 1, Census Tract 1034, Hennepin County, Minnesota",0,0,0,0,0,0,0,0,0,0,0,0,0,0,0,0,0,0,0,0,0,0,0,0,0
270531029001007,25,Near - North,27,27,1000000US270531029001007,"Block 1007, Block Group 1, Census Tract 1029, Hennepin County, Minnesota",26,1,18,0,7,0,0,0,26,24,0,17,0,7,0,0,0,2,1,1,0,0,0,0,0
270531023002022,25,Near - North,27,27,1000000US270531023002022,"Block 2022, Block Group 2, Census Tract 1023, Hennepin County, Minnesota",0,0,0,0,0,0,0,0,0,0,0,0,0,0,0,0,0,0,0,0,0,0,0,0,0
270531034001013,25,Near - North,27,27,1000000US270531034001013,"Block 1013, Block Group 1, Census Tract 1034, Hennepin County, Minnesota",19,0,18,0,1,0,0,0,19,19,0,18,0,1,0,0,0,0,0,0,0,0,0,0,0
270531029001021,25,Near - North,27,27,1000000US270531029001021,"Block 1021, Block Group 1, Census Tract 1029, Hennepin County, Minnesota",58,27,24,1,0,0,5,1,58,51,25,24,1,0,0,0,1,7,2,0,0,0,0,5,0
270531029001022,25,Near - North,27,27,1000000US270531029001022,"Block 1022, Block Group 1, Census Tract 1029, Hennepin County, Minnesota",43,15,23,0,1,0,0,4,43,36,12,23,0,1,0,0,0,7,3,0,0,0,0,0,4
270531029001025,25,Near - North,27,27,1000000US270531029001025,"Block 1025, Block Group 1, Census Tract 1029, Hennepin County, Minnesota",73,26,33,0,14,0,0,0,73,66,19,33,0,14,0,0,0,7,7,0,0,0,0,0,0
270531034001007,25,Near - North,27,27,1000000US270531034001007,"Block 1007, Block Group 1, Census Tract 1034, Hennepin County, Minnesota",0,0,0,0,0,0,0,0,0,0,0,0,0,0,0,0,0,0,0,0,0,0,0,0,0
270531023002011,25,Near - North,27,27,1000000US270531023002011,"Block 2011, Block Group 2, Census Tract 1023, Hennepin County, Minnesota",2,2,0,0,0,0,0,0,2,2,2,0,0,0,0,0,0,0,0,0,0,0,0,0,0
270531023002004,25,Near - North,27,27,1000000US270531023002004,"Block 2004, Block Group 2, Census Tract 1023, Hennepin County, Minnesota",0,0,0,0,0,0,0,0,0,0,0,0,0,0,0,0,0,0,0,0,0,0,0,0,0
270531023002023,25,Near - North,27,27,1000000US270531023002023,"Block 2023, Block Group 2, Census Tract 1023, Hennepin County, Minnesota",0,0,0,0,0,0,0,0,0,0,0,0,0,0,0,0,0,0,0,0,0,0,0,0,0
270531023002010,25,Near - North,27,27,1000000US270531023002010,"Block 2010, Block Group 2, Census Tract 1023, Hennepin County, Minnesota",0,0,0,0,0,0,0,0,0,0,0,0,0,0,0,0,0,0,0,0,0,0,0,0,0
270531023002006,25,Near - North,27,27,1000000US270531023002006,"Block 2006, Block Group 2, Census Tract 1023, Hennepin County, Minnesota",0,0,0,0,0,0,0,0,0,0,0,0,0,0,0,0,0,0,0,0,0,0,0,0,0
270531023002000,25,Near - North,27,27,1000000US270531023002000,"Block 2000, Block Group 2, Census Tract 1023, Hennepin County, Minnesota",0,0,0,0,0,0,0,0,0,0,0,0,0,0,0,0,0,0,0,0,0,0,0,0,0
270531034001000,25,Near - North,27,27,1000000US270531034001000,"Block 1000, Block Group 1, Census Tract 1034, Hennepin County, Minnesota",6,1,2,0,3,0,0,0,6,6,1,2,0,3,0,0,0,0,0,0,0,0,0,0,0
270531034001010,25,Near - North,27,27,1000000US270531034001010,"Block 1010, Block Group 1, Census Tract 1034, Hennepin County, Minnesota",66,14,38,0,12,0,0,2,66,61,14,33,0,12,0,0,2,5,0,5,0,0,0,0,0
270531023002001,25,Near - North,27,27,1000000US270531023002001,"Block 2001, Block Group 2, Census Tract 1023, Hennepin County, Minnesota",0,0,0,0,0,0,0,0,0,0,0,0,0,0,0,0,0,0,0,0,0,0,0,0,0
270531034001012,25,Near - North,27,27,1000000US270531034001012,"Block 1012, Block Group 1, Census Tract 1034, Hennepin County, Minnesota",199,1,172,3,7,0,3,13,199,194,1,171,3,7,0,0,12,5,0,1,0,0,0,3,1
270531034001011,25,Near - North,27,27,1000000US270531034001011,"Block 1011, Block Group 1, Census Tract 1034, Hennepin County, Minnesota",0,0,0,0,0,0,0,0,0,0,0,0,0,0,0,0,0,0,0,0,0,0,0,0,0
270530033002005,25,Near - North,27,27,1000000US270530033002005,"Block 2005, Block Group 2, Census Tract 33, Hennepin County, Minnesota",121,16,67,0,27,0,0,11,121,108,12,62,0,27,0,0,7,13,4,5,0,0,0,0,4
270531028001008,25,Near - North,27,27,1000000US270531028001008,"Block 1008, Block Group 1, Census Tract 1028, Hennepin County, Minnesota",60,9,24,0,14,0,13,0,60,47,9,24,0,14,0,0,0,13,0,0,0,0,0,13,0
270531028001006,25,Near - North,27,27,1000000US270531028001006,"Block 1006, Block Group 1, Census Tract 1028, Hennepin County, Minnesota",67,7,54,0,0,0,6,0,67,59,7,52,0,0,0,0,0,8,0,2,0,0,0,6,0
270531029001012,25,Near - North,27,27,1000000US270531029001012,"Block 1012, Block Group 1, Census Tract 1029, Hennepin County, Minnesota",59,18,30,1,0,0,3,7,59,51,17,30,0,0,0,0,4,8,1,0,1,0,0,3,3
270530033002011,25,Near - North,27,27,1000000US270530033002011,"Block 2011, Block Group 2, Census Tract 33, Hennepin County, Minnesota",66,7,37,0,9,0,0,13,66,66,7,37,0,9,0,0,13,0,0,0,0,0,0,0,0
270530033001000,25,Near - North,27,27,1000000US270530033001000,"Block 1000, Block Group 1, Census Tract 33, Hennepin County, Minnesota",46,4,26,0,6,0,0,10,46,38,4,26,0,6,0,0,2,8,0,0,0,0,0,0,8
270530033002019,25,Near - North,27,27,1000000US270530033002019,"Block 2019, Block Group 2, Census Tract 33, Hennepin County, Minnesota",16,6,9,0,0,0,0,1,16,14,4,9,0,0,0,0,1,2,2,0,0,0,0,0,0
270531029001024,25,Near - North,27,27,1000000US270531029001024,"Block 1024, Block Group 1, Census Tract 1029, Hennepin County, Minnesota",43,16,12,0,4,0,2,9,43,34,13,11,0,4,0,0,6,9,3,1,0,0,0,2,3
270531029001016,25,Near - North,27,27,1000000US270531029001016,"Block 1016, Block Group 1, Census Tract 1029, Hennepin County, Minnesota",8,4,1,0,1,0,0,2,8,8,4,1,0,1,0,0,2,0,0,0,0,0,0,0,0
270531029001000,25,Near - North,27,27,1000000US270531029001000,"Block 1000, Block Group 1, Census Tract 1029, Hennepin County, Minnesota",55,9,42,2,0,0,0,2,55,55,9,42,2,0,0,0,2,0,0,0,0,0,0,0,0
270531023002013,25,Near - North,27,27,1000000US270531023002013,"Block 2013, Block Group 2, Census Tract 1023, Hennepin County, Minnesota",529,94,337,2,52,0,5,39,529,522,90,336,2,52,0,4,38,7,4,1,0,0,0,1,1
270531023002005,25,Near - North,27,27,1000000US270531023002005,"Block 2005, Block Group 2, Census Tract 1023, Hennepin County, Minnesota",2,0,1,0,0,0,0,1,2,2,0,1,0,0,0,0,1,0,0,0,0,0,0,0,0
270531023002002,25,Near - North,27,27,1000000US270531023002002,"Block 2002, Block Group 2, Census Tract 1023, Hennepin County, Minnesota",0,0,0,0,0,0,0,0,0,0,0,0,0,0,0,0,0,0,0,0,0,0,0,0,0
270531023002024,25,Near - North,27,27,1000000US270531023002024,"Block 2024, Block Group 2, Census Tract 1023, Hennepin County, Minnesota",0,0,0,0,0,0,0,0,0,0,0,0,0,0,0,0,0,0,0,0,0,0,0,0,0
270531023002015,25,Near - North,27,27,1000000US270531023002015,"Block 2015, Block Group 2, Census Tract 1023, Hennepin County, Minnesota",28,8,19,0,0,0,1,0,28,27,8,19,0,0,0,0,0,1,0,0,0,0,0,1,0
270531029001015,25,Near - North,27,27,1000000US270531029001015,"Block 1015, Block Group 1, Census Tract 1029, Hennepin County, Minnesota",14,11,3,0,0,0,0,0,14,14,11,3,0,0,0,0,0,0,0,0,0,0,0,0,0
270531023002014,25,Near - North,27,27,1000000US270531023002014,"Block 2014, Block Group 2, Census Tract 1023, Hennepin County, Minnesota",16,8,8,0,0,0,0,0,16,16,8,8,0,0,0,0,0,0,0,0,0,0,0,0,0
270531029001013,25,Near - North,27,27,1000000US270531029001013,"Block 1013, Block Group 1, Census Tract 1029, Hennepin County, Minnesota",16,10,6,0,0,0,0,0,16,16,10,6,0,0,0,0,0,0,0,0,0,0,0,0,0
270531023002017,25,Near - North,27,27,1000000US270531023002017,"Block 2017, Block Group 2, Census Tract 1023, Hennepin County, Minnesota",59,0,50,0,0,0,0,9,59,59,0,50,0,0,0,0,9,0,0,0,0,0,0,0,0
270531023002020,25,Near - North,27,27,1000000US270531023002020,"Block 2020, Block Group 2, Census Tract 1023, Hennepin County, Minnesota",0,0,0,0,0,0,0,0,0,0,0,0,0,0,0,0,0,0,0,0,0,0,0,0,0
270531028001012,25,Near - North,27,27,1000000US270531028001012,"Block 1012, Block Group 1, Census Tract 1028, Hennepin County, Minnesota",33,0,32,0,1,0,0,0,33,32,0,32,0,0,0,0,0,1,0,0,0,1,0,0,0
270530033002000,25,Near - North,27,27,1000000US270530033002000,"Block 2000, Block Group 2, Census Tract 33, Hennepin County, Minnesota",133,4,90,4,32,0,0,3,133,130,4,87,4,32,0,0,3,3,0,3,0,0,0,0,0
270530033001012,25,Near - North,27,27,1000000US270530033001012,"Block 1012, Block Group 1, Census Tract 33, Hennepin County, Minnesota",6,0,6,0,0,0,0,0,6,6,0,6,0,0,0,0,0,0,0,0,0,0,0,0,0
270530033001009,25,Near - North,27,27,1000000US270530033001009,"Block 1009, Block Group 1, Census Tract 33, Hennepin County, Minnesota",48,7,36,0,2,0,0,3,48,48,7,36,0,2,0,0,3,0,0,0,0,0,0,0,0
270530033002020,25,Near - North,27,27,1000000US270530033002020,"Block 2020, Block Group 2, Census Tract 33, Hennepin County, Minnesota",0,0,0,0,0,0,0,0,0,0,0,0,0,0,0,0,0,0,0,0,0,0,0,0,0
270530033002018,25,Near - North,27,27,1000000US270530033002018,"Block 2018, Block Group 2, Census Tract 33, Hennepin County, Minnesota",11,2,9,0,0,0,0,0,11,11,2,9,0,0,0,0,0,0,0,0,0,0,0,0,0
270531034001005,25,Near - North,27,27,1000000US270531034001005,"Block 1005, Block Group 1, Census Tract 1034, Hennepin County, Minnesota",486,17,447,1,13,0,0,8,486,485,17,446,1,13,0,0,8,1,0,1,0,0,0,0,0
270531034001003,25,Near - North,27,27,1000000US270531034001003,"Block 1003, Block Group 1, Census Tract 1034, Hennepin County, Minnesota",0,0,0,0,0,0,0,0,0,0,0,0,0,0,0,0,0,0,0,0,0,0,0,0,0
270531262002003,25,Near - North,27,27,1000000US270531262002003,"Block 2003, Block Group 2, Census Tract 1262, Hennepin County, Minnesota",0,0,0,0,0,0,0,0,0,0,0,0,0,0,0,0,0,0,0,0,0,0,0,0,0
270531028001000,25,Near - North,27,27,1000000US270531028001000,"Block 1000, Block Group 1, Census Tract 1028, Hennepin County, Minnesota",26,17,7,0,0,0,0,2,26,26,17,7,0,0,0,0,2,0,0,0,0,0,0,0,0
270531028001009,25,Near - North,27,27,1000000US270531028001009,"Block 1009, Block Group 1, Census Tract 1028, Hennepin County, Minnesota",69,8,42,0,19,0,0,0,69,69,8,42,0,19,0,0,0,0,0,0,0,0,0,0,0
270530033002002,25,Near - North,27,27,1000000US270530033002002,"Block 2002, Block Group 2, Census Tract 33, Hennepin County, Minnesota",127,12,89,0,13,0,0,13,127,127,12,89,0,13,0,0,13,0,0,0,0,0,0,0,0
270530033002001,25,Near - North,27,27,1000000US270530033002001,"Block 2001, Block Group 2, Census Tract 33, Hennepin County, Minnesota",109,6,73,0,30,0,0,0,109,109,6,73,0,30,0,0,0,0,0,0,0,0,0,0,0
270530033002009,25,Near - North,27,27,1000000US270530033002009,"Block 2009, Block Group 2, Census Tract 33, Hennepin County, Minnesota",89,4,40,5,35,0,0,5,89,88,3,40,5,35,0,0,5,1,1,0,0,0,0,0,0
270530033001013,25,Near - North,27,27,1000000US270530033001013,"Block 1013, Block Group 1, Census Tract 33, Hennepin County, Minnesota",0,0,0,0,0,0,0,0,0,0,0,0,0,0,0,0,0,0,0,0,0,0,0,0,0
270531029001003,25,Near - North,27,27,1000000US270531029001003,"Block 1003, Block Group 1, Census Tract 1029, Hennepin County, Minnesota",109,14,72,0,0,0,13,10,109,89,13,71,0,0,0,0,5,20,1,1,0,0,0,13,5
270531029001026,25,Near - North,27,27,1000000US270531029001026,"Block 1026, Block Group 1, Census Tract 1029, Hennepin County, Minnesota",55,16,26,3,10,0,0,0,55,55,16,26,3,10,0,0,0,0,0,0,0,0,0,0,0
270531029001029,25,Near - North,27,27,1000000US270531029001029,"Block 1029, Block Group 1, Census Tract 1029, Hennepin County, Minnesota",24,5,10,0,9,0,0,0,24,24,5,10,0,9,0,0,0,0,0,0,0,0,0,0,0
270531029001010,25,Near - North,27,27,1000000US270531029001010,"Block 1010, Block Group 1, Census Tract 1029, Hennepin County, Minnesota",43,10,31,0,0,0,2,0,43,32,5,27,0,0,0,0,0,11,5,4,0,0,0,2,0
270531029001009,25,Near - North,27,27,1000000US270531029001009,"Block 1009, Block Group 1, Census Tract 1029, Hennepin County, Minnesota",61,15,14,0,28,0,0,4,61,61,15,14,0,28,0,0,4,0,0,0,0,0,0,0,0
270531034001009,25,Near - North,27,27,1000000US270531034001009,"Block 1009, Block Group 1, Census Tract 1034, Hennepin County, Minnesota",0,0,0,0,0,0,0,0,0,0,0,0,0,0,0,0,0,0,0,0,0,0,0,0,0
270531023002009,25,Near - North,27,27,1000000US270531023002009,"Block 2009, Block Group 2, Census Tract 1023, Hennepin County, Minnesota",0,0,0,0,0,0,0,0,0,0,0,0,0,0,0,0,0,0,0,0,0,0,0,0,0
270531023002021,25,Near - North,27,27,1000000US270531023002021,"Block 2021, Block Group 2, Census Tract 1023, Hennepin County, Minnesota",0,0,0,0,0,0,0,0,0,0,0,0,0,0,0,0,0,0,0,0,0,0,0,0,0
270531023002008,25,Near - North,27,27,1000000US270531023002008,"Block 2008, Block Group 2, Census Tract 1023, Hennepin County, Minnesota",0,0,0,0,0,0,0,0,0,0,0,0,0,0,0,0,0,0,0,0,0,0,0,0,0
270531041001036,26,Harrison,28,28,1000000US270531041001036,"Block 1036, Block Group 1, Census Tract 1041, Hennepin County, Minnesota",0,0,0,0,0,0,0,0,0,0,0,0,0,0,0,0,0,0,0,0,0,0,0,0,0
270531041002009,26,Harrison,28,28,1000000US270531041002009,"Block 2009, Block Group 2, Census Tract 1041, Hennepin County, Minnesota",17,9,6,0,1,0,1,0,17,17,9,6,0,1,0,1,0,0,0,0,0,0,0,0,0
270531041002010,26,Harrison,28,28,1000000US270531041002010,"Block 2010, Block Group 2, Census Tract 1041, Hennepin County, Minnesota",29,27,2,0,0,0,0,0,29,19,17,2,0,0,0,0,0,10,10,0,0,0,0,0,0
270531041001013,26,Harrison,28,28,1000000US270531041001013,"Block 1013, Block Group 1, Census Tract 1041, Hennepin County, Minnesota",46,25,14,0,0,0,0,7,46,45,25,14,0,0,0,0,6,1,0,0,0,0,0,0,1
270531041001017,26,Harrison,28,28,1000000US270531041001017,"Block 1017, Block Group 1, Census Tract 1041, Hennepin County, Minnesota",17,13,1,0,3,0,0,0,17,17,13,1,0,3,0,0,0,0,0,0,0,0,0,0,0
270531041002019,26,Harrison,28,28,1000000US270531041002019,"Block 2019, Block Group 2, Census Tract 1041, Hennepin County, Minnesota",58,32,21,0,0,0,0,5,58,58,32,21,0,0,0,0,5,0,0,0,0,0,0,0,0
270531041001012,26,Harrison,28,28,1000000US270531041001012,"Block 1012, Block Group 1, Census Tract 1041, Hennepin County, Minnesota",254,96,134,9,5,1,4,5,254,252,96,134,9,5,1,2,5,2,0,0,0,0,0,2,0
270531041001033,26,Harrison,28,28,1000000US270531041001033,"Block 1033, Block Group 1, Census Tract 1041, Hennepin County, Minnesota",0,0,0,0,0,0,0,0,0,0,0,0,0,0,0,0,0,0,0,0,0,0,0,0,0
270531041001016,26,Harrison,28,28,1000000US270531041001016,"Block 1016, Block Group 1, Census Tract 1041, Hennepin County, Minnesota",0,0,0,0,0,0,0,0,0,0,0,0,0,0,0,0,0,0,0,0,0,0,0,0,0
270531041001034,26,Harrison,28,28,1000000US270531041001034,"Block 1034, Block Group 1, Census Tract 1041, Hennepin County, Minnesota",0,0,0,0,0,0,0,0,0,0,0,0,0,0,0,0,0,0,0,0,0,0,0,0,0
270531041002030,26,Harrison,28,28,1000000US270531041002030,"Block 2030, Block Group 2, Census Tract 1041, Hennepin County, Minnesota",23,3,16,0,1,0,0,3,23,23,3,16,0,1,0,0,3,0,0,0,0,0,0,0,0
270531041002031,26,Harrison,28,28,1000000US270531041002031,"Block 2031, Block Group 2, Census Tract 1041, Hennepin County, Minnesota",61,18,26,0,12,0,0,5,61,47,9,25,0,12,0,0,1,14,9,1,0,0,0,0,4
270531041002017,26,Harrison,28,28,1000000US270531041002017,"Block 2017, Block Group 2, Census Tract 1041, Hennepin County, Minnesota",100,2,53,10,27,0,5,3,100,94,2,53,10,27,0,0,2,6,0,0,0,0,0,5,1
270531041002002,26,Harrison,28,28,1000000US270531041002002,"Block 2002, Block Group 2, Census Tract 1041, Hennepin County, Minnesota",0,0,0,0,0,0,0,0,0,0,0,0,0,0,0,0,0,0,0,0,0,0,0,0,0
270531041002005,26,Harrison,28,28,1000000US270531041002005,"Block 2005, Block Group 2, Census Tract 1041, Hennepin County, Minnesota",0,0,0,0,0,0,0,0,0,0,0,0,0,0,0,0,0,0,0,0,0,0,0,0,0
270531041002021,26,Harrison,28,28,1000000US270531041002021,"Block 2021, Block Group 2, Census Tract 1041, Hennepin County, Minnesota",111,24,54,0,30,0,0,3,111,103,19,54,0,29,0,0,1,8,5,0,0,1,0,0,2
270531041002026,26,Harrison,28,28,1000000US270531041002026,"Block 2026, Block Group 2, Census Tract 1041, Hennepin County, Minnesota",40,3,34,0,1,0,1,1,40,40,3,34,0,1,0,1,1,0,0,0,0,0,0,0,0
270531041001010,26,Harrison,28,28,1000000US270531041001010,"Block 1010, Block Group 1, Census Tract 1041, Hennepin County, Minnesota",82,6,27,3,23,0,14,9,82,66,5,27,3,23,0,0,8,16,1,0,0,0,0,14,1
270531041002032,26,Harrison,28,28,1000000US270531041002032,"Block 2032, Block Group 2, Census Tract 1041, Hennepin County, Minnesota",33,13,10,0,10,0,0,0,33,29,9,10,0,10,0,0,0,4,4,0,0,0,0,0,0
270531041001006,26,Harrison,28,28,1000000US270531041001006,"Block 1006, Block Group 1, Census Tract 1041, Hennepin County, Minnesota",115,64,23,2,20,0,1,5,115,114,64,22,2,20,0,1,5,1,0,1,0,0,0,0,0
270531041001023,26,Harrison,28,28,1000000US270531041001023,"Block 1023, Block Group 1, Census Tract 1041, Hennepin County, Minnesota",58,44,8,0,6,0,0,0,58,57,43,8,0,6,0,0,0,1,1,0,0,0,0,0,0
270531041001007,26,Harrison,28,28,1000000US270531041001007,"Block 1007, Block Group 1, Census Tract 1041, Hennepin County, Minnesota",56,30,18,1,5,0,1,1,56,54,30,17,1,5,0,0,1,2,0,1,0,0,0,1,0
270531041002028,26,Harrison,28,28,1000000US270531041002028,"Block 2028, Block Group 2, Census Tract 1041, Hennepin County, Minnesota",25,20,1,0,4,0,0,0,25,19,14,1,0,4,0,0,0,6,6,0,0,0,0,0,0
270531041001020,26,Harrison,28,28,1000000US270531041001020,"Block 1020, Block Group 1, Census Tract 1041, Hennepin County, Minnesota",135,68,22,0,30,1,7,7,135,120,66,19,0,30,1,0,4,15,2,3,0,0,0,7,3
270531041001025,26,Harrison,28,28,1000000US270531041001025,"Block 1025, Block Group 1, Census Tract 1041, Hennepin County, Minnesota",30,20,6,0,4,0,0,0,30,25,15,6,0,4,0,0,0,5,5,0,0,0,0,0,0
270531041002000,26,Harrison,28,28,1000000US270531041002000,"Block 2000, Block Group 2, Census Tract 1041, Hennepin County, Minnesota",0,0,0,0,0,0,0,0,0,0,0,0,0,0,0,0,0,0,0,0,0,0,0,0,0
270531041001030,26,Harrison,28,28,1000000US270531041001030,"Block 1030, Block Group 1, Census Tract 1041, Hennepin County, Minnesota",28,13,4,1,0,0,8,2,28,19,13,3,1,0,0,0,2,9,0,1,0,0,0,8,0
270531041001024,26,Harrison,28,28,1000000US270531041001024,"Block 1024, Block Group 1, Census Tract 1041, Hennepin County, Minnesota",75,54,8,2,0,0,4,7,75,70,53,8,2,0,0,0,7,5,1,0,0,0,0,4,0
270531041002001,26,Harrison,28,28,1000000US270531041002001,"Block 2001, Block Group 2, Census Tract 1041, Hennepin County, Minnesota",0,0,0,0,0,0,0,0,0,0,0,0,0,0,0,0,0,0,0,0,0,0,0,0,0
270531041001031,26,Harrison,28,28,1000000US270531041001031,"Block 1031, Block Group 1, Census Tract 1041, Hennepin County, Minnesota",0,0,0,0,0,0,0,0,0,0,0,0,0,0,0,0,0,0,0,0,0,0,0,0,0
270531041001003,26,Harrison,28,28,1000000US270531041001003,"Block 1003, Block Group 1, Census Tract 1041, Hennepin County, Minnesota",0,0,0,0,0,0,0,0,0,0,0,0,0,0,0,0,0,0,0,0,0,0,0,0,0
270531041001004,26,Harrison,28,28,1000000US270531041001004,"Block 1004, Block Group 1, Census Tract 1041, Hennepin County, Minnesota",18,14,4,0,0,0,0,0,18,18,14,4,0,0,0,0,0,0,0,0,0,0,0,0,0
270531041001022,26,Harrison,28,28,1000000US270531041001022,"Block 1022, Block Group 1, Census Tract 1041, Hennepin County, Minnesota",24,11,12,0,0,0,0,1,24,24,11,12,0,0,0,0,1,0,0,0,0,0,0,0,0
270531041002016,26,Harrison,28,28,1000000US270531041002016,"Block 2016, Block Group 2, Census Tract 1041, Hennepin County, Minnesota",229,4,215,0,0,0,0,10,229,217,0,213,0,0,0,0,4,12,4,2,0,0,0,0,6
270531041001032,26,Harrison,28,28,1000000US270531041001032,"Block 1032, Block Group 1, Census Tract 1041, Hennepin County, Minnesota",74,45,16,5,6,0,0,2,74,72,44,16,5,6,0,0,1,2,1,0,0,0,0,0,1
270531041001029,26,Harrison,28,28,1000000US270531041001029,"Block 1029, Block Group 1, Census Tract 1041, Hennepin County, Minnesota",6,5,1,0,0,0,0,0,6,6,5,1,0,0,0,0,0,0,0,0,0,0,0,0,0
270531041001028,26,Harrison,28,28,1000000US270531041001028,"Block 1028, Block Group 1, Census Tract 1041, Hennepin County, Minnesota",0,0,0,0,0,0,0,0,0,0,0,0,0,0,0,0,0,0,0,0,0,0,0,0,0
270531041001000,26,Harrison,28,28,1000000US270531041001000,"Block 1000, Block Group 1, Census Tract 1041, Hennepin County, Minnesota",0,0,0,0,0,0,0,0,0,0,0,0,0,0,0,0,0,0,0,0,0,0,0,0,0
270531041001026,26,Harrison,28,28,1000000US270531041001026,"Block 1026, Block Group 1, Census Tract 1041, Hennepin County, Minnesota",20,18,2,0,0,0,0,0,20,20,18,2,0,0,0,0,0,0,0,0,0,0,0,0,0
270531041001018,26,Harrison,28,28,1000000US270531041001018,"Block 1018, Block Group 1, Census Tract 1041, Hennepin County, Minnesota",0,0,0,0,0,0,0,0,0,0,0,0,0,0,0,0,0,0,0,0,0,0,0,0,0
270531041001035,26,Harrison,28,28,1000000US270531041001035,"Block 1035, Block Group 1, Census Tract 1041, Hennepin County, Minnesota",0,0,0,0,0,0,0,0,0,0,0,0,0,0,0,0,0,0,0,0,0,0,0,0,0
270531041002013,26,Harrison,28,28,1000000US270531041002013,"Block 2013, Block Group 2, Census Tract 1041, Hennepin County, Minnesota",0,0,0,0,0,0,0,0,0,0,0,0,0,0,0,0,0,0,0,0,0,0,0,0,0
270531041002012,26,Harrison,28,28,1000000US270531041002012,"Block 2012, Block Group 2, Census Tract 1041, Hennepin County, Minnesota",0,0,0,0,0,0,0,0,0,0,0,0,0,0,0,0,0,0,0,0,0,0,0,0,0
270531041001015,26,Harrison,28,28,1000000US270531041001015,"Block 1015, Block Group 1, Census Tract 1041, Hennepin County, Minnesota",27,12,6,0,3,0,6,0,27,14,5,6,0,3,0,0,0,13,7,0,0,0,0,6,0
270531041002024,26,Harrison,28,28,1000000US270531041002024,"Block 2024, Block Group 2, Census Tract 1041, Hennepin County, Minnesota",56,16,38,0,0,0,0,2,56,47,12,34,0,0,0,0,1,9,4,4,0,0,0,0,1
270531041001011,26,Harrison,28,28,1000000US270531041001011,"Block 1011, Block Group 1, Census Tract 1041, Hennepin County, Minnesota",73,11,45,0,15,1,1,0,73,72,11,45,0,15,1,0,0,1,0,0,0,0,0,1,0
270531041002022,26,Harrison,28,28,1000000US270531041002022,"Block 2022, Block Group 2, Census Tract 1041, Hennepin County, Minnesota",34,12,17,0,1,0,1,3,34,26,5,17,0,1,0,0,3,8,7,0,0,0,0,1,0
270531041002023,26,Harrison,28,28,1000000US270531041002023,"Block 2023, Block Group 2, Census Tract 1041, Hennepin County, Minnesota",51,21,14,0,5,0,7,4,51,46,21,14,0,5,0,2,4,5,0,0,0,0,0,5,0
270531041002004,26,Harrison,28,28,1000000US270531041002004,"Block 2004, Block Group 2, Census Tract 1041, Hennepin County, Minnesota",0,0,0,0,0,0,0,0,0,0,0,0,0,0,0,0,0,0,0,0,0,0,0,0,0
270531041002025,26,Harrison,28,28,1000000US270531041002025,"Block 2025, Block Group 2, Census Tract 1041, Hennepin County, Minnesota",65,22,20,0,1,0,12,10,65,44,14,20,0,1,0,0,9,21,8,0,0,0,0,12,1
270531041001019,26,Harrison,28,28,1000000US270531041001019,"Block 1019, Block Group 1, Census Tract 1041, Hennepin County, Minnesota",10,4,0,0,6,0,0,0,10,10,4,0,0,6,0,0,0,0,0,0,0,0,0,0,0
270531034001015,26,Harrison,28,28,1000000US270531034001015,"Block 1015, Block Group 1, Census Tract 1034, Hennepin County, Minnesota",0,0,0,0,0,0,0,0,0,0,0,0,0,0,0,0,0,0,0,0,0,0,0,0,0
270531041001027,26,Harrison,28,28,1000000US270531041001027,"Block 1027, Block Group 1, Census Tract 1041, Hennepin County, Minnesota",0,0,0,0,0,0,0,0,0,0,0,0,0,0,0,0,0,0,0,0,0,0,0,0,0
270531041002011,26,Harrison,28,28,1000000US270531041002011,"Block 2011, Block Group 2, Census Tract 1041, Hennepin County, Minnesota",115,21,8,0,63,0,19,4,115,83,10,8,0,63,0,0,2,32,11,0,0,0,0,19,2
270531041002006,26,Harrison,28,28,1000000US270531041002006,"Block 2006, Block Group 2, Census Tract 1041, Hennepin County, Minnesota",82,43,27,7,4,0,0,1,82,75,43,27,1,4,0,0,0,7,0,0,6,0,0,0,1
270531041002008,26,Harrison,28,28,1000000US270531041002008,"Block 2008, Block Group 2, Census Tract 1041, Hennepin County, Minnesota",31,24,4,0,0,0,0,3,31,31,24,4,0,0,0,0,3,0,0,0,0,0,0,0,0
270531034001016,26,Harrison,28,28,1000000US270531034001016,"Block 1016, Block Group 1, Census Tract 1034, Hennepin County, Minnesota",0,0,0,0,0,0,0,0,0,0,0,0,0,0,0,0,0,0,0,0,0,0,0,0,0
270531041001002,26,Harrison,28,28,1000000US270531041001002,"Block 1002, Block Group 1, Census Tract 1041, Hennepin County, Minnesota",0,0,0,0,0,0,0,0,0,0,0,0,0,0,0,0,0,0,0,0,0,0,0,0,0
270531041002014,26,Harrison,28,28,1000000US270531041002014,"Block 2014, Block Group 2, Census Tract 1041, Hennepin County, Minnesota",0,0,0,0,0,0,0,0,0,0,0,0,0,0,0,0,0,0,0,0,0,0,0,0,0
270531041002007,26,Harrison,28,28,1000000US270531041002007,"Block 2007, Block Group 2, Census Tract 1041, Hennepin County, Minnesota",51,19,10,0,15,0,7,0,51,44,19,10,0,15,0,0,0,7,0,0,0,0,0,7,0
270531041001014,26,Harrison,28,28,1000000US270531041001014,"Block 1014, Block Group 1, Census Tract 1041, Hennepin County, Minnesota",13,11,1,0,1,0,0,0,13,12,11,0,0,1,0,0,0,1,0,1,0,0,0,0,0
270531041002020,26,Harrison,28,28,1000000US270531041002020,"Block 2020, Block Group 2, Census Tract 1041, Hennepin County, Minnesota",55,10,15,1,0,0,22,7,55,24,5,15,0,0,0,0,4,31,5,0,1,0,0,22,3
270531041002033,26,Harrison,28,28,1000000US270531041002033,"Block 2033, Block Group 2, Census Tract 1041, Hennepin County, Minnesota",50,9,13,0,16,0,12,0,50,38,9,13,0,16,0,0,0,12,0,0,0,0,0,12,0
270531051002009,26,Harrison,28,28,1000000US270531051002009,"Block 2009, Block Group 2, Census Tract 1051, Hennepin County, Minnesota",0,0,0,0,0,0,0,0,0,0,0,0,0,0,0,0,0,0,0,0,0,0,0,0,0
270531041002018,26,Harrison,28,28,1000000US270531041002018,"Block 2018, Block Group 2, Census Tract 1041, Hennepin County, Minnesota",0,0,0,0,0,0,0,0,0,0,0,0,0,0,0,0,0,0,0,0,0,0,0,0,0
270531041002029,26,Harrison,28,28,1000000US270531041002029,"Block 2029, Block Group 2, Census Tract 1041, Hennepin County, Minnesota",61,11,12,0,38,0,0,0,61,61,11,12,0,38,0,0,0,0,0,0,0,0,0,0,0
270531041002027,26,Harrison,28,28,1000000US270531041002027,"Block 2027, Block Group 2, Census Tract 1041, Hennepin County, Minnesota",34,8,15,5,0,0,2,4,34,29,8,15,0,0,0,2,4,5,0,0,5,0,0,0,0
270531041001009,26,Harrison,28,28,1000000US270531041001009,"Block 1009, Block Group 1, Census Tract 1041, Hennepin County, Minnesota",49,9,6,0,31,0,0,3,49,49,9,6,0,31,0,0,3,0,0,0,0,0,0,0,0
270531041001021,26,Harrison,28,28,1000000US270531041001021,"Block 1021, Block Group 1, Census Tract 1041, Hennepin County, Minnesota",34,14,11,1,8,0,0,0,34,31,12,10,1,8,0,0,0,3,2,1,0,0,0,0,0
270531041002003,26,Harrison,28,28,1000000US270531041002003,"Block 2003, Block Group 2, Census Tract 1041, Hennepin County, Minnesota",0,0,0,0,0,0,0,0,0,0,0,0,0,0,0,0,0,0,0,0,0,0,0,0,0
270531041001008,26,Harrison,28,28,1000000US270531041001008,"Block 1008, Block Group 1, Census Tract 1041, Hennepin County, Minnesota",116,17,79,0,12,0,0,8,116,114,17,79,0,11,0,0,7,2,0,0,0,1,0,0,1
270531041001005,26,Harrison,28,28,1000000US270531041001005,"Block 1005, Block Group 1, Census Tract 1041, Hennepin County, Minnesota",68,27,12,0,17,0,6,6,68,56,24,12,0,17,0,0,3,12,3,0,0,0,0,6,3
270531041002015,26,Harrison,28,28,1000000US270531041002015,"Block 2015, Block Group 2, Census Tract 1041, Hennepin County, Minnesota",85,16,10,3,52,0,1,3,85,84,16,10,3,52,0,0,3,1,0,0,0,0,0,1,0
270531041002034,26,Harrison,28,28,1000000US270531041002034,"Block 2034, Block Group 2, Census Tract 1041, Hennepin County, Minnesota",286,9,185,0,78,0,0,14,286,282,6,185,0,78,0,0,13,4,3,0,0,0,0,0,1
270531041001001,26,Harrison,28,28,1000000US270531041001001,"Block 1001, Block Group 1, Census Tract 1041, Hennepin County, Minnesota",1,0,1,0,0,0,0,0,1,1,0,1,0,0,0,0,0,0,0,0,0,0,0,0,0
270531051001010,26,Harrison,28,28,1000000US270531051001010,"Block 1010, Block Group 1, Census Tract 1051, Hennepin County, Minnesota",0,0,0,0,0,0,0,0,0,0,0,0,0,0,0,0,0,0,0,0,0,0,0,0,0
270531052012001,27,Loring Park,31,31,1000000US270531052012001,"Block 2001, Block Group 2, Census Tract 1052.01, Hennepin County, Minnesota",0,0,0,0,0,0,0,0,0,0,0,0,0,0,0,0,0,0,0,0,0,0,0,0,0
270531052012002,27,Loring Park,31,31,1000000US270531052012002,"Block 2002, Block Group 2, Census Tract 1052.01, Hennepin County, Minnesota",242,177,17,5,29,1,3,10,242,230,172,17,3,29,1,2,6,12,5,0,2,0,0,1,4
270531056003000,27,Loring Park,31,31,1000000US270531056003000,"Block 3000, Block Group 3, Census Tract 1056, Hennepin County, Minnesota",654,519,55,4,53,0,9,14,654,619,497,54,4,52,0,0,12,35,22,1,0,1,0,9,2
270531052042004,27,Loring Park,31,31,1000000US270531052042004,"Block 2004, Block Group 2, Census Tract 1052.04, Hennepin County, Minnesota",135,110,11,2,2,1,2,7,135,125,105,9,2,2,1,0,6,10,5,2,0,0,0,2,1
270531056003004,27,Loring Park,31,31,1000000US270531056003004,"Block 3004, Block Group 3, Census Tract 1056, Hennepin County, Minnesota",0,0,0,0,0,0,0,0,0,0,0,0,0,0,0,0,0,0,0,0,0,0,0,0,0
270531056003001,27,Loring Park,31,31,1000000US270531056003001,"Block 3001, Block Group 3, Census Tract 1056, Hennepin County, Minnesota",47,42,2,0,1,0,2,0,47,44,41,2,0,1,0,0,0,3,1,0,0,0,0,2,0
270531056003009,27,Loring Park,31,31,1000000US270531056003009,"Block 3009, Block Group 3, Census Tract 1056, Hennepin County, Minnesota",0,0,0,0,0,0,0,0,0,0,0,0,0,0,0,0,0,0,0,0,0,0,0,0,0
270531052012007,27,Loring Park,31,31,1000000US270531052012007,"Block 2007, Block Group 2, Census Tract 1052.01, Hennepin County, Minnesota",0,0,0,0,0,0,0,0,0,0,0,0,0,0,0,0,0,0,0,0,0,0,0,0,0
270531052012006,27,Loring Park,31,31,1000000US270531052012006,"Block 2006, Block Group 2, Census Tract 1052.01, Hennepin County, Minnesota",0,0,0,0,0,0,0,0,0,0,0,0,0,0,0,0,0,0,0,0,0,0,0,0,0
270531052012017,27,Loring Park,31,31,1000000US270531052012017,"Block 2017, Block Group 2, Census Tract 1052.01, Hennepin County, Minnesota",0,0,0,0,0,0,0,0,0,0,0,0,0,0,0,0,0,0,0,0,0,0,0,0,0
270531052012004,27,Loring Park,31,31,1000000US270531052012004,"Block 2004, Block Group 2, Census Tract 1052.01, Hennepin County, Minnesota",510,377,34,1,84,0,6,8,510,489,365,34,1,82,0,1,6,21,12,0,0,2,0,5,2
270531052012012,27,Loring Park,31,31,1000000US270531052012012,"Block 2012, Block Group 2, Census Tract 1052.01, Hennepin County, Minnesota",13,11,0,0,1,0,0,1,13,11,9,0,0,1,0,0,1,2,2,0,0,0,0,0,0
270531052012005,27,Loring Park,31,31,1000000US270531052012005,"Block 2005, Block Group 2, Census Tract 1052.01, Hennepin County, Minnesota",233,132,38,4,3,0,18,38,233,174,102,38,1,3,0,3,27,59,30,0,3,0,0,15,11
270531056004000,27,Loring Park,31,31,1000000US270531056004000,"Block 4000, Block Group 4, Census Tract 1056, Hennepin County, Minnesota",876,700,68,4,44,0,15,45,876,827,671,68,2,44,0,1,41,49,29,0,2,0,0,14,4
270531052012011,27,Loring Park,31,31,1000000US270531052012011,"Block 2011, Block Group 2, Census Tract 1052.01, Hennepin County, Minnesota",23,19,2,0,1,0,1,0,23,22,19,2,0,1,0,0,0,1,0,0,0,0,0,1,0
270531056003006,27,Loring Park,31,31,1000000US270531056003006,"Block 3006, Block Group 3, Census Tract 1056, Hennepin County, Minnesota",0,0,0,0,0,0,0,0,0,0,0,0,0,0,0,0,0,0,0,0,0,0,0,0,0
270531052012003,27,Loring Park,31,31,1000000US270531052012003,"Block 2003, Block Group 2, Census Tract 1052.01, Hennepin County, Minnesota",0,0,0,0,0,0,0,0,0,0,0,0,0,0,0,0,0,0,0,0,0,0,0,0,0
270531052012009,27,Loring Park,31,31,1000000US270531052012009,"Block 2009, Block Group 2, Census Tract 1052.01, Hennepin County, Minnesota",0,0,0,0,0,0,0,0,0,0,0,0,0,0,0,0,0,0,0,0,0,0,0,0,0
270531052012015,27,Loring Park,31,31,1000000US270531052012015,"Block 2015, Block Group 2, Census Tract 1052.01, Hennepin County, Minnesota",49,37,5,1,3,0,0,3,49,49,37,5,1,3,0,0,3,0,0,0,0,0,0,0,0
270531056001001,27,Loring Park,31,31,1000000US270531056001001,"Block 1001, Block Group 1, Census Tract 1056, Hennepin County, Minnesota",361,297,31,3,9,0,5,16,361,345,289,30,3,9,0,2,12,16,8,1,0,0,0,3,4
270531052042006,27,Loring Park,31,31,1000000US270531052042006,"Block 2006, Block Group 2, Census Tract 1052.04, Hennepin County, Minnesota",132,90,17,2,8,2,5,8,132,118,84,16,2,8,2,0,6,14,6,1,0,0,0,5,2
270531056003003,27,Loring Park,31,31,1000000US270531056003003,"Block 3003, Block Group 3, Census Tract 1056, Hennepin County, Minnesota",452,402,16,1,19,0,6,8,452,436,395,16,1,19,0,1,4,16,7,0,0,0,0,5,4
270531056001000,27,Loring Park,31,31,1000000US270531056001000,"Block 1000, Block Group 1, Census Tract 1056, Hennepin County, Minnesota",293,173,99,1,5,0,6,9,293,280,166,99,1,5,0,0,9,13,7,0,0,0,0,6,0
270531052012016,27,Loring Park,31,31,1000000US270531052012016,"Block 2016, Block Group 2, Census Tract 1052.01, Hennepin County, Minnesota",302,233,20,3,27,1,5,13,302,282,221,19,3,27,1,0,11,20,12,1,0,0,0,5,2
270531052042003,27,Loring Park,31,31,1000000US270531052042003,"Block 2003, Block Group 2, Census Tract 1052.04, Hennepin County, Minnesota",247,209,7,2,19,0,1,9,247,234,198,7,2,19,0,0,8,13,11,0,0,0,0,1,1
270531052012014,27,Loring Park,31,31,1000000US270531052012014,"Block 2014, Block Group 2, Census Tract 1052.01, Hennepin County, Minnesota",61,55,1,0,4,0,0,1,61,61,55,1,0,4,0,0,1,0,0,0,0,0,0,0,0
270531052042005,27,Loring Park,31,31,1000000US270531052042005,"Block 2005, Block Group 2, Census Tract 1052.04, Hennepin County, Minnesota",0,0,0,0,0,0,0,0,0,0,0,0,0,0,0,0,0,0,0,0,0,0,0,0,0
270531052042000,27,Loring Park,31,31,1000000US270531052042000,"Block 2000, Block Group 2, Census Tract 1052.04, Hennepin County, Minnesota",348,317,4,1,20,0,3,3,348,336,309,4,1,19,0,0,3,12,8,0,0,1,0,3,0
270531052041005,27,Loring Park,31,31,1000000US270531052041005,"Block 1005, Block Group 1, Census Tract 1052.04, Hennepin County, Minnesota",271,204,13,0,48,0,0,6,271,258,192,13,0,48,0,0,5,13,12,0,0,0,0,0,1
270531052041006,27,Loring Park,31,31,1000000US270531052041006,"Block 1006, Block Group 1, Census Tract 1052.04, Hennepin County, Minnesota",361,154,170,5,9,0,4,19,361,349,152,168,4,9,0,0,16,12,2,2,1,0,0,4,3
270531052041003,27,Loring Park,31,31,1000000US270531052041003,"Block 1003, Block Group 1, Census Tract 1052.04, Hennepin County, Minnesota",0,0,0,0,0,0,0,0,0,0,0,0,0,0,0,0,0,0,0,0,0,0,0,0,0
270531052041008,27,Loring Park,31,31,1000000US270531052041008,"Block 1008, Block Group 1, Census Tract 1052.04, Hennepin County, Minnesota",0,0,0,0,0,0,0,0,0,0,0,0,0,0,0,0,0,0,0,0,0,0,0,0,0
270531052041007,27,Loring Park,31,31,1000000US270531052041007,"Block 1007, Block Group 1, Census Tract 1052.04, Hennepin County, Minnesota",104,35,46,3,1,0,11,8,104,86,28,46,3,1,0,0,8,18,7,0,0,0,0,11,0
270531052041009,27,Loring Park,31,31,1000000US270531052041009,"Block 1009, Block Group 1, Census Tract 1052.04, Hennepin County, Minnesota",27,3,22,0,0,0,1,1,27,25,2,22,0,0,0,0,1,2,1,0,0,0,0,1,0
270531052041001,27,Loring Park,31,31,1000000US270531052041001,"Block 1001, Block Group 1, Census Tract 1052.04, Hennepin County, Minnesota",0,0,0,0,0,0,0,0,0,0,0,0,0,0,0,0,0,0,0,0,0,0,0,0,0
270531052012000,27,Loring Park,31,31,1000000US270531052012000,"Block 2000, Block Group 2, Census Tract 1052.01, Hennepin County, Minnesota",0,0,0,0,0,0,0,0,0,0,0,0,0,0,0,0,0,0,0,0,0,0,0,0,0
270531052012008,27,Loring Park,31,31,1000000US270531052012008,"Block 2008, Block Group 2, Census Tract 1052.01, Hennepin County, Minnesota",0,0,0,0,0,0,0,0,0,0,0,0,0,0,0,0,0,0,0,0,0,0,0,0,0
270531052012010,27,Loring Park,31,31,1000000US270531052012010,"Block 2010, Block Group 2, Census Tract 1052.01, Hennepin County, Minnesota",0,0,0,0,0,0,0,0,0,0,0,0,0,0,0,0,0,0,0,0,0,0,0,0,0
270531056003002,27,Loring Park,31,31,1000000US270531056003002,"Block 3002, Block Group 3, Census Tract 1056, Hennepin County, Minnesota",0,0,0,0,0,0,0,0,0,0,0,0,0,0,0,0,0,0,0,0,0,0,0,0,0
270531052012013,27,Loring Park,31,31,1000000US270531052012013,"Block 2013, Block Group 2, Census Tract 1052.01, Hennepin County, Minnesota",0,0,0,0,0,0,0,0,0,0,0,0,0,0,0,0,0,0,0,0,0,0,0,0,0
270531052011000,27,Loring Park,31,31,1000000US270531052011000,"Block 1000, Block Group 1, Census Tract 1052.01, Hennepin County, Minnesota",1284,1165,42,1,61,0,4,11,1284,1261,1145,42,1,61,0,3,9,23,20,0,0,0,0,1,2
270531052041004,27,Loring Park,31,31,1000000US270531052041004,"Block 1004, Block Group 1, Census Tract 1052.04, Hennepin County, Minnesota",83,54,10,1,16,0,0,2,83,78,50,10,1,16,0,0,1,5,4,0,0,0,0,0,1
270531052041002,27,Loring Park,31,31,1000000US270531052041002,"Block 1002, Block Group 1, Census Tract 1052.04, Hennepin County, Minnesota",31,4,16,9,1,0,0,1,31,29,3,16,8,1,0,0,1,2,1,0,1,0,0,0,0
270531056003005,27,Loring Park,31,31,1000000US270531056003005,"Block 3005, Block Group 3, Census Tract 1056, Hennepin County, Minnesota",0,0,0,0,0,0,0,0,0,0,0,0,0,0,0,0,0,0,0,0,0,0,0,0,0
270531056003007,27,Loring Park,31,31,1000000US270531056003007,"Block 3007, Block Group 3, Census Tract 1056, Hennepin County, Minnesota",180,160,5,1,11,0,0,3,180,177,159,5,1,11,0,0,1,3,1,0,0,0,0,0,2
270531052042002,27,Loring Park,31,31,1000000US270531052042002,"Block 2002, Block Group 2, Census Tract 1052.04, Hennepin County, Minnesota",162,123,19,2,10,0,5,3,162,150,118,19,2,10,0,0,1,12,5,0,0,0,0,5,2
270531052042001,27,Loring Park,31,31,1000000US270531052042001,"Block 2001, Block Group 2, Census Tract 1052.04, Hennepin County, Minnesota",392,280,91,2,8,0,1,10,392,386,274,91,2,8,0,1,10,6,6,0,0,0,0,0,0
270531052041000,27,Loring Park,31,31,1000000US270531052041000,"Block 1000, Block Group 1, Census Tract 1052.04, Hennepin County, Minnesota",0,0,0,0,0,0,0,0,0,0,0,0,0,0,0,0,0,0,0,0,0,0,0,0,0
270531056002006,28,Steven's Square - Loring Heights,32,32,1000000US270531056002006,"Block 2006, Block Group 2, Census Tract 1056, Hennepin County, Minnesota",166,131,13,2,4,0,7,9,166,146,123,11,2,4,0,0,6,20,8,2,0,0,0,7,3
270531057002000,28,Steven's Square - Loring Heights,32,32,1000000US270531057002000,"Block 2000, Block Group 2, Census Tract 1057, Hennepin County, Minnesota",315,136,156,2,11,0,3,7,315,305,130,156,2,11,0,0,6,10,6,0,0,0,0,3,1
270531056002001,28,Steven's Square - Loring Heights,32,32,1000000US270531056002001,"Block 2001, Block Group 2, Census Tract 1056, Hennepin County, Minnesota",158,120,16,1,8,0,2,11,158,154,118,16,1,8,0,0,11,4,2,0,0,0,0,2,0
270531057001001,28,Steven's Square - Loring Heights,32,32,1000000US270531057001001,"Block 1001, Block Group 1, Census Tract 1057, Hennepin County, Minnesota",0,0,0,0,0,0,0,0,0,0,0,0,0,0,0,0,0,0,0,0,0,0,0,0,0
270531057001002,28,Steven's Square - Loring Heights,32,32,1000000US270531057001002,"Block 1002, Block Group 1, Census Tract 1057, Hennepin County, Minnesota",95,77,13,2,3,0,0,0,95,94,77,12,2,3,0,0,0,1,0,1,0,0,0,0,0
270531057003003,28,Steven's Square - Loring Heights,32,32,1000000US270531057003003,"Block 3003, Block Group 3, Census Tract 1057, Hennepin County, Minnesota",344,233,80,1,4,0,5,21,344,319,219,76,1,4,0,1,18,25,14,4,0,0,0,4,3
270531057001005,28,Steven's Square - Loring Heights,32,32,1000000US270531057001005,"Block 1005, Block Group 1, Census Tract 1057, Hennepin County, Minnesota",92,54,27,1,2,0,3,5,92,87,54,26,1,2,0,0,4,5,0,1,0,0,0,3,1
270531057002004,28,Steven's Square - Loring Heights,32,32,1000000US270531057002004,"Block 2004, Block Group 2, Census Tract 1057, Hennepin County, Minnesota",147,91,34,4,6,0,4,8,147,123,74,31,4,6,0,1,7,24,17,3,0,0,0,3,1
270531056002007,28,Steven's Square - Loring Heights,32,32,1000000US270531056002007,"Block 2007, Block Group 2, Census Tract 1056, Hennepin County, Minnesota",159,140,3,2,11,0,2,1,159,155,139,3,2,10,0,0,1,4,1,0,0,1,0,2,0
270531056002005,28,Steven's Square - Loring Heights,32,32,1000000US270531056002005,"Block 2005, Block Group 2, Census Tract 1056, Hennepin County, Minnesota",117,100,10,1,6,0,0,0,117,113,97,10,0,6,0,0,0,4,3,0,1,0,0,0,0
270531056002003,28,Steven's Square - Loring Heights,32,32,1000000US270531056002003,"Block 2003, Block Group 2, Census Tract 1056, Hennepin County, Minnesota",0,0,0,0,0,0,0,0,0,0,0,0,0,0,0,0,0,0,0,0,0,0,0,0,0
270531056002002,28,Steven's Square - Loring Heights,32,32,1000000US270531056002002,"Block 2002, Block Group 2, Census Tract 1056, Hennepin County, Minnesota",238,197,27,3,6,0,0,5,238,234,195,27,1,6,0,0,5,4,2,0,2,0,0,0,0
270531056002000,28,Steven's Square - Loring Heights,32,32,1000000US270531056002000,"Block 2000, Block Group 2, Census Tract 1056, Hennepin County, Minnesota",129,46,57,8,10,0,4,4,129,111,40,57,3,10,0,0,1,18,6,0,5,0,0,4,3
270531056002004,28,Steven's Square - Loring Heights,32,32,1000000US270531056002004,"Block 2004, Block Group 2, Census Tract 1056, Hennepin County, Minnesota",39,26,10,0,1,0,0,2,39,39,26,10,0,1,0,0,2,0,0,0,0,0,0,0,0
270531057003005,28,Steven's Square - Loring Heights,32,32,1000000US270531057003005,"Block 3005, Block Group 3, Census Tract 1057, Hennepin County, Minnesota",100,75,10,0,9,0,1,5,100,95,73,10,0,8,0,0,4,5,2,0,0,1,0,1,1
270531057003000,28,Steven's Square - Loring Heights,32,32,1000000US270531057003000,"Block 3000, Block Group 3, Census Tract 1057, Hennepin County, Minnesota",0,0,0,0,0,0,0,0,0,0,0,0,0,0,0,0,0,0,0,0,0,0,0,0,0
270531057001004,28,Steven's Square - Loring Heights,32,32,1000000US270531057001004,"Block 1004, Block Group 1, Census Tract 1057, Hennepin County, Minnesota",198,139,36,6,4,0,1,12,198,191,134,36,6,4,0,0,11,7,5,0,0,0,0,1,1
270531057001000,28,Steven's Square - Loring Heights,32,32,1000000US270531057001000,"Block 1000, Block Group 1, Census Tract 1057, Hennepin County, Minnesota",46,35,4,0,4,0,0,3,46,43,33,4,0,4,0,0,2,3,2,0,0,0,0,0,1
270531056002008,28,Steven's Square - Loring Heights,32,32,1000000US270531056002008,"Block 2008, Block Group 2, Census Tract 1056, Hennepin County, Minnesota",86,73,5,0,5,0,0,3,86,84,73,5,0,4,0,0,2,2,0,0,0,1,0,0,1
270531057003006,28,Steven's Square - Loring Heights,32,32,1000000US270531057003006,"Block 3006, Block Group 3, Census Tract 1057, Hennepin County, Minnesota",249,150,55,7,9,0,13,15,249,223,142,55,3,9,0,1,13,26,8,0,4,0,0,12,2
270531057003001,28,Steven's Square - Loring Heights,32,32,1000000US270531057003001,"Block 3001, Block Group 3, Census Tract 1057, Hennepin County, Minnesota",186,137,30,1,4,0,11,3,186,169,131,28,1,4,0,2,3,17,6,2,0,0,0,9,0
270531057003002,28,Steven's Square - Loring Heights,32,32,1000000US270531057003002,"Block 3002, Block Group 3, Census Tract 1057, Hennepin County, Minnesota",122,101,12,1,4,0,3,1,122,119,101,12,1,4,0,0,1,3,0,0,0,0,0,3,0
270531057002003,28,Steven's Square - Loring Heights,32,32,1000000US270531057002003,"Block 2003, Block Group 2, Census Tract 1057, Hennepin County, Minnesota",163,128,9,3,9,0,0,14,163,157,124,8,3,9,0,0,13,6,4,1,0,0,0,0,1
270531057002001,28,Steven's Square - Loring Heights,32,32,1000000US270531057002001,"Block 2001, Block Group 2, Census Tract 1057, Hennepin County, Minnesota",118,67,38,1,8,0,1,3,118,115,65,38,1,8,0,0,3,3,2,0,0,0,0,1,0
270531057001003,28,Steven's Square - Loring Heights,32,32,1000000US270531057001003,"Block 1003, Block Group 1, Census Tract 1057, Hennepin County, Minnesota",370,256,65,11,5,1,9,23,370,345,244,63,11,5,1,1,20,25,12,2,0,0,0,8,3
270531057002002,28,Steven's Square - Loring Heights,32,32,1000000US270531057002002,"Block 2002, Block Group 2, Census Tract 1057, Hennepin County, Minnesota",180,47,126,0,1,0,2,4,180,177,44,126,0,1,0,2,4,3,3,0,0,0,0,0,0
270531056003008,28,Steven's Square - Loring Heights,32,32,1000000US270531056003008,"Block 3008, Block Group 3, Census Tract 1056, Hennepin County, Minnesota",16,9,1,1,0,0,2,3,16,14,9,1,1,0,0,0,3,2,0,0,0,0,0,2,0
270531057003004,28,Steven's Square - Loring Heights,32,32,1000000US270531057003004,"Block 3004, Block Group 3, Census Tract 1057, Hennepin County, Minnesota",0,0,0,0,0,0,0,0,0,0,0,0,0,0,0,0,0,0,0,0,0,0,0,0,0
270530119982006,29,Minnehaha,81,81,1000000US270530119982006,"Block 2006, Block Group 2, Census Tract 119.98, Hennepin County, Minnesota",36,34,0,0,0,0,0,2,36,34,34,0,0,0,0,0,0,2,0,0,0,0,0,0,2
270530119983006,29,Minnehaha,81,81,1000000US270530119983006,"Block 3006, Block Group 3, Census Tract 119.98, Hennepin County, Minnesota",42,41,0,0,1,0,0,0,42,40,39,0,0,1,0,0,0,2,2,0,0,0,0,0,0
270530119983009,29,Minnehaha,81,81,1000000US270530119983009,"Block 3009, Block Group 3, Census Tract 119.98, Hennepin County, Minnesota",71,54,6,3,4,0,0,4,71,71,54,6,3,4,0,0,4,0,0,0,0,0,0,0,0
270530119983012,29,Minnehaha,81,81,1000000US270530119983012,"Block 3012, Block Group 3, Census Tract 119.98, Hennepin County, Minnesota",67,56,1,0,3,0,7,0,67,60,56,1,0,3,0,0,0,7,0,0,0,0,0,7,0
270530119983008,29,Minnehaha,81,81,1000000US270530119983008,"Block 3008, Block Group 3, Census Tract 119.98, Hennepin County, Minnesota",67,66,1,0,0,0,0,0,67,66,65,1,0,0,0,0,0,1,1,0,0,0,0,0,0
270530119983013,29,Minnehaha,81,81,1000000US270530119983013,"Block 3013, Block Group 3, Census Tract 119.98, Hennepin County, Minnesota",57,53,0,0,1,0,3,0,57,50,49,0,0,1,0,0,0,7,4,0,0,0,0,3,0
270530119983005,29,Minnehaha,81,81,1000000US270530119983005,"Block 3005, Block Group 3, Census Tract 119.98, Hennepin County, Minnesota",53,36,4,0,1,0,10,2,53,44,36,4,0,1,0,1,2,9,0,0,0,0,0,9,0
270530119981012,29,Minnehaha,81,81,1000000US270530119981012,"Block 1012, Block Group 1, Census Tract 119.98, Hennepin County, Minnesota",55,45,4,0,3,0,3,0,55,51,44,4,0,3,0,0,0,4,1,0,0,0,0,3,0
270530119981001,29,Minnehaha,81,81,1000000US270530119981001,"Block 1001, Block Group 1, Census Tract 119.98, Hennepin County, Minnesota",8,8,0,0,0,0,0,0,8,8,8,0,0,0,0,0,0,0,0,0,0,0,0,0,0
270530119981002,29,Minnehaha,81,81,1000000US270530119981002,"Block 1002, Block Group 1, Census Tract 119.98, Hennepin County, Minnesota",80,75,2,0,1,0,0,2,80,79,74,2,0,1,0,0,2,1,1,0,0,0,0,0,0
270530119981008,29,Minnehaha,81,81,1000000US270530119981008,"Block 1008, Block Group 1, Census Tract 119.98, Hennepin County, Minnesota",23,7,13,0,0,0,3,0,23,20,7,13,0,0,0,0,0,3,0,0,0,0,0,3,0
270530119981007,29,Minnehaha,81,81,1000000US270530119981007,"Block 1007, Block Group 1, Census Tract 119.98, Hennepin County, Minnesota",0,0,0,0,0,0,0,0,0,0,0,0,0,0,0,0,0,0,0,0,0,0,0,0,0
270530119984003,29,Minnehaha,81,81,1000000US270530119984003,"Block 4003, Block Group 4, Census Tract 119.98, Hennepin County, Minnesota",182,181,0,0,1,0,0,0,182,181,180,0,0,1,0,0,0,1,1,0,0,0,0,0,0
270530119984006,29,Minnehaha,81,81,1000000US270530119984006,"Block 4006, Block Group 4, Census Tract 119.98, Hennepin County, Minnesota",56,54,1,0,1,0,0,0,56,54,52,1,0,1,0,0,0,2,2,0,0,0,0,0,0
270530119985004,29,Minnehaha,81,81,1000000US270530119985004,"Block 5004, Block Group 5, Census Tract 119.98, Hennepin County, Minnesota",38,35,1,2,0,0,0,0,38,38,35,1,2,0,0,0,0,0,0,0,0,0,0,0,0
270530119982018,29,Minnehaha,81,81,1000000US270530119982018,"Block 2018, Block Group 2, Census Tract 119.98, Hennepin County, Minnesota",37,35,0,0,0,0,0,2,37,35,34,0,0,0,0,0,1,2,1,0,0,0,0,0,1
270530119981003,29,Minnehaha,81,81,1000000US270530119981003,"Block 1003, Block Group 1, Census Tract 119.98, Hennepin County, Minnesota",0,0,0,0,0,0,0,0,0,0,0,0,0,0,0,0,0,0,0,0,0,0,0,0,0
270530119983019,29,Minnehaha,81,81,1000000US270530119983019,"Block 3019, Block Group 3, Census Tract 119.98, Hennepin County, Minnesota",61,56,0,0,3,0,0,2,61,61,56,0,0,3,0,0,2,0,0,0,0,0,0,0,0
270530119985000,29,Minnehaha,81,81,1000000US270530119985000,"Block 5000, Block Group 5, Census Tract 119.98, Hennepin County, Minnesota",44,41,1,0,2,0,0,0,44,42,39,1,0,2,0,0,0,2,2,0,0,0,0,0,0
270530119985008,29,Minnehaha,81,81,1000000US270530119985008,"Block 5008, Block Group 5, Census Tract 119.98, Hennepin County, Minnesota",43,33,3,0,3,0,0,4,43,43,33,3,0,3,0,0,4,0,0,0,0,0,0,0,0
270530119983002,29,Minnehaha,81,81,1000000US270530119983002,"Block 3002, Block Group 3, Census Tract 119.98, Hennepin County, Minnesota",71,50,7,0,5,0,5,4,71,66,50,7,0,5,0,0,4,5,0,0,0,0,0,5,0
270530119981011,29,Minnehaha,81,81,1000000US270530119981011,"Block 1011, Block Group 1, Census Tract 119.98, Hennepin County, Minnesota",57,42,3,7,1,0,0,4,57,55,41,3,7,1,0,0,3,2,1,0,0,0,0,0,1
270530119981014,29,Minnehaha,81,81,1000000US270530119981014,"Block 1014, Block Group 1, Census Tract 119.98, Hennepin County, Minnesota",45,40,2,0,1,0,0,2,45,45,40,2,0,1,0,0,2,0,0,0,0,0,0,0,0
270530119981010,29,Minnehaha,81,81,1000000US270530119981010,"Block 1010, Block Group 1, Census Tract 119.98, Hennepin County, Minnesota",50,36,10,0,3,0,1,0,50,48,35,10,0,3,0,0,0,2,1,0,0,0,0,1,0
270530119985001,29,Minnehaha,81,81,1000000US270530119985001,"Block 5001, Block Group 5, Census Tract 119.98, Hennepin County, Minnesota",41,39,0,2,0,0,0,0,41,40,38,0,2,0,0,0,0,1,1,0,0,0,0,0,0
270530119981009,29,Minnehaha,81,81,1000000US270530119981009,"Block 1009, Block Group 1, Census Tract 119.98, Hennepin County, Minnesota",182,78,57,8,9,0,11,19,182,144,68,56,6,9,0,0,5,38,10,1,2,0,0,11,14
270530119984000,29,Minnehaha,81,81,1000000US270530119984000,"Block 4000, Block Group 4, Census Tract 119.98, Hennepin County, Minnesota",61,41,1,6,0,0,13,0,61,48,41,1,6,0,0,0,0,13,0,0,0,0,0,13,0
270530119983016,29,Minnehaha,81,81,1000000US270530119983016,"Block 3016, Block Group 3, Census Tract 119.98, Hennepin County, Minnesota",62,54,1,0,0,0,7,0,62,55,54,1,0,0,0,0,0,7,0,0,0,0,0,7,0
270530119982017,29,Minnehaha,81,81,1000000US270530119982017,"Block 2017, Block Group 2, Census Tract 119.98, Hennepin County, Minnesota",26,18,6,0,0,0,0,2,26,26,18,6,0,0,0,0,2,0,0,0,0,0,0,0,0
270530119985007,29,Minnehaha,81,81,1000000US270530119985007,"Block 5007, Block Group 5, Census Tract 119.98, Hennepin County, Minnesota",46,43,0,0,3,0,0,0,46,45,42,0,0,3,0,0,0,1,1,0,0,0,0,0,0
270530119985011,29,Minnehaha,81,81,1000000US270530119985011,"Block 5011, Block Group 5, Census Tract 119.98, Hennepin County, Minnesota",12,11,0,0,1,0,0,0,12,12,11,0,0,1,0,0,0,0,0,0,0,0,0,0,0
270530119983021,29,Minnehaha,81,81,1000000US270530119983021,"Block 3021, Block Group 3, Census Tract 119.98, Hennepin County, Minnesota",61,52,2,0,0,0,0,7,61,59,50,2,0,0,0,0,7,2,2,0,0,0,0,0,0
270530119981006,29,Minnehaha,81,81,1000000US270530119981006,"Block 1006, Block Group 1, Census Tract 119.98, Hennepin County, Minnesota",50,48,1,0,1,0,0,0,50,46,45,0,0,1,0,0,0,4,3,1,0,0,0,0,0
270530119981013,29,Minnehaha,81,81,1000000US270530119981013,"Block 1013, Block Group 1, Census Tract 119.98, Hennepin County, Minnesota",63,57,1,0,5,0,0,0,63,62,56,1,0,5,0,0,0,1,1,0,0,0,0,0,0
270530119982000,29,Minnehaha,81,81,1000000US270530119982000,"Block 2000, Block Group 2, Census Tract 119.98, Hennepin County, Minnesota",0,0,0,0,0,0,0,0,0,0,0,0,0,0,0,0,0,0,0,0,0,0,0,0,0
270530119982012,29,Minnehaha,81,81,1000000US270530119982012,"Block 2012, Block Group 2, Census Tract 119.98, Hennepin County, Minnesota",51,46,3,0,0,0,0,2,51,49,44,3,0,0,0,0,2,2,2,0,0,0,0,0,0
270530119984005,29,Minnehaha,81,81,1000000US270530119984005,"Block 4005, Block Group 4, Census Tract 119.98, Hennepin County, Minnesota",41,35,1,0,0,0,0,5,41,39,33,1,0,0,0,0,5,2,2,0,0,0,0,0,0
270530119983010,29,Minnehaha,81,81,1000000US270530119983010,"Block 3010, Block Group 3, Census Tract 119.98, Hennepin County, Minnesota",84,80,0,0,0,0,2,2,84,81,79,0,0,0,0,0,2,3,1,0,0,0,0,2,0
270530119983011,29,Minnehaha,81,81,1000000US270530119983011,"Block 3011, Block Group 3, Census Tract 119.98, Hennepin County, Minnesota",62,49,1,5,0,0,7,0,62,54,48,1,5,0,0,0,0,8,1,0,0,0,0,7,0
270530119982008,29,Minnehaha,81,81,1000000US270530119982008,"Block 2008, Block Group 2, Census Tract 119.98, Hennepin County, Minnesota",55,49,5,0,0,0,0,1,55,53,47,5,0,0,0,0,1,2,2,0,0,0,0,0,0
270530119982004,29,Minnehaha,81,81,1000000US270530119982004,"Block 2004, Block Group 2, Census Tract 119.98, Hennepin County, Minnesota",0,0,0,0,0,0,0,0,0,0,0,0,0,0,0,0,0,0,0,0,0,0,0,0,0
270530119982003,29,Minnehaha,81,81,1000000US270530119982003,"Block 2003, Block Group 2, Census Tract 119.98, Hennepin County, Minnesota",28,28,0,0,0,0,0,0,28,28,28,0,0,0,0,0,0,0,0,0,0,0,0,0,0
270530119982007,29,Minnehaha,81,81,1000000US270530119982007,"Block 2007, Block Group 2, Census Tract 119.98, Hennepin County, Minnesota",50,45,1,0,3,0,0,1,50,49,44,1,0,3,0,0,1,1,1,0,0,0,0,0,0
270530119982013,29,Minnehaha,81,81,1000000US270530119982013,"Block 2013, Block Group 2, Census Tract 119.98, Hennepin County, Minnesota",40,36,0,0,2,0,1,1,40,39,36,0,0,2,0,0,1,1,0,0,0,0,0,1,0
270530119982001,29,Minnehaha,81,81,1000000US270530119982001,"Block 2001, Block Group 2, Census Tract 119.98, Hennepin County, Minnesota",0,0,0,0,0,0,0,0,0,0,0,0,0,0,0,0,0,0,0,0,0,0,0,0,0
270530119982011,29,Minnehaha,81,81,1000000US270530119982011,"Block 2011, Block Group 2, Census Tract 119.98, Hennepin County, Minnesota",69,47,10,6,3,0,0,3,69,69,47,10,6,3,0,0,3,0,0,0,0,0,0,0,0
270530119982009,29,Minnehaha,81,81,1000000US270530119982009,"Block 2009, Block Group 2, Census Tract 119.98, Hennepin County, Minnesota",44,42,0,0,1,0,1,0,44,42,41,0,0,1,0,0,0,2,1,0,0,0,0,1,0
270530119982002,29,Minnehaha,81,81,1000000US270530119982002,"Block 2002, Block Group 2, Census Tract 119.98, Hennepin County, Minnesota",0,0,0,0,0,0,0,0,0,0,0,0,0,0,0,0,0,0,0,0,0,0,0,0,0
270530119984004,29,Minnehaha,81,81,1000000US270530119984004,"Block 4004, Block Group 4, Census Tract 119.98, Hennepin County, Minnesota",51,31,19,0,0,0,0,1,51,51,31,19,0,0,0,0,1,0,0,0,0,0,0,0,0
270530119982014,29,Minnehaha,81,81,1000000US270530119982014,"Block 2014, Block Group 2, Census Tract 119.98, Hennepin County, Minnesota",49,45,0,0,0,0,0,4,49,49,45,0,0,0,0,0,4,0,0,0,0,0,0,0,0
270530119982010,29,Minnehaha,81,81,1000000US270530119982010,"Block 2010, Block Group 2, Census Tract 119.98, Hennepin County, Minnesota",60,48,8,0,0,0,0,4,60,56,44,8,0,0,0,0,4,4,4,0,0,0,0,0,0
270530119982015,29,Minnehaha,81,81,1000000US270530119982015,"Block 2015, Block Group 2, Census Tract 119.98, Hennepin County, Minnesota",48,41,1,0,2,0,0,4,48,48,41,1,0,2,0,0,4,0,0,0,0,0,0,0,0
270530119983014,29,Minnehaha,81,81,1000000US270530119983014,"Block 3014, Block Group 3, Census Tract 119.98, Hennepin County, Minnesota",57,52,0,0,0,0,0,5,57,56,51,0,0,0,0,0,5,1,1,0,0,0,0,0,0
270530119985006,29,Minnehaha,81,81,1000000US270530119985006,"Block 5006, Block Group 5, Census Tract 119.98, Hennepin County, Minnesota",93,87,3,0,1,0,1,1,93,91,87,3,0,0,0,0,1,2,0,0,0,1,0,1,0
270530119983004,29,Minnehaha,81,81,1000000US270530119983004,"Block 3004, Block Group 3, Census Tract 119.98, Hennepin County, Minnesota",27,21,1,1,0,0,0,4,27,24,18,1,1,0,0,0,4,3,3,0,0,0,0,0,0
270530119985009,29,Minnehaha,81,81,1000000US270530119985009,"Block 5009, Block Group 5, Census Tract 119.98, Hennepin County, Minnesota",50,43,1,0,0,0,0,6,50,49,42,1,0,0,0,0,6,1,1,0,0,0,0,0,0
270530119983000,29,Minnehaha,81,81,1000000US270530119983000,"Block 3000, Block Group 3, Census Tract 119.98, Hennepin County, Minnesota",60,55,1,2,0,0,0,2,60,52,48,1,1,0,0,0,2,8,7,0,1,0,0,0,0
270531105002034,29,Minnehaha,81,81,1000000US270531105002034,"Block 2034, Block Group 2, Census Tract 1105, Hennepin County, Minnesota",0,0,0,0,0,0,0,0,0,0,0,0,0,0,0,0,0,0,0,0,0,0,0,0,0
270530119984002,29,Minnehaha,81,81,1000000US270530119984002,"Block 4002, Block Group 4, Census Tract 119.98, Hennepin County, Minnesota",56,46,3,6,1,0,0,0,56,54,44,3,6,1,0,0,0,2,2,0,0,0,0,0,0
270530119984008,29,Minnehaha,81,81,1000000US270530119984008,"Block 4008, Block Group 4, Census Tract 119.98, Hennepin County, Minnesota",52,46,2,0,2,0,0,2,52,52,46,2,0,2,0,0,2,0,0,0,0,0,0,0,0
270530119985003,29,Minnehaha,81,81,1000000US270530119985003,"Block 5003, Block Group 5, Census Tract 119.98, Hennepin County, Minnesota",48,45,0,0,0,0,3,0,48,44,44,0,0,0,0,0,0,4,1,0,0,0,0,3,0
270530119983001,29,Minnehaha,81,81,1000000US270530119983001,"Block 3001, Block Group 3, Census Tract 119.98, Hennepin County, Minnesota",68,48,6,1,0,0,10,3,68,57,46,6,1,0,0,1,3,11,2,0,0,0,0,9,0
270531105002029,29,Minnehaha,81,81,1000000US270531105002029,"Block 2029, Block Group 2, Census Tract 1105, Hennepin County, Minnesota",0,0,0,0,0,0,0,0,0,0,0,0,0,0,0,0,0,0,0,0,0,0,0,0,0
270530119981005,29,Minnehaha,81,81,1000000US270530119981005,"Block 1005, Block Group 1, Census Tract 119.98, Hennepin County, Minnesota",150,113,17,1,7,0,4,8,150,142,109,17,1,7,0,0,8,8,4,0,0,0,0,4,0
270530119982005,29,Minnehaha,81,81,1000000US270530119982005,"Block 2005, Block Group 2, Census Tract 119.98, Hennepin County, Minnesota",0,0,0,0,0,0,0,0,0,0,0,0,0,0,0,0,0,0,0,0,0,0,0,0,0
270530119981004,29,Minnehaha,81,81,1000000US270530119981004,"Block 1004, Block Group 1, Census Tract 119.98, Hennepin County, Minnesota",1,0,0,0,0,0,0,1,1,1,0,0,0,0,0,0,1,0,0,0,0,0,0,0,0
270530119984007,29,Minnehaha,81,81,1000000US270530119984007,"Block 4007, Block Group 4, Census Tract 119.98, Hennepin County, Minnesota",52,51,0,0,0,0,0,1,52,52,51,0,0,0,0,0,1,0,0,0,0,0,0,0,0
270530119984009,29,Minnehaha,81,81,1000000US270530119984009,"Block 4009, Block Group 4, Census Tract 119.98, Hennepin County, Minnesota",57,45,0,0,12,0,0,0,57,57,45,0,0,12,0,0,0,0,0,0,0,0,0,0,0
270530119985005,29,Minnehaha,81,81,1000000US270530119985005,"Block 5005, Block Group 5, Census Tract 119.98, Hennepin County, Minnesota",47,38,1,6,0,0,2,0,47,47,38,1,6,0,0,2,0,0,0,0,0,0,0,0,0
270530119982016,29,Minnehaha,81,81,1000000US270530119982016,"Block 2016, Block Group 2, Census Tract 119.98, Hennepin County, Minnesota",45,39,0,1,0,0,2,3,45,39,39,0,0,0,0,0,0,6,0,0,1,0,0,2,3
270530119985002,29,Minnehaha,81,81,1000000US270530119985002,"Block 5002, Block Group 5, Census Tract 119.98, Hennepin County, Minnesota",40,36,0,0,0,0,0,4,40,37,35,0,0,0,0,0,2,3,1,0,0,0,0,0,2
270530119983003,29,Minnehaha,81,81,1000000US270530119983003,"Block 3003, Block Group 3, Census Tract 119.98, Hennepin County, Minnesota",59,43,0,6,1,0,7,2,59,49,40,0,6,1,0,0,2,10,3,0,0,0,0,7,0
270530119983017,29,Minnehaha,81,81,1000000US270530119983017,"Block 3017, Block Group 3, Census Tract 119.98, Hennepin County, Minnesota",52,48,1,0,3,0,0,0,52,51,48,1,0,2,0,0,0,1,0,0,0,1,0,0,0
270530119983018,29,Minnehaha,81,81,1000000US270530119983018,"Block 3018, Block Group 3, Census Tract 119.98, Hennepin County, Minnesota",64,58,1,0,2,0,0,3,64,64,58,1,0,2,0,0,3,0,0,0,0,0,0,0,0
270530119985010,29,Minnehaha,81,81,1000000US270530119985010,"Block 5010, Block Group 5, Census Tract 119.98, Hennepin County, Minnesota",53,46,3,0,2,0,0,2,53,51,44,3,0,2,0,0,2,2,2,0,0,0,0,0,0
270530119981000,29,Minnehaha,81,81,1000000US270530119981000,"Block 1000, Block Group 1, Census Tract 119.98, Hennepin County, Minnesota",59,37,17,2,1,0,1,1,59,50,30,17,2,1,0,0,0,9,7,0,0,0,0,1,1
270530119983020,29,Minnehaha,81,81,1000000US270530119983020,"Block 3020, Block Group 3, Census Tract 119.98, Hennepin County, Minnesota",62,53,2,0,0,0,7,0,62,55,53,2,0,0,0,0,0,7,0,0,0,0,0,7,0
270530119984001,29,Minnehaha,81,81,1000000US270530119984001,"Block 4001, Block Group 4, Census Tract 119.98, Hennepin County, Minnesota",44,35,0,3,1,0,2,3,44,38,35,0,0,1,0,2,0,6,0,0,3,0,0,0,3
270530119983007,29,Minnehaha,81,81,1000000US270530119983007,"Block 3007, Block Group 3, Census Tract 119.98, Hennepin County, Minnesota",61,53,4,0,2,0,1,1,61,59,52,4,0,2,0,0,1,2,1,0,0,0,0,1,0
270530119983015,29,Minnehaha,81,81,1000000US270530119983015,"Block 3015, Block Group 3, Census Tract 119.98, Hennepin County, Minnesota",44,42,0,0,1,0,1,0,44,36,35,0,0,1,0,0,0,8,7,0,0,0,0,1,0
270530120033001,30,Diamond Lake,82,82,1000000US270530120033001,"Block 3001, Block Group 3, Census Tract 120.03, Hennepin County, Minnesota",69,58,0,0,2,0,3,6,69,63,58,0,0,2,0,0,3,6,0,0,0,0,0,3,3
270530120033005,30,Diamond Lake,82,82,1000000US270530120033005,"Block 3005, Block Group 3, Census Tract 120.03, Hennepin County, Minnesota",35,27,1,0,0,0,6,1,35,28,26,1,0,0,0,0,1,7,1,0,0,0,0,6,0
270530120033019,30,Diamond Lake,82,82,1000000US270530120033019,"Block 3019, Block Group 3, Census Tract 120.03, Hennepin County, Minnesota",130,112,6,0,0,0,4,8,130,122,111,6,0,0,0,0,5,8,1,0,0,0,0,4,3
270530117043037,30,Diamond Lake,82,82,1000000US270530117043037,"Block 3037, Block Group 3, Census Tract 117.04, Hennepin County, Minnesota",7,7,0,0,0,0,0,0,7,2,2,0,0,0,0,0,0,5,5,0,0,0,0,0,0
270530120033015,30,Diamond Lake,82,82,1000000US270530120033015,"Block 3015, Block Group 3, Census Tract 120.03, Hennepin County, Minnesota",66,66,0,0,0,0,0,0,66,66,66,0,0,0,0,0,0,0,0,0,0,0,0,0,0
270530120033012,30,Diamond Lake,82,82,1000000US270530120033012,"Block 3012, Block Group 3, Census Tract 120.03, Hennepin County, Minnesota",53,47,3,0,1,0,0,2,53,53,47,3,0,1,0,0,2,0,0,0,0,0,0,0,0
270530120032001,30,Diamond Lake,82,82,1000000US270530120032001,"Block 2001, Block Group 2, Census Tract 120.03, Hennepin County, Minnesota",56,42,2,0,4,0,8,0,56,48,42,2,0,4,0,0,0,8,0,0,0,0,0,8,0
270530117043007,30,Diamond Lake,82,82,1000000US270530117043007,"Block 3007, Block Group 3, Census Tract 117.04, Hennepin County, Minnesota",62,52,6,0,1,0,0,3,62,62,52,6,0,1,0,0,3,0,0,0,0,0,0,0,0
270530117043016,30,Diamond Lake,82,82,1000000US270530117043016,"Block 3016, Block Group 3, Census Tract 117.04, Hennepin County, Minnesota",62,41,8,1,1,0,10,1,62,49,38,8,1,1,0,0,1,13,3,0,0,0,0,10,0
270530117043013,30,Diamond Lake,82,82,1000000US270530117043013,"Block 3013, Block Group 3, Census Tract 117.04, Hennepin County, Minnesota",53,47,6,0,0,0,0,0,53,53,47,6,0,0,0,0,0,0,0,0,0,0,0,0,0
270530117043022,30,Diamond Lake,82,82,1000000US270530117043022,"Block 3022, Block Group 3, Census Tract 117.04, Hennepin County, Minnesota",60,50,8,0,0,0,0,2,60,52,42,8,0,0,0,0,2,8,8,0,0,0,0,0,0
270530117041012,30,Diamond Lake,82,82,1000000US270530117041012,"Block 1012, Block Group 1, Census Tract 117.04, Hennepin County, Minnesota",0,0,0,0,0,0,0,0,0,0,0,0,0,0,0,0,0,0,0,0,0,0,0,0,0
270530120032002,30,Diamond Lake,82,82,1000000US270530120032002,"Block 2002, Block Group 2, Census Tract 120.03, Hennepin County, Minnesota",47,40,3,0,1,0,0,3,47,47,40,3,0,1,0,0,3,0,0,0,0,0,0,0,0
270530117043010,30,Diamond Lake,82,82,1000000US270530117043010,"Block 3010, Block Group 3, Census Tract 117.04, Hennepin County, Minnesota",62,52,0,0,6,0,1,3,62,58,49,0,0,6,0,0,3,4,3,0,0,0,0,1,0
270530117043017,30,Diamond Lake,82,82,1000000US270530117043017,"Block 3017, Block Group 3, Census Tract 117.04, Hennepin County, Minnesota",43,38,2,0,0,0,0,3,43,43,38,2,0,0,0,0,3,0,0,0,0,0,0,0,0
270530117043004,30,Diamond Lake,82,82,1000000US270530117043004,"Block 3004, Block Group 3, Census Tract 117.04, Hennepin County, Minnesota",72,66,5,1,0,0,0,0,72,71,65,5,1,0,0,0,0,1,1,0,0,0,0,0,0
270530117043027,30,Diamond Lake,82,82,1000000US270530117043027,"Block 3027, Block Group 3, Census Tract 117.04, Hennepin County, Minnesota",46,38,2,0,0,0,0,6,46,46,38,2,0,0,0,0,6,0,0,0,0,0,0,0,0
270530117043019,30,Diamond Lake,82,82,1000000US270530117043019,"Block 3019, Block Group 3, Census Tract 117.04, Hennepin County, Minnesota",59,40,8,0,10,0,0,1,59,56,37,8,0,10,0,0,1,3,3,0,0,0,0,0,0
270530120033008,30,Diamond Lake,82,82,1000000US270530120033008,"Block 3008, Block Group 3, Census Tract 120.03, Hennepin County, Minnesota",110,93,11,0,1,0,0,5,110,110,93,11,0,1,0,0,5,0,0,0,0,0,0,0,0
270530120033014,30,Diamond Lake,82,82,1000000US270530120033014,"Block 3014, Block Group 3, Census Tract 120.03, Hennepin County, Minnesota",56,55,0,0,0,0,0,1,56,54,53,0,0,0,0,0,1,2,2,0,0,0,0,0,0
270530117042011,30,Diamond Lake,82,82,1000000US270530117042011,"Block 2011, Block Group 2, Census Tract 117.04, Hennepin County, Minnesota",66,46,12,0,5,0,0,3,66,66,46,12,0,5,0,0,3,0,0,0,0,0,0,0,0
270530117043012,30,Diamond Lake,82,82,1000000US270530117043012,"Block 3012, Block Group 3, Census Tract 117.04, Hennepin County, Minnesota",61,56,5,0,0,0,0,0,61,61,56,5,0,0,0,0,0,0,0,0,0,0,0,0,0
270530117043020,30,Diamond Lake,82,82,1000000US270530117043020,"Block 3020, Block Group 3, Census Tract 117.04, Hennepin County, Minnesota",28,12,10,0,6,0,0,0,28,28,12,10,0,6,0,0,0,0,0,0,0,0,0,0,0
270530120032013,30,Diamond Lake,82,82,1000000US270530120032013,"Block 2013, Block Group 2, Census Tract 120.03, Hennepin County, Minnesota",45,25,10,0,0,0,10,0,45,35,25,10,0,0,0,0,0,10,0,0,0,0,0,10,0
270530117043018,30,Diamond Lake,82,82,1000000US270530117043018,"Block 3018, Block Group 3, Census Tract 117.04, Hennepin County, Minnesota",54,38,5,0,0,0,7,4,54,45,36,5,0,0,0,0,4,9,2,0,0,0,0,7,0
270530117043025,30,Diamond Lake,82,82,1000000US270530117043025,"Block 3025, Block Group 3, Census Tract 117.04, Hennepin County, Minnesota",45,23,12,8,0,0,0,2,45,45,23,12,8,0,0,0,2,0,0,0,0,0,0,0,0
270530117041009,30,Diamond Lake,82,82,1000000US270530117041009,"Block 1009, Block Group 1, Census Tract 117.04, Hennepin County, Minnesota",24,22,2,0,0,0,0,0,24,24,22,2,0,0,0,0,0,0,0,0,0,0,0,0,0
270530117041018,30,Diamond Lake,82,82,1000000US270530117041018,"Block 1018, Block Group 1, Census Tract 117.04, Hennepin County, Minnesota",74,57,1,0,0,0,5,11,74,62,52,1,0,0,0,0,9,12,5,0,0,0,0,5,2
270530120033011,30,Diamond Lake,82,82,1000000US270530120033011,"Block 3011, Block Group 3, Census Tract 120.03, Hennepin County, Minnesota",73,62,3,0,4,0,0,4,73,72,61,3,0,4,0,0,4,1,1,0,0,0,0,0,0
270530117042010,30,Diamond Lake,82,82,1000000US270530117042010,"Block 2010, Block Group 2, Census Tract 117.04, Hennepin County, Minnesota",62,59,3,0,0,0,0,0,62,62,59,3,0,0,0,0,0,0,0,0,0,0,0,0,0
270530120032000,30,Diamond Lake,82,82,1000000US270530120032000,"Block 2000, Block Group 2, Census Tract 120.03, Hennepin County, Minnesota",74,53,1,0,7,0,13,0,74,60,52,1,0,7,0,0,0,14,1,0,0,0,0,13,0
270530117043005,30,Diamond Lake,82,82,1000000US270530117043005,"Block 3005, Block Group 3, Census Tract 117.04, Hennepin County, Minnesota",57,50,3,0,0,0,0,4,57,56,49,3,0,0,0,0,4,1,1,0,0,0,0,0,0
270530117041013,30,Diamond Lake,82,82,1000000US270530117041013,"Block 1013, Block Group 1, Census Tract 117.04, Hennepin County, Minnesota",48,48,0,0,0,0,0,0,48,47,47,0,0,0,0,0,0,1,1,0,0,0,0,0,0
270530117041015,30,Diamond Lake,82,82,1000000US270530117041015,"Block 1015, Block Group 1, Census Tract 117.04, Hennepin County, Minnesota",51,44,0,0,2,0,0,5,51,51,44,0,0,2,0,0,5,0,0,0,0,0,0,0,0
270530117041016,30,Diamond Lake,82,82,1000000US270530117041016,"Block 1016, Block Group 1, Census Tract 117.04, Hennepin County, Minnesota",58,49,2,0,2,0,1,4,58,49,42,2,0,2,0,1,2,9,7,0,0,0,0,0,2
270530117043023,30,Diamond Lake,82,82,1000000US270530117043023,"Block 3023, Block Group 3, Census Tract 117.04, Hennepin County, Minnesota",52,41,5,1,1,0,0,4,52,45,34,5,1,1,0,0,4,7,7,0,0,0,0,0,0
270530117041010,30,Diamond Lake,82,82,1000000US270530117041010,"Block 1010, Block Group 1, Census Tract 117.04, Hennepin County, Minnesota",156,109,21,0,3,0,16,7,156,138,107,21,0,3,0,0,7,18,2,0,0,0,0,16,0
270530117041003,30,Diamond Lake,82,82,1000000US270530117041003,"Block 1003, Block Group 1, Census Tract 117.04, Hennepin County, Minnesota",67,60,2,0,3,0,0,2,67,67,60,2,0,3,0,0,2,0,0,0,0,0,0,0,0
270530117041001,30,Diamond Lake,82,82,1000000US270530117041001,"Block 1001, Block Group 1, Census Tract 117.04, Hennepin County, Minnesota",52,48,1,0,2,0,1,0,52,51,48,1,0,2,0,0,0,1,0,0,0,0,0,1,0
270530117043000,30,Diamond Lake,82,82,1000000US270530117043000,"Block 3000, Block Group 3, Census Tract 117.04, Hennepin County, Minnesota",0,0,0,0,0,0,0,0,0,0,0,0,0,0,0,0,0,0,0,0,0,0,0,0,0
270530120033003,30,Diamond Lake,82,82,1000000US270530120033003,"Block 3003, Block Group 3, Census Tract 120.03, Hennepin County, Minnesota",145,130,4,0,6,0,0,5,145,144,130,4,0,6,0,0,4,1,0,0,0,0,0,0,1
270530117042005,30,Diamond Lake,82,82,1000000US270530117042005,"Block 2005, Block Group 2, Census Tract 117.04, Hennepin County, Minnesota",53,49,4,0,0,0,0,0,53,51,47,4,0,0,0,0,0,2,2,0,0,0,0,0,0
270530117043001,30,Diamond Lake,82,82,1000000US270530117043001,"Block 3001, Block Group 3, Census Tract 117.04, Hennepin County, Minnesota",0,0,0,0,0,0,0,0,0,0,0,0,0,0,0,0,0,0,0,0,0,0,0,0,0
270530120033009,30,Diamond Lake,82,82,1000000US270530120033009,"Block 3009, Block Group 3, Census Tract 120.03, Hennepin County, Minnesota",0,0,0,0,0,0,0,0,0,0,0,0,0,0,0,0,0,0,0,0,0,0,0,0,0
270530120032008,30,Diamond Lake,82,82,1000000US270530120032008,"Block 2008, Block Group 2, Census Tract 120.03, Hennepin County, Minnesota",75,55,4,0,3,0,9,4,75,43,32,4,0,3,0,2,2,32,23,0,0,0,0,7,2
270530120032011,30,Diamond Lake,82,82,1000000US270530120032011,"Block 2011, Block Group 2, Census Tract 120.03, Hennepin County, Minnesota",52,41,10,0,0,0,1,0,52,48,38,10,0,0,0,0,0,4,3,0,0,0,0,1,0
270530120033000,30,Diamond Lake,82,82,1000000US270530120033000,"Block 3000, Block Group 3, Census Tract 120.03, Hennepin County, Minnesota",95,77,13,2,0,0,0,3,95,94,77,13,2,0,0,0,2,1,0,0,0,0,0,0,1
270530117042002,30,Diamond Lake,82,82,1000000US270530117042002,"Block 2002, Block Group 2, Census Tract 117.04, Hennepin County, Minnesota",61,56,0,0,1,0,2,2,61,58,55,0,0,1,0,0,2,3,1,0,0,0,0,2,0
270530117043036,30,Diamond Lake,82,82,1000000US270530117043036,"Block 3036, Block Group 3, Census Tract 117.04, Hennepin County, Minnesota",63,43,4,0,7,0,9,0,63,54,43,4,0,7,0,0,0,9,0,0,0,0,0,9,0
270530120033004,30,Diamond Lake,82,82,1000000US270530120033004,"Block 3004, Block Group 3, Census Tract 120.03, Hennepin County, Minnesota",205,180,11,2,0,0,5,7,205,194,174,11,2,0,0,0,7,11,6,0,0,0,0,5,0
270530117041000,30,Diamond Lake,82,82,1000000US270530117041000,"Block 1000, Block Group 1, Census Tract 117.04, Hennepin County, Minnesota",25,17,4,1,0,0,0,3,25,24,16,4,1,0,0,0,3,1,1,0,0,0,0,0,0
270530117042001,30,Diamond Lake,82,82,1000000US270530117042001,"Block 2001, Block Group 2, Census Tract 117.04, Hennepin County, Minnesota",70,68,1,0,1,0,0,0,70,70,68,1,0,1,0,0,0,0,0,0,0,0,0,0,0
270530117042006,30,Diamond Lake,82,82,1000000US270530117042006,"Block 2006, Block Group 2, Census Tract 117.04, Hennepin County, Minnesota",65,64,1,0,0,0,0,0,65,65,64,1,0,0,0,0,0,0,0,0,0,0,0,0,0
270530117041005,30,Diamond Lake,82,82,1000000US270530117041005,"Block 1005, Block Group 1, Census Tract 117.04, Hennepin County, Minnesota",66,60,2,0,0,0,0,4,66,66,60,2,0,0,0,0,4,0,0,0,0,0,0,0,0
270530117041006,30,Diamond Lake,82,82,1000000US270530117041006,"Block 1006, Block Group 1, Census Tract 117.04, Hennepin County, Minnesota",70,67,3,0,0,0,0,0,70,70,67,3,0,0,0,0,0,0,0,0,0,0,0,0,0
270530117041002,30,Diamond Lake,82,82,1000000US270530117041002,"Block 1002, Block Group 1, Census Tract 117.04, Hennepin County, Minnesota",65,57,5,0,1,0,0,2,65,65,57,5,0,1,0,0,2,0,0,0,0,0,0,0,0
270530120033013,30,Diamond Lake,82,82,1000000US270530120033013,"Block 3013, Block Group 3, Census Tract 120.03, Hennepin County, Minnesota",64,47,13,0,1,0,0,3,64,64,47,13,0,1,0,0,3,0,0,0,0,0,0,0,0
270530117043008,30,Diamond Lake,82,82,1000000US270530117043008,"Block 3008, Block Group 3, Census Tract 117.04, Hennepin County, Minnesota",58,52,1,3,0,0,2,0,58,57,52,1,3,0,0,1,0,1,0,0,0,0,0,1,0
270530117043009,30,Diamond Lake,82,82,1000000US270530117043009,"Block 3009, Block Group 3, Census Tract 117.04, Hennepin County, Minnesota",66,47,8,0,0,1,6,4,66,58,46,8,0,0,1,0,3,8,1,0,0,0,0,6,1
270530117043011,30,Diamond Lake,82,82,1000000US270530117043011,"Block 3011, Block Group 3, Census Tract 117.04, Hennepin County, Minnesota",51,47,0,0,0,0,4,0,51,47,47,0,0,0,0,0,0,4,0,0,0,0,0,4,0
270530117043003,30,Diamond Lake,82,82,1000000US270530117043003,"Block 3003, Block Group 3, Census Tract 117.04, Hennepin County, Minnesota",0,0,0,0,0,0,0,0,0,0,0,0,0,0,0,0,0,0,0,0,0,0,0,0,0
270530120032010,30,Diamond Lake,82,82,1000000US270530120032010,"Block 2010, Block Group 2, Census Tract 120.03, Hennepin County, Minnesota",40,33,4,0,3,0,0,0,40,40,33,4,0,3,0,0,0,0,0,0,0,0,0,0,0
270530120032007,30,Diamond Lake,82,82,1000000US270530120032007,"Block 2007, Block Group 2, Census Tract 120.03, Hennepin County, Minnesota",60,49,4,0,1,0,0,6,60,55,49,4,0,1,0,0,1,5,0,0,0,0,0,0,5
270530117043014,30,Diamond Lake,82,82,1000000US270530117043014,"Block 3014, Block Group 3, Census Tract 117.04, Hennepin County, Minnesota",57,48,3,0,0,0,0,6,57,57,48,3,0,0,0,0,6,0,0,0,0,0,0,0,0
270530117043021,30,Diamond Lake,82,82,1000000US270530117043021,"Block 3021, Block Group 3, Census Tract 117.04, Hennepin County, Minnesota",54,38,6,0,1,0,7,2,54,47,38,6,0,1,0,0,2,7,0,0,0,0,0,7,0
270530117041017,30,Diamond Lake,82,82,1000000US270530117041017,"Block 1017, Block Group 1, Census Tract 117.04, Hennepin County, Minnesota",79,53,14,0,1,0,9,2,79,62,47,14,0,1,0,0,0,17,6,0,0,0,0,9,2
270530117041008,30,Diamond Lake,82,82,1000000US270530117041008,"Block 1008, Block Group 1, Census Tract 117.04, Hennepin County, Minnesota",70,63,3,1,0,2,0,1,70,67,62,3,0,0,2,0,0,3,1,0,1,0,0,0,1
270530120032003,30,Diamond Lake,82,82,1000000US270530120032003,"Block 2003, Block Group 2, Census Tract 120.03, Hennepin County, Minnesota",41,26,11,3,1,0,0,0,41,38,25,9,3,1,0,0,0,3,1,2,0,0,0,0,0
270530120033016,30,Diamond Lake,82,82,1000000US270530120033016,"Block 3016, Block Group 3, Census Tract 120.03, Hennepin County, Minnesota",40,39,0,0,0,0,0,1,40,37,36,0,0,0,0,0,1,3,3,0,0,0,0,0,0
270530120032004,30,Diamond Lake,82,82,1000000US270530120032004,"Block 2004, Block Group 2, Census Tract 120.03, Hennepin County, Minnesota",53,38,14,0,0,1,0,0,53,50,36,13,0,0,1,0,0,3,2,1,0,0,0,0,0
270530120034003,30,Diamond Lake,82,82,1000000US270530120034003,"Block 4003, Block Group 4, Census Tract 120.03, Hennepin County, Minnesota",0,0,0,0,0,0,0,0,0,0,0,0,0,0,0,0,0,0,0,0,0,0,0,0,0
270530120033018,30,Diamond Lake,82,82,1000000US270530120033018,"Block 3018, Block Group 3, Census Tract 120.03, Hennepin County, Minnesota",23,17,6,0,0,0,0,0,23,22,16,6,0,0,0,0,0,1,1,0,0,0,0,0,0
270530120033017,30,Diamond Lake,82,82,1000000US270530120033017,"Block 3017, Block Group 3, Census Tract 120.03, Hennepin County, Minnesota",61,46,4,0,6,0,0,5,61,55,40,4,0,6,0,0,5,6,6,0,0,0,0,0,0
270530120033006,30,Diamond Lake,82,82,1000000US270530120033006,"Block 3006, Block Group 3, Census Tract 120.03, Hennepin County, Minnesota",52,47,4,0,1,0,0,0,52,51,46,4,0,1,0,0,0,1,1,0,0,0,0,0,0
270530120033007,30,Diamond Lake,82,82,1000000US270530120033007,"Block 3007, Block Group 3, Census Tract 120.03, Hennepin County, Minnesota",82,66,14,0,0,0,2,0,82,76,62,14,0,0,0,0,0,6,4,0,0,0,0,2,0
270530117042007,30,Diamond Lake,82,82,1000000US270530117042007,"Block 2007, Block Group 2, Census Tract 117.04, Hennepin County, Minnesota",70,60,3,0,2,0,0,5,70,67,57,3,0,2,0,0,5,3,3,0,0,0,0,0,0
270530117041004,30,Diamond Lake,82,82,1000000US270530117041004,"Block 1004, Block Group 1, Census Tract 117.04, Hennepin County, Minnesota",44,37,5,0,0,0,0,2,44,43,36,5,0,0,0,0,2,1,1,0,0,0,0,0,0
270530117041007,30,Diamond Lake,82,82,1000000US270530117041007,"Block 1007, Block Group 1, Census Tract 117.04, Hennepin County, Minnesota",56,56,0,0,0,0,0,0,56,55,55,0,0,0,0,0,0,1,1,0,0,0,0,0,0
270530120033002,30,Diamond Lake,82,82,1000000US270530120033002,"Block 3002, Block Group 3, Census Tract 120.03, Hennepin County, Minnesota",53,40,13,0,0,0,0,0,53,49,40,9,0,0,0,0,0,4,0,4,0,0,0,0,0
270530117042003,30,Diamond Lake,82,82,1000000US270530117042003,"Block 2003, Block Group 2, Census Tract 117.04, Hennepin County, Minnesota",68,55,5,0,1,0,1,6,68,65,54,5,0,1,0,0,5,3,1,0,0,0,0,1,1
270530120032005,30,Diamond Lake,82,82,1000000US270530120032005,"Block 2005, Block Group 2, Census Tract 120.03, Hennepin County, Minnesota",51,34,9,0,0,3,4,1,51,51,34,9,0,0,3,4,1,0,0,0,0,0,0,0,0
270530120032006,30,Diamond Lake,82,82,1000000US270530120032006,"Block 2006, Block Group 2, Census Tract 120.03, Hennepin County, Minnesota",55,46,5,1,0,0,0,3,55,54,46,5,0,0,0,0,3,1,0,0,1,0,0,0,0
270530120032012,30,Diamond Lake,82,82,1000000US270530120032012,"Block 2012, Block Group 2, Census Tract 120.03, Hennepin County, Minnesota",43,24,15,0,2,0,0,2,43,43,24,15,0,2,0,0,2,0,0,0,0,0,0,0,0
270530117043024,30,Diamond Lake,82,82,1000000US270530117043024,"Block 3024, Block Group 3, Census Tract 117.04, Hennepin County, Minnesota",14,14,0,0,0,0,0,0,14,14,14,0,0,0,0,0,0,0,0,0,0,0,0,0,0
270530120032009,30,Diamond Lake,82,82,1000000US270530120032009,"Block 2009, Block Group 2, Census Tract 120.03, Hennepin County, Minnesota",113,68,20,0,0,0,23,2,113,79,58,19,0,0,0,0,2,34,10,1,0,0,0,23,0
270530120032014,30,Diamond Lake,82,82,1000000US270530120032014,"Block 2014, Block Group 2, Census Tract 120.03, Hennepin County, Minnesota",29,23,4,0,0,0,0,2,29,28,22,4,0,0,0,0,2,1,1,0,0,0,0,0,0
270530117043006,30,Diamond Lake,82,82,1000000US270530117043006,"Block 3006, Block Group 3, Census Tract 117.04, Hennepin County, Minnesota",55,49,4,0,1,0,0,1,55,55,49,4,0,1,0,0,1,0,0,0,0,0,0,0,0
270530117042009,30,Diamond Lake,82,82,1000000US270530117042009,"Block 2009, Block Group 2, Census Tract 117.04, Hennepin County, Minnesota",67,55,4,0,4,0,3,1,67,62,54,4,0,4,0,0,0,5,1,0,0,0,0,3,1
270530117043026,30,Diamond Lake,82,82,1000000US270530117043026,"Block 3026, Block Group 3, Census Tract 117.04, Hennepin County, Minnesota",55,44,7,0,0,0,2,2,55,46,40,5,0,0,0,0,1,9,4,2,0,0,0,2,1
270530120033010,30,Diamond Lake,82,82,1000000US270530120033010,"Block 3010, Block Group 3, Census Tract 120.03, Hennepin County, Minnesota",66,60,2,0,2,0,0,2,66,66,60,2,0,2,0,0,2,0,0,0,0,0,0,0,0
270530117043015,30,Diamond Lake,82,82,1000000US270530117043015,"Block 3015, Block Group 3, Census Tract 117.04, Hennepin County, Minnesota",47,36,3,0,6,0,0,2,47,47,36,3,0,6,0,0,2,0,0,0,0,0,0,0,0
270530117042008,30,Diamond Lake,82,82,1000000US270530117042008,"Block 2008, Block Group 2, Census Tract 117.04, Hennepin County, Minnesota",57,51,2,0,2,0,0,2,57,56,50,2,0,2,0,0,2,1,1,0,0,0,0,0,0
270530117041014,30,Diamond Lake,82,82,1000000US270530117041014,"Block 1014, Block Group 1, Census Tract 117.04, Hennepin County, Minnesota",58,55,1,0,2,0,0,0,58,58,55,1,0,2,0,0,0,0,0,0,0,0,0,0,0
270530117043038,30,Diamond Lake,82,82,1000000US270530117043038,"Block 3038, Block Group 3, Census Tract 117.04, Hennepin County, Minnesota",30,19,0,0,7,0,4,0,30,26,19,0,0,7,0,0,0,4,0,0,0,0,0,4,0
270530117041011,30,Diamond Lake,82,82,1000000US270530117041011,"Block 1011, Block Group 1, Census Tract 117.04, Hennepin County, Minnesota",0,0,0,0,0,0,0,0,0,0,0,0,0,0,0,0,0,0,0,0,0,0,0,0,0
270530117042004,30,Diamond Lake,82,82,1000000US270530117042004,"Block 2004, Block Group 2, Census Tract 117.04, Hennepin County, Minnesota",25,23,0,0,1,0,0,1,25,25,23,0,0,1,0,0,1,0,0,0,0,0,0,0,0
270530117042000,30,Diamond Lake,82,82,1000000US270530117042000,"Block 2000, Block Group 2, Census Tract 117.04, Hennepin County, Minnesota",68,67,1,0,0,0,0,0,68,64,63,1,0,0,0,0,0,4,4,0,0,0,0,0,0
270531076003006,31,Cooper,62,62,1000000US270531076003006,"Block 3006, Block Group 3, Census Tract 1076, Hennepin County, Minnesota",63,48,2,5,3,0,0,5,63,61,48,2,4,3,0,0,4,2,0,0,1,0,0,0,1
270531076003007,31,Cooper,62,62,1000000US270531076003007,"Block 3007, Block Group 3, Census Tract 1076, Hennepin County, Minnesota",72,57,2,0,3,0,0,10,72,68,53,2,0,3,0,0,10,4,4,0,0,0,0,0,0
270531076004005,31,Cooper,62,62,1000000US270531076004005,"Block 4005, Block Group 4, Census Tract 1076, Hennepin County, Minnesota",66,58,1,0,0,0,7,0,66,59,58,1,0,0,0,0,0,7,0,0,0,0,0,7,0
270531076002015,31,Cooper,62,62,1000000US270531076002015,"Block 2015, Block Group 2, Census Tract 1076, Hennepin County, Minnesota",66,55,0,0,11,0,0,0,66,66,55,0,0,11,0,0,0,0,0,0,0,0,0,0,0
270531076003008,31,Cooper,62,62,1000000US270531076003008,"Block 3008, Block Group 3, Census Tract 1076, Hennepin County, Minnesota",57,56,0,0,0,0,1,0,57,54,54,0,0,0,0,0,0,3,2,0,0,0,0,1,0
270531076002021,31,Cooper,62,62,1000000US270531076002021,"Block 2021, Block Group 2, Census Tract 1076, Hennepin County, Minnesota",49,40,1,0,2,0,5,1,49,45,40,1,0,2,0,1,1,4,0,0,0,0,0,4,0
270531076002020,31,Cooper,62,62,1000000US270531076002020,"Block 2020, Block Group 2, Census Tract 1076, Hennepin County, Minnesota",49,46,1,2,0,0,0,0,49,49,46,1,2,0,0,0,0,0,0,0,0,0,0,0,0
270531076002019,31,Cooper,62,62,1000000US270531076002019,"Block 2019, Block Group 2, Census Tract 1076, Hennepin County, Minnesota",60,55,0,1,2,0,0,2,60,59,54,0,1,2,0,0,2,1,1,0,0,0,0,0,0
270531076001001,31,Cooper,62,62,1000000US270531076001001,"Block 1001, Block Group 1, Census Tract 1076, Hennepin County, Minnesota",0,0,0,0,0,0,0,0,0,0,0,0,0,0,0,0,0,0,0,0,0,0,0,0,0
270531076001013,31,Cooper,62,62,1000000US270531076001013,"Block 1013, Block Group 1, Census Tract 1076, Hennepin County, Minnesota",29,26,3,0,0,0,0,0,29,29,26,3,0,0,0,0,0,0,0,0,0,0,0,0,0
270531076004011,31,Cooper,62,62,1000000US270531076004011,"Block 4011, Block Group 4, Census Tract 1076, Hennepin County, Minnesota",54,50,4,0,0,0,0,0,54,54,50,4,0,0,0,0,0,0,0,0,0,0,0,0,0
270531076003005,31,Cooper,62,62,1000000US270531076003005,"Block 3005, Block Group 3, Census Tract 1076, Hennepin County, Minnesota",46,36,1,4,0,0,0,5,46,46,36,1,4,0,0,0,5,0,0,0,0,0,0,0,0
270531076003002,31,Cooper,62,62,1000000US270531076003002,"Block 3002, Block Group 3, Census Tract 1076, Hennepin County, Minnesota",46,40,4,0,1,0,0,1,46,43,37,4,0,1,0,0,1,3,3,0,0,0,0,0,0
270531076002018,31,Cooper,62,62,1000000US270531076002018,"Block 2018, Block Group 2, Census Tract 1076, Hennepin County, Minnesota",7,7,0,0,0,0,0,0,7,6,6,0,0,0,0,0,0,1,1,0,0,0,0,0,0
270531076001006,31,Cooper,62,62,1000000US270531076001006,"Block 1006, Block Group 1, Census Tract 1076, Hennepin County, Minnesota",76,51,8,3,3,0,6,5,76,65,49,8,3,3,0,0,2,11,2,0,0,0,0,6,3
270531076001008,31,Cooper,62,62,1000000US270531076001008,"Block 1008, Block Group 1, Census Tract 1076, Hennepin County, Minnesota",65,59,0,0,3,0,0,3,65,65,59,0,0,3,0,0,3,0,0,0,0,0,0,0,0
270531076001017,31,Cooper,62,62,1000000US270531076001017,"Block 1017, Block Group 1, Census Tract 1076, Hennepin County, Minnesota",62,55,5,0,0,0,0,2,62,61,54,5,0,0,0,0,2,1,1,0,0,0,0,0,0
270531076001000,31,Cooper,62,62,1000000US270531076001000,"Block 1000, Block Group 1, Census Tract 1076, Hennepin County, Minnesota",0,0,0,0,0,0,0,0,0,0,0,0,0,0,0,0,0,0,0,0,0,0,0,0,0
270531076001015,31,Cooper,62,62,1000000US270531076001015,"Block 1015, Block Group 1, Census Tract 1076, Hennepin County, Minnesota",70,62,0,2,4,0,0,2,70,70,62,0,2,4,0,0,2,0,0,0,0,0,0,0,0
270531076002005,31,Cooper,62,62,1000000US270531076002005,"Block 2005, Block Group 2, Census Tract 1076, Hennepin County, Minnesota",29,27,0,0,2,0,0,0,29,29,27,0,0,2,0,0,0,0,0,0,0,0,0,0,0
270531076004008,31,Cooper,62,62,1000000US270531076004008,"Block 4008, Block Group 4, Census Tract 1076, Hennepin County, Minnesota",79,58,0,5,2,0,12,2,79,62,57,0,1,2,0,0,2,17,1,0,4,0,0,12,0
270531076001007,31,Cooper,62,62,1000000US270531076001007,"Block 1007, Block Group 1, Census Tract 1076, Hennepin County, Minnesota",62,60,0,0,0,0,1,1,62,61,60,0,0,0,0,0,1,1,0,0,0,0,0,1,0
270531076001019,31,Cooper,62,62,1000000US270531076001019,"Block 1019, Block Group 1, Census Tract 1076, Hennepin County, Minnesota",0,0,0,0,0,0,0,0,0,0,0,0,0,0,0,0,0,0,0,0,0,0,0,0,0
270531076003004,31,Cooper,62,62,1000000US270531076003004,"Block 3004, Block Group 3, Census Tract 1076, Hennepin County, Minnesota",59,48,0,4,5,0,0,2,59,56,46,0,4,5,0,0,1,3,2,0,0,0,0,0,1
270531076004004,31,Cooper,62,62,1000000US270531076004004,"Block 4004, Block Group 4, Census Tract 1076, Hennepin County, Minnesota",61,46,0,8,2,0,0,5,61,57,45,0,5,2,0,0,5,4,1,0,3,0,0,0,0
270531076004006,31,Cooper,62,62,1000000US270531076004006,"Block 4006, Block Group 4, Census Tract 1076, Hennepin County, Minnesota",75,52,4,2,7,0,9,1,75,61,48,3,2,7,0,0,1,14,4,1,0,0,0,9,0
270531076002023,31,Cooper,62,62,1000000US270531076002023,"Block 2023, Block Group 2, Census Tract 1076, Hennepin County, Minnesota",57,49,1,2,0,0,0,5,57,54,49,1,0,0,0,0,4,3,0,0,2,0,0,0,1
270531076003011,31,Cooper,62,62,1000000US270531076003011,"Block 3011, Block Group 3, Census Tract 1076, Hennepin County, Minnesota",61,57,0,2,2,0,0,0,61,60,57,0,2,1,0,0,0,1,0,0,0,1,0,0,0
270531076002003,31,Cooper,62,62,1000000US270531076002003,"Block 2003, Block Group 2, Census Tract 1076, Hennepin County, Minnesota",121,89,20,0,5,0,1,6,121,117,86,20,0,5,0,0,6,4,3,0,0,0,0,1,0
270531076001004,31,Cooper,62,62,1000000US270531076001004,"Block 1004, Block Group 1, Census Tract 1076, Hennepin County, Minnesota",46,42,1,0,1,0,0,2,46,43,39,1,0,1,0,0,2,3,3,0,0,0,0,0,0
270531076001012,31,Cooper,62,62,1000000US270531076001012,"Block 1012, Block Group 1, Census Tract 1076, Hennepin County, Minnesota",62,58,0,0,0,0,0,4,62,61,58,0,0,0,0,0,3,1,0,0,0,0,0,0,1
270531076001002,31,Cooper,62,62,1000000US270531076001002,"Block 1002, Block Group 1, Census Tract 1076, Hennepin County, Minnesota",0,0,0,0,0,0,0,0,0,0,0,0,0,0,0,0,0,0,0,0,0,0,0,0,0
270531076004002,31,Cooper,62,62,1000000US270531076004002,"Block 4002, Block Group 4, Census Tract 1076, Hennepin County, Minnesota",57,56,0,1,0,0,0,0,57,57,56,0,1,0,0,0,0,0,0,0,0,0,0,0,0
270531076004000,31,Cooper,62,62,1000000US270531076004000,"Block 4000, Block Group 4, Census Tract 1076, Hennepin County, Minnesota",64,63,0,0,1,0,0,0,64,64,63,0,0,1,0,0,0,0,0,0,0,0,0,0,0
270531076004009,31,Cooper,62,62,1000000US270531076004009,"Block 4009, Block Group 4, Census Tract 1076, Hennepin County, Minnesota",65,57,5,1,0,0,0,2,65,61,55,5,1,0,0,0,0,4,2,0,0,0,0,0,2
270531076004010,31,Cooper,62,62,1000000US270531076004010,"Block 4010, Block Group 4, Census Tract 1076, Hennepin County, Minnesota",55,45,0,5,0,0,0,5,55,51,45,0,1,0,0,0,5,4,0,0,4,0,0,0,0
270531076002000,31,Cooper,62,62,1000000US270531076002000,"Block 2000, Block Group 2, Census Tract 1076, Hennepin County, Minnesota",0,0,0,0,0,0,0,0,0,0,0,0,0,0,0,0,0,0,0,0,0,0,0,0,0
270531076004001,31,Cooper,62,62,1000000US270531076004001,"Block 4001, Block Group 4, Census Tract 1076, Hennepin County, Minnesota",47,43,0,0,4,0,0,0,47,47,43,0,0,4,0,0,0,0,0,0,0,0,0,0,0
270531076002002,31,Cooper,62,62,1000000US270531076002002,"Block 2002, Block Group 2, Census Tract 1076, Hennepin County, Minnesota",27,19,4,0,0,0,4,0,27,23,19,4,0,0,0,0,0,4,0,0,0,0,0,4,0
270531076002001,31,Cooper,62,62,1000000US270531076002001,"Block 2001, Block Group 2, Census Tract 1076, Hennepin County, Minnesota",0,0,0,0,0,0,0,0,0,0,0,0,0,0,0,0,0,0,0,0,0,0,0,0,0
270531076002006,31,Cooper,62,62,1000000US270531076002006,"Block 2006, Block Group 2, Census Tract 1076, Hennepin County, Minnesota",90,83,2,0,5,0,0,0,90,90,83,2,0,5,0,0,0,0,0,0,0,0,0,0,0
270531076002009,31,Cooper,62,62,1000000US270531076002009,"Block 2009, Block Group 2, Census Tract 1076, Hennepin County, Minnesota",59,53,5,0,0,0,0,1,59,58,52,5,0,0,0,0,1,1,1,0,0,0,0,0,0
270531076002013,31,Cooper,62,62,1000000US270531076002013,"Block 2013, Block Group 2, Census Tract 1076, Hennepin County, Minnesota",48,47,1,0,0,0,0,0,48,45,44,1,0,0,0,0,0,3,3,0,0,0,0,0,0
270531076002012,31,Cooper,62,62,1000000US270531076002012,"Block 2012, Block Group 2, Census Tract 1076, Hennepin County, Minnesota",64,45,7,7,3,0,0,2,64,64,45,7,7,3,0,0,2,0,0,0,0,0,0,0,0
270531076003003,31,Cooper,62,62,1000000US270531076003003,"Block 3003, Block Group 3, Census Tract 1076, Hennepin County, Minnesota",31,23,1,0,4,0,0,3,31,28,21,1,0,3,0,0,3,3,2,0,0,1,0,0,0
270531076003001,31,Cooper,62,62,1000000US270531076003001,"Block 3001, Block Group 3, Census Tract 1076, Hennepin County, Minnesota",32,32,0,0,0,0,0,0,32,31,31,0,0,0,0,0,0,1,1,0,0,0,0,0,0
270531076001003,31,Cooper,62,62,1000000US270531076001003,"Block 1003, Block Group 1, Census Tract 1076, Hennepin County, Minnesota",90,78,1,3,2,0,0,6,90,90,78,1,3,2,0,0,6,0,0,0,0,0,0,0,0
270531076001009,31,Cooper,62,62,1000000US270531076001009,"Block 1009, Block Group 1, Census Tract 1076, Hennepin County, Minnesota",57,53,4,0,0,0,0,0,57,57,53,4,0,0,0,0,0,0,0,0,0,0,0,0,0
270531076004003,31,Cooper,62,62,1000000US270531076004003,"Block 4003, Block Group 4, Census Tract 1076, Hennepin County, Minnesota",65,61,1,1,0,0,1,1,65,62,59,1,1,0,0,0,1,3,2,0,0,0,0,1,0
270531076001018,31,Cooper,62,62,1000000US270531076001018,"Block 1018, Block Group 1, Census Tract 1076, Hennepin County, Minnesota",55,41,2,0,4,2,3,3,55,49,41,2,0,3,0,0,3,6,0,0,0,1,2,3,0
270531076002008,31,Cooper,62,62,1000000US270531076002008,"Block 2008, Block Group 2, Census Tract 1076, Hennepin County, Minnesota",41,33,0,0,6,0,1,1,41,39,32,0,0,6,0,0,1,2,1,0,0,0,0,1,0
270531076002025,31,Cooper,62,62,1000000US270531076002025,"Block 2025, Block Group 2, Census Tract 1076, Hennepin County, Minnesota",40,38,0,0,2,0,0,0,40,40,38,0,0,2,0,0,0,0,0,0,0,0,0,0,0
270531076002016,31,Cooper,62,62,1000000US270531076002016,"Block 2016, Block Group 2, Census Tract 1076, Hennepin County, Minnesota",69,62,0,0,6,0,0,1,69,69,62,0,0,6,0,0,1,0,0,0,0,0,0,0,0
270531076002004,31,Cooper,62,62,1000000US270531076002004,"Block 2004, Block Group 2, Census Tract 1076, Hennepin County, Minnesota",19,19,0,0,0,0,0,0,19,18,18,0,0,0,0,0,0,1,1,0,0,0,0,0,0
270531076002010,31,Cooper,62,62,1000000US270531076002010,"Block 2010, Block Group 2, Census Tract 1076, Hennepin County, Minnesota",65,55,5,1,2,0,2,0,65,60,52,5,1,2,0,0,0,5,3,0,0,0,0,2,0
270531076002014,31,Cooper,62,62,1000000US270531076002014,"Block 2014, Block Group 2, Census Tract 1076, Hennepin County, Minnesota",69,63,2,0,0,0,2,2,69,66,61,2,0,0,0,1,2,3,2,0,0,0,0,1,0
270531076002024,31,Cooper,62,62,1000000US270531076002024,"Block 2024, Block Group 2, Census Tract 1076, Hennepin County, Minnesota",41,31,3,0,0,0,7,0,41,32,29,3,0,0,0,0,0,9,2,0,0,0,0,7,0
270531076003009,31,Cooper,62,62,1000000US270531076003009,"Block 3009, Block Group 3, Census Tract 1076, Hennepin County, Minnesota",77,63,8,0,0,0,0,6,77,68,59,7,0,0,0,0,2,9,4,1,0,0,0,0,4
270531076002017,31,Cooper,62,62,1000000US270531076002017,"Block 2017, Block Group 2, Census Tract 1076, Hennepin County, Minnesota",47,46,0,0,1,0,0,0,47,47,46,0,0,1,0,0,0,0,0,0,0,0,0,0,0
270531076003010,31,Cooper,62,62,1000000US270531076003010,"Block 3010, Block Group 3, Census Tract 1076, Hennepin County, Minnesota",48,43,1,0,2,0,0,2,48,48,43,1,0,2,0,0,2,0,0,0,0,0,0,0,0
270531076003000,31,Cooper,62,62,1000000US270531076003000,"Block 3000, Block Group 3, Census Tract 1076, Hennepin County, Minnesota",38,30,0,2,2,0,0,4,38,34,30,0,0,2,0,0,2,4,0,0,2,0,0,0,2
270531076001010,31,Cooper,62,62,1000000US270531076001010,"Block 1010, Block Group 1, Census Tract 1076, Hennepin County, Minnesota",57,48,0,0,4,0,0,5,57,56,47,0,0,4,0,0,5,1,1,0,0,0,0,0,0
270531076001011,31,Cooper,62,62,1000000US270531076001011,"Block 1011, Block Group 1, Census Tract 1076, Hennepin County, Minnesota",81,71,0,4,6,0,0,0,81,73,67,0,0,6,0,0,0,8,4,0,4,0,0,0,0
270531076002007,31,Cooper,62,62,1000000US270531076002007,"Block 2007, Block Group 2, Census Tract 1076, Hennepin County, Minnesota",6,6,0,0,0,0,0,0,6,6,6,0,0,0,0,0,0,0,0,0,0,0,0,0,0
270531076002022,31,Cooper,62,62,1000000US270531076002022,"Block 2022, Block Group 2, Census Tract 1076, Hennepin County, Minnesota",54,45,1,2,2,0,0,4,54,39,35,0,0,2,0,0,2,15,10,1,2,0,0,0,2
270531076001005,31,Cooper,62,62,1000000US270531076001005,"Block 1005, Block Group 1, Census Tract 1076, Hennepin County, Minnesota",47,46,0,0,0,0,0,1,47,47,46,0,0,0,0,0,1,0,0,0,0,0,0,0,0
270531076001016,31,Cooper,62,62,1000000US270531076001016,"Block 1016, Block Group 1, Census Tract 1076, Hennepin County, Minnesota",63,62,0,0,0,0,0,1,63,62,61,0,0,0,0,0,1,1,1,0,0,0,0,0,0
270531076001014,31,Cooper,62,62,1000000US270531076001014,"Block 1014, Block Group 1, Census Tract 1076, Hennepin County, Minnesota",0,0,0,0,0,0,0,0,0,0,0,0,0,0,0,0,0,0,0,0,0,0,0,0,0
270531076004007,31,Cooper,62,62,1000000US270531076004007,"Block 4007, Block Group 4, Census Tract 1076, Hennepin County, Minnesota",80,60,7,0,2,0,1,10,80,70,57,6,0,2,0,0,5,10,3,1,0,0,0,1,5
270531108003009,32,Tangletown,65,65,1000000US270531108003009,"Block 3009, Block Group 3, Census Tract 1108, Hennepin County, Minnesota",54,50,1,0,0,0,0,3,54,54,50,1,0,0,0,0,3,0,0,0,0,0,0,0,0
270531115003014,32,Tangletown,65,65,1000000US270531115003014,"Block 3014, Block Group 3, Census Tract 1115, Hennepin County, Minnesota",53,49,1,0,1,0,0,2,53,52,48,1,0,1,0,0,2,1,1,0,0,0,0,0,0
270531115003002,32,Tangletown,65,65,1000000US270531115003002,"Block 3002, Block Group 3, Census Tract 1115, Hennepin County, Minnesota",57,50,3,0,0,0,1,3,57,51,49,1,0,0,0,0,1,6,1,2,0,0,0,1,2
270531115003012,32,Tangletown,65,65,1000000US270531115003012,"Block 3012, Block Group 3, Census Tract 1115, Hennepin County, Minnesota",50,50,0,0,0,0,0,0,50,50,50,0,0,0,0,0,0,0,0,0,0,0,0,0,0
270531115003016,32,Tangletown,65,65,1000000US270531115003016,"Block 3016, Block Group 3, Census Tract 1115, Hennepin County, Minnesota",39,37,1,0,1,0,0,0,39,38,36,1,0,1,0,0,0,1,1,0,0,0,0,0,0
270531108002010,32,Tangletown,65,65,1000000US270531108002010,"Block 2010, Block Group 2, Census Tract 1108, Hennepin County, Minnesota",54,44,10,0,0,0,0,0,54,49,39,10,0,0,0,0,0,5,5,0,0,0,0,0,0
270531108002009,32,Tangletown,65,65,1000000US270531108002009,"Block 2009, Block Group 2, Census Tract 1108, Hennepin County, Minnesota",68,61,4,0,1,0,0,2,68,64,57,4,0,1,0,0,2,4,4,0,0,0,0,0,0
270531108002001,32,Tangletown,65,65,1000000US270531108002001,"Block 2001, Block Group 2, Census Tract 1108, Hennepin County, Minnesota",61,39,3,0,7,2,6,4,61,55,39,3,0,7,2,0,4,6,0,0,0,0,0,6,0
270531115001004,32,Tangletown,65,65,1000000US270531115001004,"Block 1004, Block Group 1, Census Tract 1115, Hennepin County, Minnesota",0,0,0,0,0,0,0,0,0,0,0,0,0,0,0,0,0,0,0,0,0,0,0,0,0
270531108002007,32,Tangletown,65,65,1000000US270531108002007,"Block 2007, Block Group 2, Census Tract 1108, Hennepin County, Minnesota",72,72,0,0,0,0,0,0,72,72,72,0,0,0,0,0,0,0,0,0,0,0,0,0,0
270531115003001,32,Tangletown,65,65,1000000US270531115003001,"Block 3001, Block Group 3, Census Tract 1115, Hennepin County, Minnesota",74,54,7,0,2,0,0,11,74,71,53,7,0,2,0,0,9,3,1,0,0,0,0,0,2
270531115001000,32,Tangletown,65,65,1000000US270531115001000,"Block 1000, Block Group 1, Census Tract 1115, Hennepin County, Minnesota",142,130,1,0,1,0,0,10,142,137,126,1,0,1,0,0,9,5,4,0,0,0,0,0,1
270531115003017,32,Tangletown,65,65,1000000US270531115003017,"Block 3017, Block Group 3, Census Tract 1115, Hennepin County, Minnesota",35,35,0,0,0,0,0,0,35,35,35,0,0,0,0,0,0,0,0,0,0,0,0,0,0
270531115001027,32,Tangletown,65,65,1000000US270531115001027,"Block 1027, Block Group 1, Census Tract 1115, Hennepin County, Minnesota",94,92,2,0,0,0,0,0,94,88,87,1,0,0,0,0,0,6,5,1,0,0,0,0,0
270531115005005,32,Tangletown,65,65,1000000US270531115005005,"Block 5005, Block Group 5, Census Tract 1115, Hennepin County, Minnesota",0,0,0,0,0,0,0,0,0,0,0,0,0,0,0,0,0,0,0,0,0,0,0,0,0
270531115001028,32,Tangletown,65,65,1000000US270531115001028,"Block 1028, Block Group 1, Census Tract 1115, Hennepin County, Minnesota",0,0,0,0,0,0,0,0,0,0,0,0,0,0,0,0,0,0,0,0,0,0,0,0,0
270531115003011,32,Tangletown,65,65,1000000US270531115003011,"Block 3011, Block Group 3, Census Tract 1115, Hennepin County, Minnesota",0,0,0,0,0,0,0,0,0,0,0,0,0,0,0,0,0,0,0,0,0,0,0,0,0
270531115001007,32,Tangletown,65,65,1000000US270531115001007,"Block 1007, Block Group 1, Census Tract 1115, Hennepin County, Minnesota",74,71,2,0,1,0,0,0,74,74,71,2,0,1,0,0,0,0,0,0,0,0,0,0,0
270531115001015,32,Tangletown,65,65,1000000US270531115001015,"Block 1015, Block Group 1, Census Tract 1115, Hennepin County, Minnesota",43,43,0,0,0,0,0,0,43,43,43,0,0,0,0,0,0,0,0,0,0,0,0,0,0
270531115001025,32,Tangletown,65,65,1000000US270531115001025,"Block 1025, Block Group 1, Census Tract 1115, Hennepin County, Minnesota",22,20,2,0,0,0,0,0,22,22,20,2,0,0,0,0,0,0,0,0,0,0,0,0,0
270531115005004,32,Tangletown,65,65,1000000US270531115005004,"Block 5004, Block Group 5, Census Tract 1115, Hennepin County, Minnesota",0,0,0,0,0,0,0,0,0,0,0,0,0,0,0,0,0,0,0,0,0,0,0,0,0
270531115001029,32,Tangletown,65,65,1000000US270531115001029,"Block 1029, Block Group 1, Census Tract 1115, Hennepin County, Minnesota",37,29,0,0,3,0,1,4,37,34,29,0,0,3,0,0,2,3,0,0,0,0,0,1,2
270531115001024,32,Tangletown,65,65,1000000US270531115001024,"Block 1024, Block Group 1, Census Tract 1115, Hennepin County, Minnesota",51,51,0,0,0,0,0,0,51,51,51,0,0,0,0,0,0,0,0,0,0,0,0,0,0
270531115005008,32,Tangletown,65,65,1000000US270531115005008,"Block 5008, Block Group 5, Census Tract 1115, Hennepin County, Minnesota",0,0,0,0,0,0,0,0,0,0,0,0,0,0,0,0,0,0,0,0,0,0,0,0,0
270531115005001,32,Tangletown,65,65,1000000US270531115005001,"Block 5001, Block Group 5, Census Tract 1115, Hennepin County, Minnesota",0,0,0,0,0,0,0,0,0,0,0,0,0,0,0,0,0,0,0,0,0,0,0,0,0
270531115003000,32,Tangletown,65,65,1000000US270531115003000,"Block 3000, Block Group 3, Census Tract 1115, Hennepin County, Minnesota",0,0,0,0,0,0,0,0,0,0,0,0,0,0,0,0,0,0,0,0,0,0,0,0,0
270531115001006,32,Tangletown,65,65,1000000US270531115001006,"Block 1006, Block Group 1, Census Tract 1115, Hennepin County, Minnesota",84,60,12,1,0,0,3,8,84,75,59,11,1,0,0,0,4,9,1,1,0,0,0,3,4
270531115005012,32,Tangletown,65,65,1000000US270531115005012,"Block 5012, Block Group 5, Census Tract 1115, Hennepin County, Minnesota",61,58,2,0,1,0,0,0,61,55,52,2,0,1,0,0,0,6,6,0,0,0,0,0,0
270531115005007,32,Tangletown,65,65,1000000US270531115005007,"Block 5007, Block Group 5, Census Tract 1115, Hennepin County, Minnesota",248,161,60,3,4,0,6,14,248,238,158,60,3,4,0,0,13,10,3,0,0,0,0,6,1
270531115001005,32,Tangletown,65,65,1000000US270531115001005,"Block 1005, Block Group 1, Census Tract 1115, Hennepin County, Minnesota",42,35,6,0,0,0,1,0,42,41,35,6,0,0,0,0,0,1,0,0,0,0,0,1,0
270531115005000,32,Tangletown,65,65,1000000US270531115005000,"Block 5000, Block Group 5, Census Tract 1115, Hennepin County, Minnesota",0,0,0,0,0,0,0,0,0,0,0,0,0,0,0,0,0,0,0,0,0,0,0,0,0
270531115005002,32,Tangletown,65,65,1000000US270531115005002,"Block 5002, Block Group 5, Census Tract 1115, Hennepin County, Minnesota",80,77,3,0,0,0,0,0,80,80,77,3,0,0,0,0,0,0,0,0,0,0,0,0,0
270531115005006,32,Tangletown,65,65,1000000US270531115005006,"Block 5006, Block Group 5, Census Tract 1115, Hennepin County, Minnesota",100,55,33,0,1,0,3,8,100,84,46,31,0,1,0,0,6,16,9,2,0,0,0,3,2
270531115001021,32,Tangletown,65,65,1000000US270531115001021,"Block 1021, Block Group 1, Census Tract 1115, Hennepin County, Minnesota",0,0,0,0,0,0,0,0,0,0,0,0,0,0,0,0,0,0,0,0,0,0,0,0,0
270531115001017,32,Tangletown,65,65,1000000US270531115001017,"Block 1017, Block Group 1, Census Tract 1115, Hennepin County, Minnesota",0,0,0,0,0,0,0,0,0,0,0,0,0,0,0,0,0,0,0,0,0,0,0,0,0
270531115001002,32,Tangletown,65,65,1000000US270531115001002,"Block 1002, Block Group 1, Census Tract 1115, Hennepin County, Minnesota",0,0,0,0,0,0,0,0,0,0,0,0,0,0,0,0,0,0,0,0,0,0,0,0,0
270531115005011,32,Tangletown,65,65,1000000US270531115005011,"Block 5011, Block Group 5, Census Tract 1115, Hennepin County, Minnesota",0,0,0,0,0,0,0,0,0,0,0,0,0,0,0,0,0,0,0,0,0,0,0,0,0
270531115003018,32,Tangletown,65,65,1000000US270531115003018,"Block 3018, Block Group 3, Census Tract 1115, Hennepin County, Minnesota",30,28,0,0,2,0,0,0,30,30,28,0,0,2,0,0,0,0,0,0,0,0,0,0,0
270531108002005,32,Tangletown,65,65,1000000US270531108002005,"Block 2005, Block Group 2, Census Tract 1108, Hennepin County, Minnesota",61,58,0,0,0,0,3,0,61,56,56,0,0,0,0,0,0,5,2,0,0,0,0,3,0
270531108002004,32,Tangletown,65,65,1000000US270531108002004,"Block 2004, Block Group 2, Census Tract 1108, Hennepin County, Minnesota",61,58,0,0,2,0,1,0,61,57,55,0,0,2,0,0,0,4,3,0,0,0,0,1,0
270531115001023,32,Tangletown,65,65,1000000US270531115001023,"Block 1023, Block Group 1, Census Tract 1115, Hennepin County, Minnesota",29,27,1,0,0,0,0,1,29,29,27,1,0,0,0,0,1,0,0,0,0,0,0,0,0
270531115001022,32,Tangletown,65,65,1000000US270531115001022,"Block 1022, Block Group 1, Census Tract 1115, Hennepin County, Minnesota",46,44,0,0,1,0,1,0,46,45,44,0,0,1,0,0,0,1,0,0,0,0,0,1,0
270531115001001,32,Tangletown,65,65,1000000US270531115001001,"Block 1001, Block Group 1, Census Tract 1115, Hennepin County, Minnesota",0,0,0,0,0,0,0,0,0,0,0,0,0,0,0,0,0,0,0,0,0,0,0,0,0
270531115003005,32,Tangletown,65,65,1000000US270531115003005,"Block 3005, Block Group 3, Census Tract 1115, Hennepin County, Minnesota",25,21,0,4,0,0,0,0,25,25,21,0,4,0,0,0,0,0,0,0,0,0,0,0,0
270531115001011,32,Tangletown,65,65,1000000US270531115001011,"Block 1011, Block Group 1, Census Tract 1115, Hennepin County, Minnesota",81,79,1,0,1,0,0,0,81,79,77,1,0,1,0,0,0,2,2,0,0,0,0,0,0
270531115005014,32,Tangletown,65,65,1000000US270531115005014,"Block 5014, Block Group 5, Census Tract 1115, Hennepin County, Minnesota",49,40,0,0,5,0,0,4,49,48,39,0,0,5,0,0,4,1,1,0,0,0,0,0,0
270531108003004,32,Tangletown,65,65,1000000US270531108003004,"Block 3004, Block Group 3, Census Tract 1108, Hennepin County, Minnesota",83,71,6,0,6,0,0,0,83,82,70,6,0,6,0,0,0,1,1,0,0,0,0,0,0
270531108003002,32,Tangletown,65,65,1000000US270531108003002,"Block 3002, Block Group 3, Census Tract 1108, Hennepin County, Minnesota",65,60,0,0,1,0,0,4,65,64,59,0,0,1,0,0,4,1,1,0,0,0,0,0,0
270531115003007,32,Tangletown,65,65,1000000US270531115003007,"Block 3007, Block Group 3, Census Tract 1115, Hennepin County, Minnesota",63,57,0,1,0,0,0,5,63,56,51,0,0,0,0,0,5,7,6,0,1,0,0,0,0
270531115003006,32,Tangletown,65,65,1000000US270531115003006,"Block 3006, Block Group 3, Census Tract 1115, Hennepin County, Minnesota",68,64,1,0,1,0,0,2,68,67,63,1,0,1,0,0,2,1,1,0,0,0,0,0,0
270531115005010,32,Tangletown,65,65,1000000US270531115005010,"Block 5010, Block Group 5, Census Tract 1115, Hennepin County, Minnesota",136,102,16,0,7,0,0,11,136,134,100,16,0,7,0,0,11,2,2,0,0,0,0,0,0
270531108003003,32,Tangletown,65,65,1000000US270531108003003,"Block 3003, Block Group 3, Census Tract 1108, Hennepin County, Minnesota",75,67,0,0,4,0,0,4,75,72,65,0,0,4,0,0,3,3,2,0,0,0,0,0,1
270531115003010,32,Tangletown,65,65,1000000US270531115003010,"Block 3010, Block Group 3, Census Tract 1115, Hennepin County, Minnesota",49,45,1,0,2,0,0,1,49,47,43,1,0,2,0,0,1,2,2,0,0,0,0,0,0
270531115005013,32,Tangletown,65,65,1000000US270531115005013,"Block 5013, Block Group 5, Census Tract 1115, Hennepin County, Minnesota",62,57,2,0,0,0,0,3,62,59,57,2,0,0,0,0,0,3,0,0,0,0,0,0,3
270531108003006,32,Tangletown,65,65,1000000US270531108003006,"Block 3006, Block Group 3, Census Tract 1108, Hennepin County, Minnesota",80,66,5,0,5,0,0,4,80,80,66,5,0,5,0,0,4,0,0,0,0,0,0,0,0
270531115003008,32,Tangletown,65,65,1000000US270531115003008,"Block 3008, Block Group 3, Census Tract 1115, Hennepin County, Minnesota",53,49,0,0,4,0,0,0,53,52,48,0,0,4,0,0,0,1,1,0,0,0,0,0,0
270531115001013,32,Tangletown,65,65,1000000US270531115001013,"Block 1013, Block Group 1, Census Tract 1115, Hennepin County, Minnesota",73,70,0,0,2,0,0,1,73,73,70,0,0,2,0,0,1,0,0,0,0,0,0,0,0
270531115003015,32,Tangletown,65,65,1000000US270531115003015,"Block 3015, Block Group 3, Census Tract 1115, Hennepin County, Minnesota",47,44,0,0,0,0,0,3,47,47,44,0,0,0,0,0,3,0,0,0,0,0,0,0,0
270531115001018,32,Tangletown,65,65,1000000US270531115001018,"Block 1018, Block Group 1, Census Tract 1115, Hennepin County, Minnesota",0,0,0,0,0,0,0,0,0,0,0,0,0,0,0,0,0,0,0,0,0,0,0,0,0
270531115005015,32,Tangletown,65,65,1000000US270531115005015,"Block 5015, Block Group 5, Census Tract 1115, Hennepin County, Minnesota",0,0,0,0,0,0,0,0,0,0,0,0,0,0,0,0,0,0,0,0,0,0,0,0,0
270531115005009,32,Tangletown,65,65,1000000US270531115005009,"Block 5009, Block Group 5, Census Tract 1115, Hennepin County, Minnesota",0,0,0,0,0,0,0,0,0,0,0,0,0,0,0,0,0,0,0,0,0,0,0,0,0
270531115001019,32,Tangletown,65,65,1000000US270531115001019,"Block 1019, Block Group 1, Census Tract 1115, Hennepin County, Minnesota",0,0,0,0,0,0,0,0,0,0,0,0,0,0,0,0,0,0,0,0,0,0,0,0,0
270531108003008,32,Tangletown,65,65,1000000US270531108003008,"Block 3008, Block Group 3, Census Tract 1108, Hennepin County, Minnesota",92,84,1,0,3,0,0,4,92,92,84,1,0,3,0,0,4,0,0,0,0,0,0,0,0
270531108002008,32,Tangletown,65,65,1000000US270531108002008,"Block 2008, Block Group 2, Census Tract 1108, Hennepin County, Minnesota",66,60,2,0,3,0,0,1,66,66,60,2,0,3,0,0,1,0,0,0,0,0,0,0,0
270531115003003,32,Tangletown,65,65,1000000US270531115003003,"Block 3003, Block Group 3, Census Tract 1115, Hennepin County, Minnesota",63,61,1,0,0,0,0,1,63,63,61,1,0,0,0,0,1,0,0,0,0,0,0,0,0
270531108002003,32,Tangletown,65,65,1000000US270531108002003,"Block 2003, Block Group 2, Census Tract 1108, Hennepin County, Minnesota",67,39,12,2,7,0,1,6,67,64,39,12,1,7,0,0,5,3,0,0,1,0,0,1,1
270531115003009,32,Tangletown,65,65,1000000US270531115003009,"Block 3009, Block Group 3, Census Tract 1115, Hennepin County, Minnesota",67,67,0,0,0,0,0,0,67,64,64,0,0,0,0,0,0,3,3,0,0,0,0,0,0
270531115001012,32,Tangletown,65,65,1000000US270531115001012,"Block 1012, Block Group 1, Census Tract 1115, Hennepin County, Minnesota",42,40,2,0,0,0,0,0,42,42,40,2,0,0,0,0,0,0,0,0,0,0,0,0,0
270531108003000,32,Tangletown,65,65,1000000US270531108003000,"Block 3000, Block Group 3, Census Tract 1108, Hennepin County, Minnesota",69,65,1,0,1,0,0,2,69,65,62,1,0,1,0,0,1,4,3,0,0,0,0,0,1
270531115001026,32,Tangletown,65,65,1000000US270531115001026,"Block 1026, Block Group 1, Census Tract 1115, Hennepin County, Minnesota",87,84,3,0,0,0,0,0,87,87,84,3,0,0,0,0,0,0,0,0,0,0,0,0,0
270531115001003,32,Tangletown,65,65,1000000US270531115001003,"Block 1003, Block Group 1, Census Tract 1115, Hennepin County, Minnesota",43,42,0,0,0,0,1,0,43,42,42,0,0,0,0,0,0,1,0,0,0,0,0,1,0
270531115005003,32,Tangletown,65,65,1000000US270531115005003,"Block 5003, Block Group 5, Census Tract 1115, Hennepin County, Minnesota",47,45,0,0,1,0,0,1,47,46,44,0,0,1,0,0,1,1,1,0,0,0,0,0,0
270531108003005,32,Tangletown,65,65,1000000US270531108003005,"Block 3005, Block Group 3, Census Tract 1108, Hennepin County, Minnesota",60,59,0,0,1,0,0,0,60,60,59,0,0,1,0,0,0,0,0,0,0,0,0,0,0
270531108003007,32,Tangletown,65,65,1000000US270531108003007,"Block 3007, Block Group 3, Census Tract 1108, Hennepin County, Minnesota",78,68,2,0,3,0,0,5,78,76,66,2,0,3,0,0,5,2,2,0,0,0,0,0,0
270531108002002,32,Tangletown,65,65,1000000US270531108002002,"Block 2002, Block Group 2, Census Tract 1108, Hennepin County, Minnesota",64,54,5,0,1,0,0,4,64,60,52,5,0,1,0,0,2,4,2,0,0,0,0,0,2
270531115003013,32,Tangletown,65,65,1000000US270531115003013,"Block 3013, Block Group 3, Census Tract 1115, Hennepin County, Minnesota",59,53,0,0,0,0,0,6,59,55,53,0,0,0,0,0,2,4,0,0,0,0,0,0,4
270531115001014,32,Tangletown,65,65,1000000US270531115001014,"Block 1014, Block Group 1, Census Tract 1115, Hennepin County, Minnesota",53,48,2,0,0,0,1,2,53,53,48,2,0,0,0,1,2,0,0,0,0,0,0,0,0
270531115001008,32,Tangletown,65,65,1000000US270531115001008,"Block 1008, Block Group 1, Census Tract 1115, Hennepin County, Minnesota",49,47,1,0,1,0,0,0,49,48,46,1,0,1,0,0,0,1,1,0,0,0,0,0,0
270531115001016,32,Tangletown,65,65,1000000US270531115001016,"Block 1016, Block Group 1, Census Tract 1115, Hennepin County, Minnesota",20,19,0,0,1,0,0,0,20,20,19,0,0,1,0,0,0,0,0,0,0,0,0,0,0
270531115001020,32,Tangletown,65,65,1000000US270531115001020,"Block 1020, Block Group 1, Census Tract 1115, Hennepin County, Minnesota",52,50,0,1,0,0,0,1,52,49,47,0,1,0,0,0,1,3,3,0,0,0,0,0,0
270531115001010,32,Tangletown,65,65,1000000US270531115001010,"Block 1010, Block Group 1, Census Tract 1115, Hennepin County, Minnesota",75,68,2,0,2,0,0,3,75,74,67,2,0,2,0,0,3,1,1,0,0,0,0,0,0
270531115001009,32,Tangletown,65,65,1000000US270531115001009,"Block 1009, Block Group 1, Census Tract 1115, Hennepin County, Minnesota",62,61,1,0,0,0,0,0,62,61,61,0,0,0,0,0,0,1,0,1,0,0,0,0,0
270531108003001,32,Tangletown,65,65,1000000US270531108003001,"Block 3001, Block Group 3, Census Tract 1108, Hennepin County, Minnesota",69,65,2,0,1,0,0,1,69,69,65,2,0,1,0,0,1,0,0,0,0,0,0,0,0
270531115003004,32,Tangletown,65,65,1000000US270531115003004,"Block 3004, Block Group 3, Census Tract 1115, Hennepin County, Minnesota",72,69,0,0,1,0,0,2,72,68,65,0,0,1,0,0,2,4,4,0,0,0,0,0,0
270531108002006,32,Tangletown,65,65,1000000US270531108002006,"Block 2006, Block Group 2, Census Tract 1108, Hennepin County, Minnesota",64,54,0,0,7,0,0,3,64,64,54,0,0,7,0,0,3,0,0,0,0,0,0,0,0
270531108002000,32,Tangletown,65,65,1000000US270531108002000,"Block 2000, Block Group 2, Census Tract 1108, Hennepin County, Minnesota",0,0,0,0,0,0,0,0,0,0,0,0,0,0,0,0,0,0,0,0,0,0,0,0,0
270531262002020,33,North Loop,86,86,1000000US270531262002020,"Block 2020, Block Group 2, Census Tract 1262, Hennepin County, Minnesota",0,0,0,0,0,0,0,0,0,0,0,0,0,0,0,0,0,0,0,0,0,0,0,0,0
270531262001016,33,North Loop,86,86,1000000US270531262001016,"Block 1016, Block Group 1, Census Tract 1262, Hennepin County, Minnesota",90,79,4,0,3,0,1,3,90,88,79,4,0,3,0,0,2,2,0,0,0,0,0,1,1
270531262002058,33,North Loop,86,86,1000000US270531262002058,"Block 2058, Block Group 2, Census Tract 1262, Hennepin County, Minnesota",0,0,0,0,0,0,0,0,0,0,0,0,0,0,0,0,0,0,0,0,0,0,0,0,0
270531262002067,33,North Loop,86,86,1000000US270531262002067,"Block 2067, Block Group 2, Census Tract 1262, Hennepin County, Minnesota",0,0,0,0,0,0,0,0,0,0,0,0,0,0,0,0,0,0,0,0,0,0,0,0,0
270531262001019,33,North Loop,86,86,1000000US270531262001019,"Block 1019, Block Group 1, Census Tract 1262, Hennepin County, Minnesota",0,0,0,0,0,0,0,0,0,0,0,0,0,0,0,0,0,0,0,0,0,0,0,0,0
270531262002057,33,North Loop,86,86,1000000US270531262002057,"Block 2057, Block Group 2, Census Tract 1262, Hennepin County, Minnesota",0,0,0,0,0,0,0,0,0,0,0,0,0,0,0,0,0,0,0,0,0,0,0,0,0
270531262002061,33,North Loop,86,86,1000000US270531262002061,"Block 2061, Block Group 2, Census Tract 1262, Hennepin County, Minnesota",5,1,4,0,0,0,0,0,5,5,1,4,0,0,0,0,0,0,0,0,0,0,0,0,0
270531262002056,33,North Loop,86,86,1000000US270531262002056,"Block 2056, Block Group 2, Census Tract 1262, Hennepin County, Minnesota",0,0,0,0,0,0,0,0,0,0,0,0,0,0,0,0,0,0,0,0,0,0,0,0,0
270531262001017,33,North Loop,86,86,1000000US270531262001017,"Block 1017, Block Group 1, Census Tract 1262, Hennepin County, Minnesota",1,1,0,0,0,0,0,0,1,1,1,0,0,0,0,0,0,0,0,0,0,0,0,0,0
270531262002028,33,North Loop,86,86,1000000US270531262002028,"Block 2028, Block Group 2, Census Tract 1262, Hennepin County, Minnesota",0,0,0,0,0,0,0,0,0,0,0,0,0,0,0,0,0,0,0,0,0,0,0,0,0
270531262002048,33,North Loop,86,86,1000000US270531262002048,"Block 2048, Block Group 2, Census Tract 1262, Hennepin County, Minnesota",0,0,0,0,0,0,0,0,0,0,0,0,0,0,0,0,0,0,0,0,0,0,0,0,0
270531262002041,33,North Loop,86,86,1000000US270531262002041,"Block 2041, Block Group 2, Census Tract 1262, Hennepin County, Minnesota",0,0,0,0,0,0,0,0,0,0,0,0,0,0,0,0,0,0,0,0,0,0,0,0,0
270531262002004,33,North Loop,86,86,1000000US270531262002004,"Block 2004, Block Group 2, Census Tract 1262, Hennepin County, Minnesota",5,0,5,0,0,0,0,0,5,5,0,5,0,0,0,0,0,0,0,0,0,0,0,0,0
270531262002040,33,North Loop,86,86,1000000US270531262002040,"Block 2040, Block Group 2, Census Tract 1262, Hennepin County, Minnesota",0,0,0,0,0,0,0,0,0,0,0,0,0,0,0,0,0,0,0,0,0,0,0,0,0
270531262001010,33,North Loop,86,86,1000000US270531262001010,"Block 1010, Block Group 1, Census Tract 1262, Hennepin County, Minnesota",0,0,0,0,0,0,0,0,0,0,0,0,0,0,0,0,0,0,0,0,0,0,0,0,0
270531262002018,33,North Loop,86,86,1000000US270531262002018,"Block 2018, Block Group 2, Census Tract 1262, Hennepin County, Minnesota",0,0,0,0,0,0,0,0,0,0,0,0,0,0,0,0,0,0,0,0,0,0,0,0,0
270531262002066,33,North Loop,86,86,1000000US270531262002066,"Block 2066, Block Group 2, Census Tract 1262, Hennepin County, Minnesota",18,13,5,0,0,0,0,0,18,18,13,5,0,0,0,0,0,0,0,0,0,0,0,0,0
270531262001004,33,North Loop,86,86,1000000US270531262001004,"Block 1004, Block Group 1, Census Tract 1262, Hennepin County, Minnesota",0,0,0,0,0,0,0,0,0,0,0,0,0,0,0,0,0,0,0,0,0,0,0,0,0
270531262001003,33,North Loop,86,86,1000000US270531262001003,"Block 1003, Block Group 1, Census Tract 1262, Hennepin County, Minnesota",85,79,0,0,6,0,0,0,85,85,79,0,0,6,0,0,0,0,0,0,0,0,0,0,0
270531262002053,33,North Loop,86,86,1000000US270531262002053,"Block 2053, Block Group 2, Census Tract 1262, Hennepin County, Minnesota",0,0,0,0,0,0,0,0,0,0,0,0,0,0,0,0,0,0,0,0,0,0,0,0,0
270531262002060,33,North Loop,86,86,1000000US270531262002060,"Block 2060, Block Group 2, Census Tract 1262, Hennepin County, Minnesota",0,0,0,0,0,0,0,0,0,0,0,0,0,0,0,0,0,0,0,0,0,0,0,0,0
270531262002062,33,North Loop,86,86,1000000US270531262002062,"Block 2062, Block Group 2, Census Tract 1262, Hennepin County, Minnesota",0,0,0,0,0,0,0,0,0,0,0,0,0,0,0,0,0,0,0,0,0,0,0,0,0
270531262001012,33,North Loop,86,86,1000000US270531262001012,"Block 1012, Block Group 1, Census Tract 1262, Hennepin County, Minnesota",284,265,9,0,8,0,0,2,284,276,257,9,0,8,0,0,2,8,8,0,0,0,0,0,0
270531262002033,33,North Loop,86,86,1000000US270531262002033,"Block 2033, Block Group 2, Census Tract 1262, Hennepin County, Minnesota",0,0,0,0,0,0,0,0,0,0,0,0,0,0,0,0,0,0,0,0,0,0,0,0,0
270531262002037,33,North Loop,86,86,1000000US270531262002037,"Block 2037, Block Group 2, Census Tract 1262, Hennepin County, Minnesota",0,0,0,0,0,0,0,0,0,0,0,0,0,0,0,0,0,0,0,0,0,0,0,0,0
270531262001006,33,North Loop,86,86,1000000US270531262001006,"Block 1006, Block Group 1, Census Tract 1262, Hennepin County, Minnesota",725,653,21,0,35,0,1,15,725,705,637,20,0,35,0,0,13,20,16,1,0,0,0,1,2
270531262002016,33,North Loop,86,86,1000000US270531262002016,"Block 2016, Block Group 2, Census Tract 1262, Hennepin County, Minnesota",24,24,0,0,0,0,0,0,24,24,24,0,0,0,0,0,0,0,0,0,0,0,0,0,0
270531262002011,33,North Loop,86,86,1000000US270531262002011,"Block 2011, Block Group 2, Census Tract 1262, Hennepin County, Minnesota",96,89,0,0,2,0,1,4,96,96,89,0,0,2,0,1,4,0,0,0,0,0,0,0,0
270531262002024,33,North Loop,86,86,1000000US270531262002024,"Block 2024, Block Group 2, Census Tract 1262, Hennepin County, Minnesota",0,0,0,0,0,0,0,0,0,0,0,0,0,0,0,0,0,0,0,0,0,0,0,0,0
270531262002006,33,North Loop,86,86,1000000US270531262002006,"Block 2006, Block Group 2, Census Tract 1262, Hennepin County, Minnesota",0,0,0,0,0,0,0,0,0,0,0,0,0,0,0,0,0,0,0,0,0,0,0,0,0
270531262002038,33,North Loop,86,86,1000000US270531262002038,"Block 2038, Block Group 2, Census Tract 1262, Hennepin County, Minnesota",0,0,0,0,0,0,0,0,0,0,0,0,0,0,0,0,0,0,0,0,0,0,0,0,0
270531262002050,33,North Loop,86,86,1000000US270531262002050,"Block 2050, Block Group 2, Census Tract 1262, Hennepin County, Minnesota",0,0,0,0,0,0,0,0,0,0,0,0,0,0,0,0,0,0,0,0,0,0,0,0,0
270531262001007,33,North Loop,86,86,1000000US270531262001007,"Block 1007, Block Group 1, Census Tract 1262, Hennepin County, Minnesota",12,10,0,0,2,0,0,0,12,12,10,0,0,2,0,0,0,0,0,0,0,0,0,0,0
270531262002010,33,North Loop,86,86,1000000US270531262002010,"Block 2010, Block Group 2, Census Tract 1262, Hennepin County, Minnesota",38,32,1,0,4,0,0,1,38,36,31,1,0,4,0,0,0,2,1,0,0,0,0,0,1
270531262002046,33,North Loop,86,86,1000000US270531262002046,"Block 2046, Block Group 2, Census Tract 1262, Hennepin County, Minnesota",0,0,0,0,0,0,0,0,0,0,0,0,0,0,0,0,0,0,0,0,0,0,0,0,0
270531262002021,33,North Loop,86,86,1000000US270531262002021,"Block 2021, Block Group 2, Census Tract 1262, Hennepin County, Minnesota",1,0,1,0,0,0,0,0,1,1,0,1,0,0,0,0,0,0,0,0,0,0,0,0,0
270531262002049,33,North Loop,86,86,1000000US270531262002049,"Block 2049, Block Group 2, Census Tract 1262, Hennepin County, Minnesota",0,0,0,0,0,0,0,0,0,0,0,0,0,0,0,0,0,0,0,0,0,0,0,0,0
270531262002059,33,North Loop,86,86,1000000US270531262002059,"Block 2059, Block Group 2, Census Tract 1262, Hennepin County, Minnesota",0,0,0,0,0,0,0,0,0,0,0,0,0,0,0,0,0,0,0,0,0,0,0,0,0
270531262001008,33,North Loop,86,86,1000000US270531262001008,"Block 1008, Block Group 1, Census Tract 1262, Hennepin County, Minnesota",546,447,36,2,33,0,1,27,546,527,435,35,1,32,0,0,24,19,12,1,1,1,0,1,3
270531262002012,33,North Loop,86,86,1000000US270531262002012,"Block 2012, Block Group 2, Census Tract 1262, Hennepin County, Minnesota",52,49,0,0,2,0,0,1,52,51,48,0,0,2,0,0,1,1,1,0,0,0,0,0,0
270531262002045,33,North Loop,86,86,1000000US270531262002045,"Block 2045, Block Group 2, Census Tract 1262, Hennepin County, Minnesota",0,0,0,0,0,0,0,0,0,0,0,0,0,0,0,0,0,0,0,0,0,0,0,0,0
270531262002052,33,North Loop,86,86,1000000US270531262002052,"Block 2052, Block Group 2, Census Tract 1262, Hennepin County, Minnesota",0,0,0,0,0,0,0,0,0,0,0,0,0,0,0,0,0,0,0,0,0,0,0,0,0
270531262002027,33,North Loop,86,86,1000000US270531262002027,"Block 2027, Block Group 2, Census Tract 1262, Hennepin County, Minnesota",1,0,0,0,1,0,0,0,1,1,0,0,0,1,0,0,0,0,0,0,0,0,0,0,0
270531262001002,33,North Loop,86,86,1000000US270531262001002,"Block 1002, Block Group 1, Census Tract 1262, Hennepin County, Minnesota",36,35,0,0,0,0,1,0,36,36,35,0,0,0,0,1,0,0,0,0,0,0,0,0,0
270531262002014,33,North Loop,86,86,1000000US270531262002014,"Block 2014, Block Group 2, Census Tract 1262, Hennepin County, Minnesota",0,0,0,0,0,0,0,0,0,0,0,0,0,0,0,0,0,0,0,0,0,0,0,0,0
270531262002008,33,North Loop,86,86,1000000US270531262002008,"Block 2008, Block Group 2, Census Tract 1262, Hennepin County, Minnesota",0,0,0,0,0,0,0,0,0,0,0,0,0,0,0,0,0,0,0,0,0,0,0,0,0
270531262001013,33,North Loop,86,86,1000000US270531262001013,"Block 1013, Block Group 1, Census Tract 1262, Hennepin County, Minnesota",0,0,0,0,0,0,0,0,0,0,0,0,0,0,0,0,0,0,0,0,0,0,0,0,0
270531262002029,33,North Loop,86,86,1000000US270531262002029,"Block 2029, Block Group 2, Census Tract 1262, Hennepin County, Minnesota",0,0,0,0,0,0,0,0,0,0,0,0,0,0,0,0,0,0,0,0,0,0,0,0,0
270531262001009,33,North Loop,86,86,1000000US270531262001009,"Block 1009, Block Group 1, Census Tract 1262, Hennepin County, Minnesota",2,2,0,0,0,0,0,0,2,2,2,0,0,0,0,0,0,0,0,0,0,0,0,0,0
270531262002026,33,North Loop,86,86,1000000US270531262002026,"Block 2026, Block Group 2, Census Tract 1262, Hennepin County, Minnesota",0,0,0,0,0,0,0,0,0,0,0,0,0,0,0,0,0,0,0,0,0,0,0,0,0
270531262001011,33,North Loop,86,86,1000000US270531262001011,"Block 1011, Block Group 1, Census Tract 1262, Hennepin County, Minnesota",148,125,12,0,9,0,0,2,148,146,124,12,0,9,0,0,1,2,1,0,0,0,0,0,1
270531262002032,33,North Loop,86,86,1000000US270531262002032,"Block 2032, Block Group 2, Census Tract 1262, Hennepin County, Minnesota",0,0,0,0,0,0,0,0,0,0,0,0,0,0,0,0,0,0,0,0,0,0,0,0,0
270531262001014,33,North Loop,86,86,1000000US270531262001014,"Block 1014, Block Group 1, Census Tract 1262, Hennepin County, Minnesota",3,3,0,0,0,0,0,0,3,3,3,0,0,0,0,0,0,0,0,0,0,0,0,0,0
270531262002025,33,North Loop,86,86,1000000US270531262002025,"Block 2025, Block Group 2, Census Tract 1262, Hennepin County, Minnesota",0,0,0,0,0,0,0,0,0,0,0,0,0,0,0,0,0,0,0,0,0,0,0,0,0
270531262002063,33,North Loop,86,86,1000000US270531262002063,"Block 2063, Block Group 2, Census Tract 1262, Hennepin County, Minnesota",0,0,0,0,0,0,0,0,0,0,0,0,0,0,0,0,0,0,0,0,0,0,0,0,0
270531262001021,33,North Loop,86,86,1000000US270531262001021,"Block 1021, Block Group 1, Census Tract 1262, Hennepin County, Minnesota",0,0,0,0,0,0,0,0,0,0,0,0,0,0,0,0,0,0,0,0,0,0,0,0,0
270531262001018,33,North Loop,86,86,1000000US270531262001018,"Block 1018, Block Group 1, Census Tract 1262, Hennepin County, Minnesota",0,0,0,0,0,0,0,0,0,0,0,0,0,0,0,0,0,0,0,0,0,0,0,0,0
270531262002030,33,North Loop,86,86,1000000US270531262002030,"Block 2030, Block Group 2, Census Tract 1262, Hennepin County, Minnesota",0,0,0,0,0,0,0,0,0,0,0,0,0,0,0,0,0,0,0,0,0,0,0,0,0
270531262001023,33,North Loop,86,86,1000000US270531262001023,"Block 1023, Block Group 1, Census Tract 1262, Hennepin County, Minnesota",0,0,0,0,0,0,0,0,0,0,0,0,0,0,0,0,0,0,0,0,0,0,0,0,0
270531262002002,33,North Loop,86,86,1000000US270531262002002,"Block 2002, Block Group 2, Census Tract 1262, Hennepin County, Minnesota",0,0,0,0,0,0,0,0,0,0,0,0,0,0,0,0,0,0,0,0,0,0,0,0,0
270531262001005,33,North Loop,86,86,1000000US270531262001005,"Block 1005, Block Group 1, Census Tract 1262, Hennepin County, Minnesota",299,270,3,0,16,0,3,7,299,292,266,3,0,16,0,1,6,7,4,0,0,0,0,2,1
270531262002015,33,North Loop,86,86,1000000US270531262002015,"Block 2015, Block Group 2, Census Tract 1262, Hennepin County, Minnesota",0,0,0,0,0,0,0,0,0,0,0,0,0,0,0,0,0,0,0,0,0,0,0,0,0
270531262002022,33,North Loop,86,86,1000000US270531262002022,"Block 2022, Block Group 2, Census Tract 1262, Hennepin County, Minnesota",0,0,0,0,0,0,0,0,0,0,0,0,0,0,0,0,0,0,0,0,0,0,0,0,0
270531262002036,33,North Loop,86,86,1000000US270531262002036,"Block 2036, Block Group 2, Census Tract 1262, Hennepin County, Minnesota",0,0,0,0,0,0,0,0,0,0,0,0,0,0,0,0,0,0,0,0,0,0,0,0,0
270531262002023,33,North Loop,86,86,1000000US270531262002023,"Block 2023, Block Group 2, Census Tract 1262, Hennepin County, Minnesota",0,0,0,0,0,0,0,0,0,0,0,0,0,0,0,0,0,0,0,0,0,0,0,0,0
270531262002044,33,North Loop,86,86,1000000US270531262002044,"Block 2044, Block Group 2, Census Tract 1262, Hennepin County, Minnesota",311,100,160,18,10,0,9,14,311,253,56,158,18,10,0,0,11,58,44,2,0,0,0,9,3
270531262002031,33,North Loop,86,86,1000000US270531262002031,"Block 2031, Block Group 2, Census Tract 1262, Hennepin County, Minnesota",0,0,0,0,0,0,0,0,0,0,0,0,0,0,0,0,0,0,0,0,0,0,0,0,0
270531262002039,33,North Loop,86,86,1000000US270531262002039,"Block 2039, Block Group 2, Census Tract 1262, Hennepin County, Minnesota",0,0,0,0,0,0,0,0,0,0,0,0,0,0,0,0,0,0,0,0,0,0,0,0,0
270531262002051,33,North Loop,86,86,1000000US270531262002051,"Block 2051, Block Group 2, Census Tract 1262, Hennepin County, Minnesota",0,0,0,0,0,0,0,0,0,0,0,0,0,0,0,0,0,0,0,0,0,0,0,0,0
270531262002055,33,North Loop,86,86,1000000US270531262002055,"Block 2055, Block Group 2, Census Tract 1262, Hennepin County, Minnesota",0,0,0,0,0,0,0,0,0,0,0,0,0,0,0,0,0,0,0,0,0,0,0,0,0
270531262002065,33,North Loop,86,86,1000000US270531262002065,"Block 2065, Block Group 2, Census Tract 1262, Hennepin County, Minnesota",0,0,0,0,0,0,0,0,0,0,0,0,0,0,0,0,0,0,0,0,0,0,0,0,0
270531262002064,33,North Loop,86,86,1000000US270531262002064,"Block 2064, Block Group 2, Census Tract 1262, Hennepin County, Minnesota",18,15,1,0,2,0,0,0,18,17,14,1,0,2,0,0,0,1,1,0,0,0,0,0,0
270531262002007,33,North Loop,86,86,1000000US270531262002007,"Block 2007, Block Group 2, Census Tract 1262, Hennepin County, Minnesota",0,0,0,0,0,0,0,0,0,0,0,0,0,0,0,0,0,0,0,0,0,0,0,0,0
270531262002001,33,North Loop,86,86,1000000US270531262002001,"Block 2001, Block Group 2, Census Tract 1262, Hennepin County, Minnesota",0,0,0,0,0,0,0,0,0,0,0,0,0,0,0,0,0,0,0,0,0,0,0,0,0
270531262002005,33,North Loop,86,86,1000000US270531262002005,"Block 2005, Block Group 2, Census Tract 1262, Hennepin County, Minnesota",0,0,0,0,0,0,0,0,0,0,0,0,0,0,0,0,0,0,0,0,0,0,0,0,0
270531262002042,33,North Loop,86,86,1000000US270531262002042,"Block 2042, Block Group 2, Census Tract 1262, Hennepin County, Minnesota",0,0,0,0,0,0,0,0,0,0,0,0,0,0,0,0,0,0,0,0,0,0,0,0,0
270531262002043,33,North Loop,86,86,1000000US270531262002043,"Block 2043, Block Group 2, Census Tract 1262, Hennepin County, Minnesota",0,0,0,0,0,0,0,0,0,0,0,0,0,0,0,0,0,0,0,0,0,0,0,0,0
270531262002017,33,North Loop,86,86,1000000US270531262002017,"Block 2017, Block Group 2, Census Tract 1262, Hennepin County, Minnesota",0,0,0,0,0,0,0,0,0,0,0,0,0,0,0,0,0,0,0,0,0,0,0,0,0
270531262001001,33,North Loop,86,86,1000000US270531262001001,"Block 1001, Block Group 1, Census Tract 1262, Hennepin County, Minnesota",0,0,0,0,0,0,0,0,0,0,0,0,0,0,0,0,0,0,0,0,0,0,0,0,0
270531262001020,33,North Loop,86,86,1000000US270531262001020,"Block 1020, Block Group 1, Census Tract 1262, Hennepin County, Minnesota",8,8,0,0,0,0,0,0,8,8,8,0,0,0,0,0,0,0,0,0,0,0,0,0,0
270531262001022,33,North Loop,86,86,1000000US270531262001022,"Block 1022, Block Group 1, Census Tract 1262, Hennepin County, Minnesota",55,51,2,0,1,0,1,0,55,52,49,2,0,1,0,0,0,3,2,0,0,0,0,1,0
270531262002068,33,North Loop,86,86,1000000US270531262002068,"Block 2068, Block Group 2, Census Tract 1262, Hennepin County, Minnesota",38,19,15,1,0,0,0,3,38,36,19,13,1,0,0,0,3,2,0,2,0,0,0,0,0
270531262002047,33,North Loop,86,86,1000000US270531262002047,"Block 2047, Block Group 2, Census Tract 1262, Hennepin County, Minnesota",472,85,225,34,69,0,12,47,472,391,40,220,27,69,0,0,35,81,45,5,7,0,0,12,12
270531262002019,33,North Loop,86,86,1000000US270531262002019,"Block 2019, Block Group 2, Census Tract 1262, Hennepin County, Minnesota",154,141,1,0,7,0,0,5,154,150,137,1,0,7,0,0,5,4,4,0,0,0,0,0,0
270531262001000,33,North Loop,86,86,1000000US270531262001000,"Block 1000, Block Group 1, Census Tract 1262, Hennepin County, Minnesota",0,0,0,0,0,0,0,0,0,0,0,0,0,0,0,0,0,0,0,0,0,0,0,0,0
270531262001024,33,North Loop,86,86,1000000US270531262001024,"Block 1024, Block Group 1, Census Tract 1262, Hennepin County, Minnesota",0,0,0,0,0,0,0,0,0,0,0,0,0,0,0,0,0,0,0,0,0,0,0,0,0
270531262002069,33,North Loop,86,86,1000000US270531262002069,"Block 2069, Block Group 2, Census Tract 1262, Hennepin County, Minnesota",0,0,0,0,0,0,0,0,0,0,0,0,0,0,0,0,0,0,0,0,0,0,0,0,0
270531262002000,33,North Loop,86,86,1000000US270531262002000,"Block 2000, Block Group 2, Census Tract 1262, Hennepin County, Minnesota",0,0,0,0,0,0,0,0,0,0,0,0,0,0,0,0,0,0,0,0,0,0,0,0,0
270531262002009,33,North Loop,86,86,1000000US270531262002009,"Block 2009, Block Group 2, Census Tract 1262, Hennepin County, Minnesota",0,0,0,0,0,0,0,0,0,0,0,0,0,0,0,0,0,0,0,0,0,0,0,0,0
270531262001015,33,North Loop,86,86,1000000US270531262001015,"Block 1015, Block Group 1, Census Tract 1262, Hennepin County, Minnesota",50,49,1,0,0,0,0,0,50,50,49,1,0,0,0,0,0,0,0,0,0,0,0,0,0
270531262002013,33,North Loop,86,86,1000000US270531262002013,"Block 2013, Block Group 2, Census Tract 1262, Hennepin County, Minnesota",554,491,43,1,12,0,4,3,554,535,477,42,1,12,0,0,3,19,14,1,0,0,0,4,0
270531262002035,33,North Loop,86,86,1000000US270531262002035,"Block 2035, Block Group 2, Census Tract 1262, Hennepin County, Minnesota",0,0,0,0,0,0,0,0,0,0,0,0,0,0,0,0,0,0,0,0,0,0,0,0,0
270531262002034,33,North Loop,86,86,1000000US270531262002034,"Block 2034, Block Group 2, Census Tract 1262, Hennepin County, Minnesota",0,0,0,0,0,0,0,0,0,0,0,0,0,0,0,0,0,0,0,0,0,0,0,0,0
270531262002054,33,North Loop,86,86,1000000US270531262002054,"Block 2054, Block Group 2, Census Tract 1262, Hennepin County, Minnesota",160,81,63,11,0,0,3,2,160,157,81,63,11,0,0,0,2,3,0,0,0,0,0,3,0
270530117033005,34,Hale,79,79,1000000US270530117033005,"Block 3005, Block Group 3, Census Tract 117.03, Hennepin County, Minnesota",68,58,4,0,0,0,0,6,68,64,56,4,0,0,0,0,4,4,2,0,0,0,0,0,2
270530117033011,34,Hale,79,79,1000000US270530117033011,"Block 3011, Block Group 3, Census Tract 117.03, Hennepin County, Minnesota",100,59,27,0,0,0,11,3,100,85,55,27,0,0,0,0,3,15,4,0,0,0,0,11,0
270530117033012,34,Hale,79,79,1000000US270530117033012,"Block 3012, Block Group 3, Census Tract 117.03, Hennepin County, Minnesota",48,44,4,0,0,0,0,0,48,47,43,4,0,0,0,0,0,1,1,0,0,0,0,0,0
270530117031001,34,Hale,79,79,1000000US270530117031001,"Block 1001, Block Group 1, Census Tract 117.03, Hennepin County, Minnesota",69,61,5,0,3,0,0,0,69,68,60,5,0,3,0,0,0,1,1,0,0,0,0,0,0
270530117034010,34,Hale,79,79,1000000US270530117034010,"Block 4010, Block Group 4, Census Tract 117.03, Hennepin County, Minnesota",67,64,1,0,0,0,2,0,67,66,64,1,0,0,0,1,0,1,0,0,0,0,0,1,0
270530117034006,34,Hale,79,79,1000000US270530117034006,"Block 4006, Block Group 4, Census Tract 117.03, Hennepin County, Minnesota",60,55,0,0,1,0,0,4,60,60,55,0,0,1,0,0,4,0,0,0,0,0,0,0,0
270530117031007,34,Hale,79,79,1000000US270530117031007,"Block 1007, Block Group 1, Census Tract 117.03, Hennepin County, Minnesota",52,45,4,0,3,0,0,0,52,51,44,4,0,3,0,0,0,1,1,0,0,0,0,0,0
270530117031008,34,Hale,79,79,1000000US270530117031008,"Block 1008, Block Group 1, Census Tract 117.03, Hennepin County, Minnesota",30,29,1,0,0,0,0,0,30,30,29,1,0,0,0,0,0,0,0,0,0,0,0,0,0
270530117031010,34,Hale,79,79,1000000US270530117031010,"Block 1010, Block Group 1, Census Tract 117.03, Hennepin County, Minnesota",0,0,0,0,0,0,0,0,0,0,0,0,0,0,0,0,0,0,0,0,0,0,0,0,0
270530117031000,34,Hale,79,79,1000000US270530117031000,"Block 1000, Block Group 1, Census Tract 117.03, Hennepin County, Minnesota",69,69,0,0,0,0,0,0,69,69,69,0,0,0,0,0,0,0,0,0,0,0,0,0,0
270530117034000,34,Hale,79,79,1000000US270530117034000,"Block 4000, Block Group 4, Census Tract 117.03, Hennepin County, Minnesota",0,0,0,0,0,0,0,0,0,0,0,0,0,0,0,0,0,0,0,0,0,0,0,0,0
270530117034007,34,Hale,79,79,1000000US270530117034007,"Block 4007, Block Group 4, Census Tract 117.03, Hennepin County, Minnesota",53,53,0,0,0,0,0,0,53,51,51,0,0,0,0,0,0,2,2,0,0,0,0,0,0
270530117031002,34,Hale,79,79,1000000US270530117031002,"Block 1002, Block Group 1, Census Tract 117.03, Hennepin County, Minnesota",73,65,0,0,4,0,0,4,73,73,65,0,0,4,0,0,4,0,0,0,0,0,0,0,0
270530117031009,34,Hale,79,79,1000000US270530117031009,"Block 1009, Block Group 1, Census Tract 117.03, Hennepin County, Minnesota",0,0,0,0,0,0,0,0,0,0,0,0,0,0,0,0,0,0,0,0,0,0,0,0,0
270530117034011,34,Hale,79,79,1000000US270530117034011,"Block 4011, Block Group 4, Census Tract 117.03, Hennepin County, Minnesota",49,46,0,0,1,0,0,2,49,48,45,0,0,1,0,0,2,1,1,0,0,0,0,0,0
270530117034014,34,Hale,79,79,1000000US270530117034014,"Block 4014, Block Group 4, Census Tract 117.03, Hennepin County, Minnesota",28,28,0,0,0,0,0,0,28,28,28,0,0,0,0,0,0,0,0,0,0,0,0,0,0
270530117033001,34,Hale,79,79,1000000US270530117033001,"Block 3001, Block Group 3, Census Tract 117.03, Hennepin County, Minnesota",72,70,1,0,0,0,1,0,72,71,70,1,0,0,0,0,0,1,0,0,0,0,0,1,0
270530117034001,34,Hale,79,79,1000000US270530117034001,"Block 4001, Block Group 4, Census Tract 117.03, Hennepin County, Minnesota",64,56,2,0,0,0,1,5,64,59,55,2,0,0,0,0,2,5,1,0,0,0,0,1,3
270530117031013,34,Hale,79,79,1000000US270530117031013,"Block 1013, Block Group 1, Census Tract 117.03, Hennepin County, Minnesota",75,62,2,1,3,0,0,7,75,75,62,2,1,3,0,0,7,0,0,0,0,0,0,0,0
270530117031012,34,Hale,79,79,1000000US270530117031012,"Block 1012, Block Group 1, Census Tract 117.03, Hennepin County, Minnesota",65,64,0,0,0,0,1,0,65,64,64,0,0,0,0,0,0,1,0,0,0,0,0,1,0
270530117031011,34,Hale,79,79,1000000US270530117031011,"Block 1011, Block Group 1, Census Tract 117.03, Hennepin County, Minnesota",43,41,1,0,1,0,0,0,43,43,41,1,0,1,0,0,0,0,0,0,0,0,0,0,0
270530117033003,34,Hale,79,79,1000000US270530117033003,"Block 3003, Block Group 3, Census Tract 117.03, Hennepin County, Minnesota",49,49,0,0,0,0,0,0,49,48,48,0,0,0,0,0,0,1,1,0,0,0,0,0,0
270530117033010,34,Hale,79,79,1000000US270530117033010,"Block 3010, Block Group 3, Census Tract 117.03, Hennepin County, Minnesota",60,56,0,0,1,0,1,2,60,59,56,0,0,1,0,0,2,1,0,0,0,0,0,1,0
270530117033013,34,Hale,79,79,1000000US270530117033013,"Block 3013, Block Group 3, Census Tract 117.03, Hennepin County, Minnesota",72,68,0,0,0,0,0,4,72,72,68,0,0,0,0,0,4,0,0,0,0,0,0,0,0
270530117033007,34,Hale,79,79,1000000US270530117033007,"Block 3007, Block Group 3, Census Tract 117.03, Hennepin County, Minnesota",59,56,0,0,2,0,0,1,59,58,55,0,0,2,0,0,1,1,1,0,0,0,0,0,0
270530117033015,34,Hale,79,79,1000000US270530117033015,"Block 3015, Block Group 3, Census Tract 117.03, Hennepin County, Minnesota",1,1,0,0,0,0,0,0,1,1,1,0,0,0,0,0,0,0,0,0,0,0,0,0,0
270530117032011,34,Hale,79,79,1000000US270530117032011,"Block 2011, Block Group 2, Census Tract 117.03, Hennepin County, Minnesota",14,14,0,0,0,0,0,0,14,14,14,0,0,0,0,0,0,0,0,0,0,0,0,0,0
270530117031005,34,Hale,79,79,1000000US270530117031005,"Block 1005, Block Group 1, Census Tract 117.03, Hennepin County, Minnesota",69,51,10,1,2,0,1,4,69,64,48,10,1,2,0,0,3,5,3,0,0,0,0,1,1
270530117033009,34,Hale,79,79,1000000US270530117033009,"Block 3009, Block Group 3, Census Tract 117.03, Hennepin County, Minnesota",57,54,3,0,0,0,0,0,57,57,54,3,0,0,0,0,0,0,0,0,0,0,0,0,0
270530117032002,34,Hale,79,79,1000000US270530117032002,"Block 2002, Block Group 2, Census Tract 117.03, Hennepin County, Minnesota",65,60,5,0,0,0,0,0,65,65,60,5,0,0,0,0,0,0,0,0,0,0,0,0,0
270530117032000,34,Hale,79,79,1000000US270530117032000,"Block 2000, Block Group 2, Census Tract 117.03, Hennepin County, Minnesota",74,63,6,0,3,0,0,2,74,72,61,6,0,3,0,0,2,2,2,0,0,0,0,0,0
270530117032004,34,Hale,79,79,1000000US270530117032004,"Block 2004, Block Group 2, Census Tract 117.03, Hennepin County, Minnesota",69,68,0,0,1,0,0,0,69,68,67,0,0,1,0,0,0,1,1,0,0,0,0,0,0
270530117031004,34,Hale,79,79,1000000US270530117031004,"Block 1004, Block Group 1, Census Tract 117.03, Hennepin County, Minnesota",61,51,0,0,4,0,4,2,61,55,50,0,0,4,0,0,1,6,1,0,0,0,0,4,1
270530117032006,34,Hale,79,79,1000000US270530117032006,"Block 2006, Block Group 2, Census Tract 117.03, Hennepin County, Minnesota",65,55,10,0,0,0,0,0,65,64,54,10,0,0,0,0,0,1,1,0,0,0,0,0,0
270530117031006,34,Hale,79,79,1000000US270530117031006,"Block 1006, Block Group 1, Census Tract 117.03, Hennepin County, Minnesota",52,49,3,0,0,0,0,0,52,51,48,3,0,0,0,0,0,1,1,0,0,0,0,0,0
270530117034003,34,Hale,79,79,1000000US270530117034003,"Block 4003, Block Group 4, Census Tract 117.03, Hennepin County, Minnesota",37,36,1,0,0,0,0,0,37,37,36,1,0,0,0,0,0,0,0,0,0,0,0,0,0
270530117032008,34,Hale,79,79,1000000US270530117032008,"Block 2008, Block Group 2, Census Tract 117.03, Hennepin County, Minnesota",0,0,0,0,0,0,0,0,0,0,0,0,0,0,0,0,0,0,0,0,0,0,0,0,0
270530117032005,34,Hale,79,79,1000000US270530117032005,"Block 2005, Block Group 2, Census Tract 117.03, Hennepin County, Minnesota",76,72,0,0,2,0,0,2,76,76,72,0,0,2,0,0,2,0,0,0,0,0,0,0,0
270530117032001,34,Hale,79,79,1000000US270530117032001,"Block 2001, Block Group 2, Census Tract 117.03, Hennepin County, Minnesota",74,73,0,0,1,0,0,0,74,72,71,0,0,1,0,0,0,2,2,0,0,0,0,0,0
270530117032003,34,Hale,79,79,1000000US270530117032003,"Block 2003, Block Group 2, Census Tract 117.03, Hennepin County, Minnesota",77,72,0,0,3,0,0,2,77,77,72,0,0,3,0,0,2,0,0,0,0,0,0,0,0
270530117033006,34,Hale,79,79,1000000US270530117033006,"Block 3006, Block Group 3, Census Tract 117.03, Hennepin County, Minnesota",74,58,4,0,1,0,3,8,74,68,58,4,0,1,0,0,5,6,0,0,0,0,0,3,3
270530117034005,34,Hale,79,79,1000000US270530117034005,"Block 4005, Block Group 4, Census Tract 117.03, Hennepin County, Minnesota",59,57,1,0,1,0,0,0,59,58,56,1,0,1,0,0,0,1,1,0,0,0,0,0,0
270530117034002,34,Hale,79,79,1000000US270530117034002,"Block 4002, Block Group 4, Census Tract 117.03, Hennepin County, Minnesota",83,62,3,3,1,0,8,6,83,73,62,3,1,1,0,0,6,10,0,0,2,0,0,8,0
270530117033014,34,Hale,79,79,1000000US270530117033014,"Block 3014, Block Group 3, Census Tract 117.03, Hennepin County, Minnesota",61,60,0,0,0,0,0,1,61,61,60,0,0,0,0,0,1,0,0,0,0,0,0,0,0
270530117032009,34,Hale,79,79,1000000US270530117032009,"Block 2009, Block Group 2, Census Tract 117.03, Hennepin County, Minnesota",55,50,0,1,1,0,0,3,55,55,50,0,1,1,0,0,3,0,0,0,0,0,0,0,0
270530117032010,34,Hale,79,79,1000000US270530117032010,"Block 2010, Block Group 2, Census Tract 117.03, Hennepin County, Minnesota",60,59,1,0,0,0,0,0,60,56,55,1,0,0,0,0,0,4,4,0,0,0,0,0,0
270530117034008,34,Hale,79,79,1000000US270530117034008,"Block 4008, Block Group 4, Census Tract 117.03, Hennepin County, Minnesota",79,74,1,0,3,0,0,1,79,79,74,1,0,3,0,0,1,0,0,0,0,0,0,0,0
270530117034009,34,Hale,79,79,1000000US270530117034009,"Block 4009, Block Group 4, Census Tract 117.03, Hennepin County, Minnesota",75,61,1,0,4,0,1,8,75,73,61,1,0,4,0,0,7,2,0,0,0,0,0,1,1
270530117034013,34,Hale,79,79,1000000US270530117034013,"Block 4013, Block Group 4, Census Tract 117.03, Hennepin County, Minnesota",50,48,1,0,0,0,1,0,50,49,48,1,0,0,0,0,0,1,0,0,0,0,0,1,0
270530117033000,34,Hale,79,79,1000000US270530117033000,"Block 3000, Block Group 3, Census Tract 117.03, Hennepin County, Minnesota",58,47,0,0,1,0,1,9,58,50,46,0,0,1,0,0,3,8,1,0,0,0,0,1,6
270530117033008,34,Hale,79,79,1000000US270530117033008,"Block 3008, Block Group 3, Census Tract 117.03, Hennepin County, Minnesota",84,68,8,0,2,0,1,5,84,83,68,8,0,2,0,0,5,1,0,0,0,0,0,1,0
270530117031003,34,Hale,79,79,1000000US270530117031003,"Block 1003, Block Group 1, Census Tract 117.03, Hennepin County, Minnesota",60,51,2,0,2,0,0,5,60,60,51,2,0,2,0,0,5,0,0,0,0,0,0,0,0
270530117031014,34,Hale,79,79,1000000US270530117031014,"Block 1014, Block Group 1, Census Tract 117.03, Hennepin County, Minnesota",0,0,0,0,0,0,0,0,0,0,0,0,0,0,0,0,0,0,0,0,0,0,0,0,0
270530117033002,34,Hale,79,79,1000000US270530117033002,"Block 3002, Block Group 3, Census Tract 117.03, Hennepin County, Minnesota",84,70,3,0,5,0,0,6,84,80,66,3,0,5,0,0,6,4,4,0,0,0,0,0,0
270530117034012,34,Hale,79,79,1000000US270530117034012,"Block 4012, Block Group 4, Census Tract 117.03, Hennepin County, Minnesota",0,0,0,0,0,0,0,0,0,0,0,0,0,0,0,0,0,0,0,0,0,0,0,0,0
270530117034004,34,Hale,79,79,1000000US270530117034004,"Block 4004, Block Group 4, Census Tract 117.03, Hennepin County, Minnesota",64,56,1,0,3,0,0,4,64,64,56,1,0,3,0,0,4,0,0,0,0,0,0,0,0
270530117033004,34,Hale,79,79,1000000US270530117033004,"Block 3004, Block Group 3, Census Tract 117.03, Hennepin County, Minnesota",52,46,0,0,1,0,0,5,52,52,46,0,0,1,0,0,5,0,0,0,0,0,0,0,0
270530117032007,34,Hale,79,79,1000000US270530117032007,"Block 2007, Block Group 2, Census Tract 117.03, Hennepin County, Minnesota",62,59,1,0,0,0,0,2,62,62,59,1,0,0,0,0,2,0,0,0,0,0,0,0,0
270530118004002,35,Keewaydin,80,80,1000000US270530118004002,"Block 4002, Block Group 4, Census Tract 118, Hennepin County, Minnesota",0,0,0,0,0,0,0,0,0,0,0,0,0,0,0,0,0,0,0,0,0,0,0,0,0
270530118004008,35,Keewaydin,80,80,1000000US270530118004008,"Block 4008, Block Group 4, Census Tract 118, Hennepin County, Minnesota",0,0,0,0,0,0,0,0,0,0,0,0,0,0,0,0,0,0,0,0,0,0,0,0,0
270530118004013,35,Keewaydin,80,80,1000000US270530118004013,"Block 4013, Block Group 4, Census Tract 118, Hennepin County, Minnesota",25,25,0,0,0,0,0,0,25,23,23,0,0,0,0,0,0,2,2,0,0,0,0,0,0
270530118004021,35,Keewaydin,80,80,1000000US270530118004021,"Block 4021, Block Group 4, Census Tract 118, Hennepin County, Minnesota",76,75,0,0,1,0,0,0,76,76,75,0,0,1,0,0,0,0,0,0,0,0,0,0,0
270530118001015,35,Keewaydin,80,80,1000000US270530118001015,"Block 1015, Block Group 1, Census Tract 118, Hennepin County, Minnesota",59,53,1,0,0,0,2,3,59,59,53,1,0,0,0,2,3,0,0,0,0,0,0,0,0
270530118001014,35,Keewaydin,80,80,1000000US270530118001014,"Block 1014, Block Group 1, Census Tract 118, Hennepin County, Minnesota",63,51,2,0,7,0,0,3,63,63,51,2,0,7,0,0,3,0,0,0,0,0,0,0,0
270530118001006,35,Keewaydin,80,80,1000000US270530118001006,"Block 1006, Block Group 1, Census Tract 118, Hennepin County, Minnesota",51,46,0,0,4,0,0,1,51,50,45,0,0,4,0,0,1,1,1,0,0,0,0,0,0
270530118004019,35,Keewaydin,80,80,1000000US270530118004019,"Block 4019, Block Group 4, Census Tract 118, Hennepin County, Minnesota",48,43,2,0,1,0,1,1,48,47,43,2,0,1,0,0,1,1,0,0,0,0,0,1,0
270530118004012,35,Keewaydin,80,80,1000000US270530118004012,"Block 4012, Block Group 4, Census Tract 118, Hennepin County, Minnesota",42,41,0,0,0,0,0,1,42,39,39,0,0,0,0,0,0,3,2,0,0,0,0,0,1
270530118001001,35,Keewaydin,80,80,1000000US270530118001001,"Block 1001, Block Group 1, Census Tract 118, Hennepin County, Minnesota",0,0,0,0,0,0,0,0,0,0,0,0,0,0,0,0,0,0,0,0,0,0,0,0,0
270530118004001,35,Keewaydin,80,80,1000000US270530118004001,"Block 4001, Block Group 4, Census Tract 118, Hennepin County, Minnesota",65,62,0,2,0,0,0,1,65,63,61,0,2,0,0,0,0,2,1,0,0,0,0,0,1
270530118004022,35,Keewaydin,80,80,1000000US270530118004022,"Block 4022, Block Group 4, Census Tract 118, Hennepin County, Minnesota",0,0,0,0,0,0,0,0,0,0,0,0,0,0,0,0,0,0,0,0,0,0,0,0,0
270530118001003,35,Keewaydin,80,80,1000000US270530118001003,"Block 1003, Block Group 1, Census Tract 118, Hennepin County, Minnesota",48,47,1,0,0,0,0,0,48,48,47,1,0,0,0,0,0,0,0,0,0,0,0,0,0
270530118001004,35,Keewaydin,80,80,1000000US270530118001004,"Block 1004, Block Group 1, Census Tract 118, Hennepin County, Minnesota",52,48,0,0,2,0,0,2,52,51,47,0,0,2,0,0,2,1,1,0,0,0,0,0,0
270530118001010,35,Keewaydin,80,80,1000000US270530118001010,"Block 1010, Block Group 1, Census Tract 118, Hennepin County, Minnesota",54,48,2,1,0,0,1,2,54,51,47,2,1,0,0,0,1,3,1,0,0,0,0,1,1
270530118004003,35,Keewaydin,80,80,1000000US270530118004003,"Block 4003, Block Group 4, Census Tract 118, Hennepin County, Minnesota",0,0,0,0,0,0,0,0,0,0,0,0,0,0,0,0,0,0,0,0,0,0,0,0,0
270530118004020,35,Keewaydin,80,80,1000000US270530118004020,"Block 4020, Block Group 4, Census Tract 118, Hennepin County, Minnesota",0,0,0,0,0,0,0,0,0,0,0,0,0,0,0,0,0,0,0,0,0,0,0,0,0
270530118004010,35,Keewaydin,80,80,1000000US270530118004010,"Block 4010, Block Group 4, Census Tract 118, Hennepin County, Minnesota",0,0,0,0,0,0,0,0,0,0,0,0,0,0,0,0,0,0,0,0,0,0,0,0,0
270530118004023,35,Keewaydin,80,80,1000000US270530118004023,"Block 4023, Block Group 4, Census Tract 118, Hennepin County, Minnesota",51,38,13,0,0,0,0,0,51,51,38,13,0,0,0,0,0,0,0,0,0,0,0,0,0
270530118004014,35,Keewaydin,80,80,1000000US270530118004014,"Block 4014, Block Group 4, Census Tract 118, Hennepin County, Minnesota",79,69,3,7,0,0,0,0,79,77,67,3,7,0,0,0,0,2,2,0,0,0,0,0,0
270530118001005,35,Keewaydin,80,80,1000000US270530118001005,"Block 1005, Block Group 1, Census Tract 118, Hennepin County, Minnesota",57,56,1,0,0,0,0,0,57,57,56,1,0,0,0,0,0,0,0,0,0,0,0,0,0
270530118001008,35,Keewaydin,80,80,1000000US270530118001008,"Block 1008, Block Group 1, Census Tract 118, Hennepin County, Minnesota",54,47,2,1,4,0,0,0,54,53,46,2,1,4,0,0,0,1,1,0,0,0,0,0,0
270530118004017,35,Keewaydin,80,80,1000000US270530118004017,"Block 4017, Block Group 4, Census Tract 118, Hennepin County, Minnesota",56,54,0,0,0,0,0,2,56,56,54,0,0,0,0,0,2,0,0,0,0,0,0,0,0
270530118002006,35,Keewaydin,80,80,1000000US270530118002006,"Block 2006, Block Group 2, Census Tract 118, Hennepin County, Minnesota",79,75,1,1,0,0,1,1,79,72,69,1,1,0,0,0,1,7,6,0,0,0,0,1,0
270530118002011,35,Keewaydin,80,80,1000000US270530118002011,"Block 2011, Block Group 2, Census Tract 118, Hennepin County, Minnesota",78,72,0,1,1,0,0,4,78,76,72,0,0,1,0,0,3,2,0,0,1,0,0,0,1
270530118003001,35,Keewaydin,80,80,1000000US270530118003001,"Block 3001, Block Group 3, Census Tract 118, Hennepin County, Minnesota",53,50,0,3,0,0,0,0,53,53,50,0,3,0,0,0,0,0,0,0,0,0,0,0,0
270530118001002,35,Keewaydin,80,80,1000000US270530118001002,"Block 1002, Block Group 1, Census Tract 118, Hennepin County, Minnesota",121,102,11,1,3,0,1,3,121,117,99,11,1,3,0,0,3,4,3,0,0,0,0,1,0
270530118001000,35,Keewaydin,80,80,1000000US270530118001000,"Block 1000, Block Group 1, Census Tract 118, Hennepin County, Minnesota",0,0,0,0,0,0,0,0,0,0,0,0,0,0,0,0,0,0,0,0,0,0,0,0,0
270530118004011,35,Keewaydin,80,80,1000000US270530118004011,"Block 4011, Block Group 4, Census Tract 118, Hennepin County, Minnesota",0,0,0,0,0,0,0,0,0,0,0,0,0,0,0,0,0,0,0,0,0,0,0,0,0
270530118003006,35,Keewaydin,80,80,1000000US270530118003006,"Block 3006, Block Group 3, Census Tract 118, Hennepin County, Minnesota",62,57,3,1,1,0,0,0,62,62,57,3,1,1,0,0,0,0,0,0,0,0,0,0,0
270530118002003,35,Keewaydin,80,80,1000000US270530118002003,"Block 2003, Block Group 2, Census Tract 118, Hennepin County, Minnesota",61,61,0,0,0,0,0,0,61,61,61,0,0,0,0,0,0,0,0,0,0,0,0,0,0
270530118002002,35,Keewaydin,80,80,1000000US270530118002002,"Block 2002, Block Group 2, Census Tract 118, Hennepin County, Minnesota",63,62,1,0,0,0,0,0,63,63,62,1,0,0,0,0,0,0,0,0,0,0,0,0,0
270530118002007,35,Keewaydin,80,80,1000000US270530118002007,"Block 2007, Block Group 2, Census Tract 118, Hennepin County, Minnesota",62,58,1,0,1,0,2,0,62,60,58,1,0,1,0,0,0,2,0,0,0,0,0,2,0
270530118002010,35,Keewaydin,80,80,1000000US270530118002010,"Block 2010, Block Group 2, Census Tract 118, Hennepin County, Minnesota",82,65,2,10,0,0,1,4,82,72,63,1,4,0,0,0,4,10,2,1,6,0,0,1,0
270530118003010,35,Keewaydin,80,80,1000000US270530118003010,"Block 3010, Block Group 3, Census Tract 118, Hennepin County, Minnesota",43,34,1,0,0,0,1,7,43,37,29,1,0,0,0,0,7,6,5,0,0,0,0,1,0
270530118003013,35,Keewaydin,80,80,1000000US270530118003013,"Block 3013, Block Group 3, Census Tract 118, Hennepin County, Minnesota",38,36,0,1,1,0,0,0,38,37,35,0,1,1,0,0,0,1,1,0,0,0,0,0,0
270530118002001,35,Keewaydin,80,80,1000000US270530118002001,"Block 2001, Block Group 2, Census Tract 118, Hennepin County, Minnesota",55,45,6,2,1,0,0,1,55,55,45,6,2,1,0,0,1,0,0,0,0,0,0,0,0
270530118002009,35,Keewaydin,80,80,1000000US270530118002009,"Block 2009, Block Group 2, Census Tract 118, Hennepin County, Minnesota",93,82,5,0,6,0,0,0,93,93,82,5,0,6,0,0,0,0,0,0,0,0,0,0,0
270530118003011,35,Keewaydin,80,80,1000000US270530118003011,"Block 3011, Block Group 3, Census Tract 118, Hennepin County, Minnesota",42,33,5,1,0,0,1,2,42,41,33,5,1,0,0,0,2,1,0,0,0,0,0,1,0
270530118004024,35,Keewaydin,80,80,1000000US270530118004024,"Block 4024, Block Group 4, Census Tract 118, Hennepin County, Minnesota",64,53,0,4,0,0,0,7,64,64,53,0,4,0,0,0,7,0,0,0,0,0,0,0,0
270530118003005,35,Keewaydin,80,80,1000000US270530118003005,"Block 3005, Block Group 3, Census Tract 118, Hennepin County, Minnesota",63,56,1,2,1,0,0,3,63,61,55,1,2,1,0,0,2,2,1,0,0,0,0,0,1
270530118002005,35,Keewaydin,80,80,1000000US270530118002005,"Block 2005, Block Group 2, Census Tract 118, Hennepin County, Minnesota",77,68,2,1,2,0,0,4,77,77,68,2,1,2,0,0,4,0,0,0,0,0,0,0,0
270530118003003,35,Keewaydin,80,80,1000000US270530118003003,"Block 3003, Block Group 3, Census Tract 118, Hennepin County, Minnesota",0,0,0,0,0,0,0,0,0,0,0,0,0,0,0,0,0,0,0,0,0,0,0,0,0
270530118004015,35,Keewaydin,80,80,1000000US270530118004015,"Block 4015, Block Group 4, Census Tract 118, Hennepin County, Minnesota",67,64,2,0,1,0,0,0,67,66,63,2,0,1,0,0,0,1,1,0,0,0,0,0,0
270530118003004,35,Keewaydin,80,80,1000000US270530118003004,"Block 3004, Block Group 3, Census Tract 118, Hennepin County, Minnesota",44,42,1,0,1,0,0,0,44,40,38,1,0,1,0,0,0,4,4,0,0,0,0,0,0
270530118003000,35,Keewaydin,80,80,1000000US270530118003000,"Block 3000, Block Group 3, Census Tract 118, Hennepin County, Minnesota",55,41,3,2,2,0,6,1,55,45,37,3,2,2,0,0,1,10,4,0,0,0,0,6,0
270530118004018,35,Keewaydin,80,80,1000000US270530118004018,"Block 4018, Block Group 4, Census Tract 118, Hennepin County, Minnesota",61,55,0,0,3,0,0,3,61,61,55,0,0,3,0,0,3,0,0,0,0,0,0,0,0
270530118003009,35,Keewaydin,80,80,1000000US270530118003009,"Block 3009, Block Group 3, Census Tract 118, Hennepin County, Minnesota",57,53,1,0,2,0,0,1,57,51,47,1,0,2,0,0,1,6,6,0,0,0,0,0,0
270530118002000,35,Keewaydin,80,80,1000000US270530118002000,"Block 2000, Block Group 2, Census Tract 118, Hennepin County, Minnesota",55,49,1,1,1,0,0,3,55,48,45,1,1,1,0,0,0,7,4,0,0,0,0,0,3
270530118004006,35,Keewaydin,80,80,1000000US270530118004006,"Block 4006, Block Group 4, Census Tract 118, Hennepin County, Minnesota",0,0,0,0,0,0,0,0,0,0,0,0,0,0,0,0,0,0,0,0,0,0,0,0,0
270530118001011,35,Keewaydin,80,80,1000000US270530118001011,"Block 1011, Block Group 1, Census Tract 118, Hennepin County, Minnesota",59,50,0,6,0,0,0,3,59,59,50,0,6,0,0,0,3,0,0,0,0,0,0,0,0
270530118001007,35,Keewaydin,80,80,1000000US270530118001007,"Block 1007, Block Group 1, Census Tract 118, Hennepin County, Minnesota",45,43,0,0,2,0,0,0,45,45,43,0,0,2,0,0,0,0,0,0,0,0,0,0,0
270530118004025,35,Keewaydin,80,80,1000000US270530118004025,"Block 4025, Block Group 4, Census Tract 118, Hennepin County, Minnesota",60,60,0,0,0,0,0,0,60,56,56,0,0,0,0,0,0,4,4,0,0,0,0,0,0
270530118002004,35,Keewaydin,80,80,1000000US270530118002004,"Block 2004, Block Group 2, Census Tract 118, Hennepin County, Minnesota",69,63,5,0,0,0,0,1,69,66,60,5,0,0,0,0,1,3,3,0,0,0,0,0,0
270530118003007,35,Keewaydin,80,80,1000000US270530118003007,"Block 3007, Block Group 3, Census Tract 118, Hennepin County, Minnesota",54,44,7,2,0,0,0,1,54,54,44,7,2,0,0,0,1,0,0,0,0,0,0,0,0
270530118003008,35,Keewaydin,80,80,1000000US270530118003008,"Block 3008, Block Group 3, Census Tract 118, Hennepin County, Minnesota",71,69,1,0,0,0,1,0,71,67,66,1,0,0,0,0,0,4,3,0,0,0,0,1,0
270530118002008,35,Keewaydin,80,80,1000000US270530118002008,"Block 2008, Block Group 2, Census Tract 118, Hennepin County, Minnesota",52,49,0,0,0,0,0,3,52,52,49,0,0,0,0,0,3,0,0,0,0,0,0,0,0
270530118003012,35,Keewaydin,80,80,1000000US270530118003012,"Block 3012, Block Group 3, Census Tract 118, Hennepin County, Minnesota",45,38,1,0,3,0,0,3,45,40,36,1,0,3,0,0,0,5,2,0,0,0,0,0,3
270530118004004,35,Keewaydin,80,80,1000000US270530118004004,"Block 4004, Block Group 4, Census Tract 118, Hennepin County, Minnesota",0,0,0,0,0,0,0,0,0,0,0,0,0,0,0,0,0,0,0,0,0,0,0,0,0
270530118004005,35,Keewaydin,80,80,1000000US270530118004005,"Block 4005, Block Group 4, Census Tract 118, Hennepin County, Minnesota",0,0,0,0,0,0,0,0,0,0,0,0,0,0,0,0,0,0,0,0,0,0,0,0,0
270530118004007,35,Keewaydin,80,80,1000000US270530118004007,"Block 4007, Block Group 4, Census Tract 118, Hennepin County, Minnesota",0,0,0,0,0,0,0,0,0,0,0,0,0,0,0,0,0,0,0,0,0,0,0,0,0
270530118004000,35,Keewaydin,80,80,1000000US270530118004000,"Block 4000, Block Group 4, Census Tract 118, Hennepin County, Minnesota",0,0,0,0,0,0,0,0,0,0,0,0,0,0,0,0,0,0,0,0,0,0,0,0,0
270530118001013,35,Keewaydin,80,80,1000000US270530118001013,"Block 1013, Block Group 1, Census Tract 118, Hennepin County, Minnesota",52,50,2,0,0,0,0,0,52,51,49,2,0,0,0,0,0,1,1,0,0,0,0,0,0
270530118001012,35,Keewaydin,80,80,1000000US270530118001012,"Block 1012, Block Group 1, Census Tract 118, Hennepin County, Minnesota",60,57,0,0,2,0,0,1,60,59,56,0,0,2,0,0,1,1,1,0,0,0,0,0,0
270530118001009,35,Keewaydin,80,80,1000000US270530118001009,"Block 1009, Block Group 1, Census Tract 118, Hennepin County, Minnesota",43,37,0,1,0,0,1,4,43,37,36,0,1,0,0,0,0,6,1,0,0,0,0,1,4
270530118004016,35,Keewaydin,80,80,1000000US270530118004016,"Block 4016, Block Group 4, Census Tract 118, Hennepin County, Minnesota",83,59,0,6,0,0,18,0,83,60,54,0,6,0,0,0,0,23,5,0,0,0,0,18,0
270530118003002,35,Keewaydin,80,80,1000000US270530118003002,"Block 3002, Block Group 3, Census Tract 118, Hennepin County, Minnesota",48,44,1,0,0,0,0,3,48,47,43,1,0,0,0,0,3,1,1,0,0,0,0,0,0
270531112002014,36,Fulton,72,72,1000000US270531112002014,"Block 2014, Block Group 2, Census Tract 1112, Hennepin County, Minnesota",57,55,0,2,0,0,0,0,57,54,54,0,0,0,0,0,0,3,1,0,2,0,0,0,0
270531113004006,36,Fulton,72,72,1000000US270531113004006,"Block 4006, Block Group 4, Census Tract 1113, Hennepin County, Minnesota",63,61,0,0,2,0,0,0,63,63,61,0,0,2,0,0,0,0,0,0,0,0,0,0,0
270531112001011,36,Fulton,72,72,1000000US270531112001011,"Block 1011, Block Group 1, Census Tract 1112, Hennepin County, Minnesota",0,0,0,0,0,0,0,0,0,0,0,0,0,0,0,0,0,0,0,0,0,0,0,0,0
270531112003014,36,Fulton,72,72,1000000US270531112003014,"Block 3014, Block Group 3, Census Tract 1112, Hennepin County, Minnesota",58,58,0,0,0,0,0,0,58,57,57,0,0,0,0,0,0,1,1,0,0,0,0,0,0
270531112001008,36,Fulton,72,72,1000000US270531112001008,"Block 1008, Block Group 1, Census Tract 1112, Hennepin County, Minnesota",30,30,0,0,0,0,0,0,30,30,30,0,0,0,0,0,0,0,0,0,0,0,0,0,0
270531112001009,36,Fulton,72,72,1000000US270531112001009,"Block 1009, Block Group 1, Census Tract 1112, Hennepin County, Minnesota",58,53,1,0,3,0,0,1,58,58,53,1,0,3,0,0,1,0,0,0,0,0,0,0,0
270531112001004,36,Fulton,72,72,1000000US270531112001004,"Block 1004, Block Group 1, Census Tract 1112, Hennepin County, Minnesota",56,54,0,0,2,0,0,0,56,56,54,0,0,2,0,0,0,0,0,0,0,0,0,0,0
270531112001020,36,Fulton,72,72,1000000US270531112001020,"Block 1020, Block Group 1, Census Tract 1112, Hennepin County, Minnesota",47,47,0,0,0,0,0,0,47,46,46,0,0,0,0,0,0,1,1,0,0,0,0,0,0
270531112001019,36,Fulton,72,72,1000000US270531112001019,"Block 1019, Block Group 1, Census Tract 1112, Hennepin County, Minnesota",48,47,0,0,1,0,0,0,48,48,47,0,0,1,0,0,0,0,0,0,0,0,0,0,0
270531112003006,36,Fulton,72,72,1000000US270531112003006,"Block 3006, Block Group 3, Census Tract 1112, Hennepin County, Minnesota",68,64,1,0,1,0,0,2,68,63,59,1,0,1,0,0,2,5,5,0,0,0,0,0,0
270531112003005,36,Fulton,72,72,1000000US270531112003005,"Block 3005, Block Group 3, Census Tract 1112, Hennepin County, Minnesota",73,64,4,0,1,0,0,4,73,68,63,1,0,1,0,0,3,5,1,3,0,0,0,0,1
270531112003011,36,Fulton,72,72,1000000US270531112003011,"Block 3011, Block Group 3, Census Tract 1112, Hennepin County, Minnesota",54,49,0,0,3,2,0,0,54,54,49,0,0,3,2,0,0,0,0,0,0,0,0,0,0
270531112001014,36,Fulton,72,72,1000000US270531112001014,"Block 1014, Block Group 1, Census Tract 1112, Hennepin County, Minnesota",75,69,0,0,2,0,1,3,75,65,60,0,0,2,0,0,3,10,9,0,0,0,0,1,0
270530106002017,36,Fulton,72,72,1000000US270530106002017,"Block 2017, Block Group 2, Census Tract 106, Hennepin County, Minnesota",63,61,1,0,1,0,0,0,63,63,61,1,0,1,0,0,0,0,0,0,0,0,0,0,0
270530106002000,36,Fulton,72,72,1000000US270530106002000,"Block 2000, Block Group 2, Census Tract 106, Hennepin County, Minnesota",39,36,0,0,1,0,0,2,39,39,36,0,0,1,0,0,2,0,0,0,0,0,0,0,0
270530106002010,36,Fulton,72,72,1000000US270530106002010,"Block 2010, Block Group 2, Census Tract 106, Hennepin County, Minnesota",53,50,0,0,3,0,0,0,53,53,50,0,0,3,0,0,0,0,0,0,0,0,0,0,0
270531112002002,36,Fulton,72,72,1000000US270531112002002,"Block 2002, Block Group 2, Census Tract 1112, Hennepin County, Minnesota",46,45,1,0,0,0,0,0,46,45,44,1,0,0,0,0,0,1,1,0,0,0,0,0,0
270531112003001,36,Fulton,72,72,1000000US270531112003001,"Block 3001, Block Group 3, Census Tract 1112, Hennepin County, Minnesota",70,65,0,0,3,0,0,2,70,70,65,0,0,3,0,0,2,0,0,0,0,0,0,0,0
270531112002007,36,Fulton,72,72,1000000US270531112002007,"Block 2007, Block Group 2, Census Tract 1112, Hennepin County, Minnesota",22,11,6,3,0,0,0,2,22,22,11,6,3,0,0,0,2,0,0,0,0,0,0,0,0
270531112002004,36,Fulton,72,72,1000000US270531112002004,"Block 2004, Block Group 2, Census Tract 1112, Hennepin County, Minnesota",52,43,0,0,0,0,0,9,52,51,43,0,0,0,0,0,8,1,0,0,0,0,0,0,1
270531112002011,36,Fulton,72,72,1000000US270531112002011,"Block 2011, Block Group 2, Census Tract 1112, Hennepin County, Minnesota",44,43,0,1,0,0,0,0,44,40,39,0,1,0,0,0,0,4,4,0,0,0,0,0,0
270531112003003,36,Fulton,72,72,1000000US270531112003003,"Block 3003, Block Group 3, Census Tract 1112, Hennepin County, Minnesota",65,61,0,0,0,0,1,3,65,62,59,0,0,0,0,0,3,3,2,0,0,0,0,1,0
270530106002008,36,Fulton,72,72,1000000US270530106002008,"Block 2008, Block Group 2, Census Tract 106, Hennepin County, Minnesota",2,2,0,0,0,0,0,0,2,2,2,0,0,0,0,0,0,0,0,0,0,0,0,0,0
270530106002016,36,Fulton,72,72,1000000US270530106002016,"Block 2016, Block Group 2, Census Tract 106, Hennepin County, Minnesota",69,65,0,0,0,0,4,0,69,68,65,0,0,0,0,3,0,1,0,0,0,0,0,1,0
270530106002015,36,Fulton,72,72,1000000US270530106002015,"Block 2015, Block Group 2, Census Tract 106, Hennepin County, Minnesota",71,60,6,0,4,0,1,0,71,70,59,6,0,4,0,1,0,1,1,0,0,0,0,0,0
270531112002001,36,Fulton,72,72,1000000US270531112002001,"Block 2001, Block Group 2, Census Tract 1112, Hennepin County, Minnesota",23,23,0,0,0,0,0,0,23,23,23,0,0,0,0,0,0,0,0,0,0,0,0,0,0
270531112002005,36,Fulton,72,72,1000000US270531112002005,"Block 2005, Block Group 2, Census Tract 1112, Hennepin County, Minnesota",59,56,1,0,2,0,0,0,59,59,56,1,0,2,0,0,0,0,0,0,0,0,0,0,0
270531112002010,36,Fulton,72,72,1000000US270531112002010,"Block 2010, Block Group 2, Census Tract 1112, Hennepin County, Minnesota",45,43,0,0,2,0,0,0,45,45,43,0,0,2,0,0,0,0,0,0,0,0,0,0,0
270531112003010,36,Fulton,72,72,1000000US270531112003010,"Block 3010, Block Group 3, Census Tract 1112, Hennepin County, Minnesota",62,59,1,0,0,0,1,1,62,60,58,1,0,0,0,0,1,2,1,0,0,0,0,1,0
270531112001002,36,Fulton,72,72,1000000US270531112001002,"Block 1002, Block Group 1, Census Tract 1112, Hennepin County, Minnesota",60,51,7,0,0,0,0,2,60,59,50,7,0,0,0,0,2,1,1,0,0,0,0,0,0
270531112001000,36,Fulton,72,72,1000000US270531112001000,"Block 1000, Block Group 1, Census Tract 1112, Hennepin County, Minnesota",40,36,0,0,2,0,0,2,40,40,36,0,0,2,0,0,2,0,0,0,0,0,0,0,0
270530106002005,36,Fulton,72,72,1000000US270530106002005,"Block 2005, Block Group 2, Census Tract 106, Hennepin County, Minnesota",86,81,1,0,0,0,0,4,86,85,81,1,0,0,0,0,3,1,0,0,0,0,0,0,1
270530106002007,36,Fulton,72,72,1000000US270530106002007,"Block 2007, Block Group 2, Census Tract 106, Hennepin County, Minnesota",70,69,1,0,0,0,0,0,70,68,67,1,0,0,0,0,0,2,2,0,0,0,0,0,0
270530106002014,36,Fulton,72,72,1000000US270530106002014,"Block 2014, Block Group 2, Census Tract 106, Hennepin County, Minnesota",57,54,0,0,3,0,0,0,57,54,51,0,0,3,0,0,0,3,3,0,0,0,0,0,0
270531112002000,36,Fulton,72,72,1000000US270531112002000,"Block 2000, Block Group 2, Census Tract 1112, Hennepin County, Minnesota",52,48,0,0,2,0,0,2,52,51,47,0,0,2,0,0,2,1,1,0,0,0,0,0,0
270531112002012,36,Fulton,72,72,1000000US270531112002012,"Block 2012, Block Group 2, Census Tract 1112, Hennepin County, Minnesota",68,56,0,1,1,0,9,1,68,58,56,0,1,1,0,0,0,10,0,0,0,0,0,9,1
270531112001013,36,Fulton,72,72,1000000US270531112001013,"Block 1013, Block Group 1, Census Tract 1112, Hennepin County, Minnesota",60,56,1,2,0,0,0,1,60,59,55,1,2,0,0,0,1,1,1,0,0,0,0,0,0
270531112003002,36,Fulton,72,72,1000000US270531112003002,"Block 3002, Block Group 3, Census Tract 1112, Hennepin County, Minnesota",74,69,1,0,4,0,0,0,74,74,69,1,0,4,0,0,0,0,0,0,0,0,0,0,0
270531113003008,36,Fulton,72,72,1000000US270531113003008,"Block 3008, Block Group 3, Census Tract 1113, Hennepin County, Minnesota",28,25,0,0,0,0,0,3,28,28,25,0,0,0,0,0,3,0,0,0,0,0,0,0,0
270531112002008,36,Fulton,72,72,1000000US270531112002008,"Block 2008, Block Group 2, Census Tract 1112, Hennepin County, Minnesota",57,51,5,0,0,0,0,1,57,54,48,5,0,0,0,0,1,3,3,0,0,0,0,0,0
270531112002009,36,Fulton,72,72,1000000US270531112002009,"Block 2009, Block Group 2, Census Tract 1112, Hennepin County, Minnesota",43,37,1,0,4,0,0,1,43,41,35,1,0,4,0,0,1,2,2,0,0,0,0,0,0
270531112003008,36,Fulton,72,72,1000000US270531112003008,"Block 3008, Block Group 3, Census Tract 1112, Hennepin County, Minnesota",53,49,3,0,0,0,0,1,53,51,47,3,0,0,0,0,1,2,2,0,0,0,0,0,0
270530106002019,36,Fulton,72,72,1000000US270530106002019,"Block 2019, Block Group 2, Census Tract 106, Hennepin County, Minnesota",59,52,4,0,2,0,0,1,59,59,52,4,0,2,0,0,1,0,0,0,0,0,0,0,0
270530106002020,36,Fulton,72,72,1000000US270530106002020,"Block 2020, Block Group 2, Census Tract 106, Hennepin County, Minnesota",69,64,0,0,5,0,0,0,69,69,64,0,0,5,0,0,0,0,0,0,0,0,0,0,0
270531113004003,36,Fulton,72,72,1000000US270531113004003,"Block 4003, Block Group 4, Census Tract 1113, Hennepin County, Minnesota",43,41,0,0,1,0,1,0,43,41,40,0,0,1,0,0,0,2,1,0,0,0,0,1,0
270531113003002,36,Fulton,72,72,1000000US270531113003002,"Block 3002, Block Group 3, Census Tract 1113, Hennepin County, Minnesota",63,51,0,0,6,0,0,6,63,62,50,0,0,6,0,0,6,1,1,0,0,0,0,0,0
270530106002013,36,Fulton,72,72,1000000US270530106002013,"Block 2013, Block Group 2, Census Tract 106, Hennepin County, Minnesota",68,62,3,0,2,0,1,0,68,67,62,3,0,2,0,0,0,1,0,0,0,0,0,1,0
270531113003006,36,Fulton,72,72,1000000US270531113003006,"Block 3006, Block Group 3, Census Tract 1113, Hennepin County, Minnesota",81,77,2,0,1,0,1,0,81,80,77,2,0,1,0,0,0,1,0,0,0,0,0,1,0
270531112003000,36,Fulton,72,72,1000000US270531112003000,"Block 3000, Block Group 3, Census Tract 1112, Hennepin County, Minnesota",64,60,0,0,2,0,0,2,64,62,60,0,0,1,0,0,1,2,0,0,0,1,0,0,1
270531112003015,36,Fulton,72,72,1000000US270531112003015,"Block 3015, Block Group 3, Census Tract 1112, Hennepin County, Minnesota",51,47,2,0,0,0,2,0,51,48,44,2,0,0,0,2,0,3,3,0,0,0,0,0,0
270531113004011,36,Fulton,72,72,1000000US270531113004011,"Block 4011, Block Group 4, Census Tract 1113, Hennepin County, Minnesota",100,95,1,0,3,0,0,1,100,98,93,1,0,3,0,0,1,2,2,0,0,0,0,0,0
270531113004008,36,Fulton,72,72,1000000US270531113004008,"Block 4008, Block Group 4, Census Tract 1113, Hennepin County, Minnesota",65,57,4,0,3,0,0,1,65,60,55,1,0,3,0,0,1,5,2,3,0,0,0,0,0
270531113003010,36,Fulton,72,72,1000000US270531113003010,"Block 3010, Block Group 3, Census Tract 1113, Hennepin County, Minnesota",91,90,0,0,1,0,0,0,91,91,90,0,0,1,0,0,0,0,0,0,0,0,0,0,0
270530106002011,36,Fulton,72,72,1000000US270530106002011,"Block 2011, Block Group 2, Census Tract 106, Hennepin County, Minnesota",34,32,0,0,0,0,1,1,34,32,32,0,0,0,0,0,0,2,0,0,0,0,0,1,1
270531113004002,36,Fulton,72,72,1000000US270531113004002,"Block 4002, Block Group 4, Census Tract 1113, Hennepin County, Minnesota",98,92,3,0,3,0,0,0,98,93,87,3,0,3,0,0,0,5,5,0,0,0,0,0,0
270531113004007,36,Fulton,72,72,1000000US270531113004007,"Block 4007, Block Group 4, Census Tract 1113, Hennepin County, Minnesota",71,65,0,0,1,0,3,2,71,68,65,0,0,1,0,0,2,3,0,0,0,0,0,3,0
270531113004005,36,Fulton,72,72,1000000US270531113004005,"Block 4005, Block Group 4, Census Tract 1113, Hennepin County, Minnesota",61,55,2,1,1,0,0,2,61,61,55,2,1,1,0,0,2,0,0,0,0,0,0,0,0
270531113003014,36,Fulton,72,72,1000000US270531113003014,"Block 3014, Block Group 3, Census Tract 1113, Hennepin County, Minnesota",59,55,0,0,2,0,2,0,59,59,55,0,0,2,0,2,0,0,0,0,0,0,0,0,0
270531112002015,36,Fulton,72,72,1000000US270531112002015,"Block 2015, Block Group 2, Census Tract 1112, Hennepin County, Minnesota",50,45,1,0,1,0,0,3,50,49,44,1,0,1,0,0,3,1,1,0,0,0,0,0,0
270531113004009,36,Fulton,72,72,1000000US270531113004009,"Block 4009, Block Group 4, Census Tract 1113, Hennepin County, Minnesota",68,65,0,0,3,0,0,0,68,68,65,0,0,3,0,0,0,0,0,0,0,0,0,0,0
270531113003004,36,Fulton,72,72,1000000US270531113003004,"Block 3004, Block Group 3, Census Tract 1113, Hennepin County, Minnesota",72,59,8,0,2,0,0,3,72,69,56,8,0,2,0,0,3,3,3,0,0,0,0,0,0
270531113003001,36,Fulton,72,72,1000000US270531113003001,"Block 3001, Block Group 3, Census Tract 1113, Hennepin County, Minnesota",73,72,0,0,0,0,0,1,73,73,72,0,0,0,0,0,1,0,0,0,0,0,0,0,0
270531113003007,36,Fulton,72,72,1000000US270531113003007,"Block 3007, Block Group 3, Census Tract 1113, Hennepin County, Minnesota",67,64,0,0,1,0,0,2,67,67,64,0,0,1,0,0,2,0,0,0,0,0,0,0,0
270531113003013,36,Fulton,72,72,1000000US270531113003013,"Block 3013, Block Group 3, Census Tract 1113, Hennepin County, Minnesota",30,26,2,0,2,0,0,0,30,30,26,2,0,2,0,0,0,0,0,0,0,0,0,0,0
270531113003000,36,Fulton,72,72,1000000US270531113003000,"Block 3000, Block Group 3, Census Tract 1113, Hennepin County, Minnesota",76,69,4,0,1,0,0,2,76,72,65,4,0,1,0,0,2,4,4,0,0,0,0,0,0
270531112001021,36,Fulton,72,72,1000000US270531112001021,"Block 1021, Block Group 1, Census Tract 1112, Hennepin County, Minnesota",39,34,0,0,3,0,0,2,39,39,34,0,0,3,0,0,2,0,0,0,0,0,0,0,0
270531112001006,36,Fulton,72,72,1000000US270531112001006,"Block 1006, Block Group 1, Census Tract 1112, Hennepin County, Minnesota",58,54,0,0,4,0,0,0,58,58,54,0,0,4,0,0,0,0,0,0,0,0,0,0,0
270530106002004,36,Fulton,72,72,1000000US270530106002004,"Block 2004, Block Group 2, Census Tract 106, Hennepin County, Minnesota",77,71,0,0,6,0,0,0,77,76,70,0,0,6,0,0,0,1,1,0,0,0,0,0,0
270531112003007,36,Fulton,72,72,1000000US270531112003007,"Block 3007, Block Group 3, Census Tract 1112, Hennepin County, Minnesota",66,62,4,0,0,0,0,0,66,66,62,4,0,0,0,0,0,0,0,0,0,0,0,0,0
270531112002006,36,Fulton,72,72,1000000US270531112002006,"Block 2006, Block Group 2, Census Tract 1112, Hennepin County, Minnesota",45,30,8,0,3,0,0,4,45,45,30,8,0,3,0,0,4,0,0,0,0,0,0,0,0
270531112003004,36,Fulton,72,72,1000000US270531112003004,"Block 3004, Block Group 3, Census Tract 1112, Hennepin County, Minnesota",56,49,0,0,6,0,0,1,56,56,49,0,0,6,0,0,1,0,0,0,0,0,0,0,0
270530106002018,36,Fulton,72,72,1000000US270530106002018,"Block 2018, Block Group 2, Census Tract 106, Hennepin County, Minnesota",0,0,0,0,0,0,0,0,0,0,0,0,0,0,0,0,0,0,0,0,0,0,0,0,0
270531112001001,36,Fulton,72,72,1000000US270531112001001,"Block 1001, Block Group 1, Census Tract 1112, Hennepin County, Minnesota",59,56,0,0,0,0,3,0,59,54,54,0,0,0,0,0,0,5,2,0,0,0,0,3,0
270531112001012,36,Fulton,72,72,1000000US270531112001012,"Block 1012, Block Group 1, Census Tract 1112, Hennepin County, Minnesota",59,51,0,0,1,0,0,7,59,54,51,0,0,1,0,0,2,5,0,0,0,0,0,0,5
270531112001005,36,Fulton,72,72,1000000US270531112001005,"Block 1005, Block Group 1, Census Tract 1112, Hennepin County, Minnesota",61,60,0,1,0,0,0,0,61,60,60,0,0,0,0,0,0,1,0,0,1,0,0,0,0
270531112001010,36,Fulton,72,72,1000000US270531112001010,"Block 1010, Block Group 1, Census Tract 1112, Hennepin County, Minnesota",62,54,0,0,4,0,4,0,62,58,54,0,0,4,0,0,0,4,0,0,0,0,0,4,0
270531112001018,36,Fulton,72,72,1000000US270531112001018,"Block 1018, Block Group 1, Census Tract 1112, Hennepin County, Minnesota",0,0,0,0,0,0,0,0,0,0,0,0,0,0,0,0,0,0,0,0,0,0,0,0,0
270531112003009,36,Fulton,72,72,1000000US270531112003009,"Block 3009, Block Group 3, Census Tract 1112, Hennepin County, Minnesota",56,53,0,0,1,0,0,2,56,56,53,0,0,1,0,0,2,0,0,0,0,0,0,0,0
270531112003012,36,Fulton,72,72,1000000US270531112003012,"Block 3012, Block Group 3, Census Tract 1112, Hennepin County, Minnesota",64,56,1,2,3,0,0,2,64,64,56,1,2,3,0,0,2,0,0,0,0,0,0,0,0
270530106002003,36,Fulton,72,72,1000000US270530106002003,"Block 2003, Block Group 2, Census Tract 106, Hennepin County, Minnesota",72,64,5,0,0,0,1,2,72,72,64,5,0,0,0,1,2,0,0,0,0,0,0,0,0
270530106002001,36,Fulton,72,72,1000000US270530106002001,"Block 2001, Block Group 2, Census Tract 106, Hennepin County, Minnesota",60,58,2,0,0,0,0,0,60,60,58,2,0,0,0,0,0,0,0,0,0,0,0,0,0
270530106002002,36,Fulton,72,72,1000000US270530106002002,"Block 2002, Block Group 2, Census Tract 106, Hennepin County, Minnesota",70,69,0,0,0,0,1,0,70,68,68,0,0,0,0,0,0,2,1,0,0,0,0,1,0
270530106002006,36,Fulton,72,72,1000000US270530106002006,"Block 2006, Block Group 2, Census Tract 106, Hennepin County, Minnesota",77,75,0,0,1,0,0,1,77,73,71,0,0,1,0,0,1,4,4,0,0,0,0,0,0
270530106002009,36,Fulton,72,72,1000000US270530106002009,"Block 2009, Block Group 2, Census Tract 106, Hennepin County, Minnesota",38,35,1,0,1,0,0,1,38,38,35,1,0,1,0,0,1,0,0,0,0,0,0,0,0
270531112001016,36,Fulton,72,72,1000000US270531112001016,"Block 1016, Block Group 1, Census Tract 1112, Hennepin County, Minnesota",77,76,1,0,0,0,0,0,77,76,75,1,0,0,0,0,0,1,1,0,0,0,0,0,0
270531112002013,36,Fulton,72,72,1000000US270531112002013,"Block 2013, Block Group 2, Census Tract 1112, Hennepin County, Minnesota",69,58,0,0,7,0,1,3,69,63,56,0,0,7,0,0,0,6,2,0,0,0,0,1,3
270531112003013,36,Fulton,72,72,1000000US270531112003013,"Block 3013, Block Group 3, Census Tract 1112, Hennepin County, Minnesota",63,55,2,0,1,0,2,3,63,61,55,2,0,1,0,1,2,2,0,0,0,0,0,1,1
270531113004010,36,Fulton,72,72,1000000US270531113004010,"Block 4010, Block Group 4, Census Tract 1113, Hennepin County, Minnesota",66,66,0,0,0,0,0,0,66,64,64,0,0,0,0,0,0,2,2,0,0,0,0,0,0
270531113004000,36,Fulton,72,72,1000000US270531113004000,"Block 4000, Block Group 4, Census Tract 1113, Hennepin County, Minnesota",67,63,2,0,0,0,1,1,67,65,62,2,0,0,0,0,1,2,1,0,0,0,0,1,0
270531113003005,36,Fulton,72,72,1000000US270531113003005,"Block 3005, Block Group 3, Census Tract 1113, Hennepin County, Minnesota",55,52,0,0,1,0,0,2,55,55,52,0,0,1,0,0,2,0,0,0,0,0,0,0,0
270531113003012,36,Fulton,72,72,1000000US270531113003012,"Block 3012, Block Group 3, Census Tract 1113, Hennepin County, Minnesota",20,20,0,0,0,0,0,0,20,20,20,0,0,0,0,0,0,0,0,0,0,0,0,0,0
270530106002012,36,Fulton,72,72,1000000US270530106002012,"Block 2012, Block Group 2, Census Tract 106, Hennepin County, Minnesota",66,65,1,0,0,0,0,0,66,64,63,1,0,0,0,0,0,2,2,0,0,0,0,0,0
270531113004004,36,Fulton,72,72,1000000US270531113004004,"Block 4004, Block Group 4, Census Tract 1113, Hennepin County, Minnesota",58,52,2,2,1,0,1,0,58,52,49,1,1,1,0,0,0,6,3,1,1,0,0,1,0
270531113004001,36,Fulton,72,72,1000000US270531113004001,"Block 4001, Block Group 4, Census Tract 1113, Hennepin County, Minnesota",73,63,1,0,4,0,3,2,73,70,63,1,0,4,0,0,2,3,0,0,0,0,0,3,0
270531112001007,36,Fulton,72,72,1000000US270531112001007,"Block 1007, Block Group 1, Census Tract 1112, Hennepin County, Minnesota",74,48,11,0,8,0,7,0,74,62,43,11,0,8,0,0,0,12,5,0,0,0,0,7,0
270531113004012,36,Fulton,72,72,1000000US270531113004012,"Block 4012, Block Group 4, Census Tract 1113, Hennepin County, Minnesota",36,34,0,0,2,0,0,0,36,36,34,0,0,2,0,0,0,0,0,0,0,0,0,0,0
270531113003003,36,Fulton,72,72,1000000US270531113003003,"Block 3003, Block Group 3, Census Tract 1113, Hennepin County, Minnesota",64,57,2,0,1,0,0,4,64,64,57,2,0,1,0,0,4,0,0,0,0,0,0,0,0
270531113003009,36,Fulton,72,72,1000000US270531113003009,"Block 3009, Block Group 3, Census Tract 1113, Hennepin County, Minnesota",49,49,0,0,0,0,0,0,49,49,49,0,0,0,0,0,0,0,0,0,0,0,0,0,0
270531113003011,36,Fulton,72,72,1000000US270531113003011,"Block 3011, Block Group 3, Census Tract 1113, Hennepin County, Minnesota",63,60,0,0,0,0,1,2,63,61,60,0,0,0,0,0,1,2,0,0,0,0,0,1,1
270531112001015,36,Fulton,72,72,1000000US270531112001015,"Block 1015, Block Group 1, Census Tract 1112, Hennepin County, Minnesota",70,66,0,0,1,0,1,2,70,68,65,0,0,1,0,0,2,2,1,0,0,0,0,1,0
270531112001003,36,Fulton,72,72,1000000US270531112001003,"Block 1003, Block Group 1, Census Tract 1112, Hennepin County, Minnesota",36,32,0,0,4,0,0,0,36,36,32,0,0,4,0,0,0,0,0,0,0,0,0,0,0
270531112001017,36,Fulton,72,72,1000000US270531112001017,"Block 1017, Block Group 1, Census Tract 1112, Hennepin County, Minnesota",58,55,0,0,1,0,0,2,58,58,55,0,0,1,0,0,2,0,0,0,0,0,0,0,0
270531112002003,36,Fulton,72,72,1000000US270531112002003,"Block 2003, Block Group 2, Census Tract 1112, Hennepin County, Minnesota",44,43,0,0,0,0,1,0,44,43,43,0,0,0,0,0,0,1,0,0,0,0,0,1,0
270531113002004,37,Lynnhurst,73,73,1000000US270531113002004,"Block 2004, Block Group 2, Census Tract 1113, Hennepin County, Minnesota",59,49,9,0,1,0,0,0,59,58,48,9,0,1,0,0,0,1,1,0,0,0,0,0,0
270531113002008,37,Lynnhurst,73,73,1000000US270531113002008,"Block 2008, Block Group 2, Census Tract 1113, Hennepin County, Minnesota",35,32,0,0,3,0,0,0,35,35,32,0,0,3,0,0,0,0,0,0,0,0,0,0,0
270530106001006,37,Lynnhurst,73,73,1000000US270530106001006,"Block 1006, Block Group 1, Census Tract 106, Hennepin County, Minnesota",44,42,0,0,0,0,0,2,44,42,40,0,0,0,0,0,2,2,2,0,0,0,0,0,0
270530106001005,37,Lynnhurst,73,73,1000000US270530106001005,"Block 1005, Block Group 1, Census Tract 106, Hennepin County, Minnesota",0,0,0,0,0,0,0,0,0,0,0,0,0,0,0,0,0,0,0,0,0,0,0,0,0
270531113002002,37,Lynnhurst,73,73,1000000US270531113002002,"Block 2002, Block Group 2, Census Tract 1113, Hennepin County, Minnesota",89,76,5,1,3,0,0,4,89,81,72,1,1,3,0,0,4,8,4,4,0,0,0,0,0
270530106001010,37,Lynnhurst,73,73,1000000US270530106001010,"Block 1010, Block Group 1, Census Tract 106, Hennepin County, Minnesota",73,68,0,0,2,0,0,3,73,73,68,0,0,2,0,0,3,0,0,0,0,0,0,0,0
270531113002001,37,Lynnhurst,73,73,1000000US270531113002001,"Block 2001, Block Group 2, Census Tract 1113, Hennepin County, Minnesota",75,68,7,0,0,0,0,0,75,75,68,7,0,0,0,0,0,0,0,0,0,0,0,0,0
270531113001010,37,Lynnhurst,73,73,1000000US270531113001010,"Block 1010, Block Group 1, Census Tract 1113, Hennepin County, Minnesota",70,68,0,0,2,0,0,0,70,70,68,0,0,2,0,0,0,0,0,0,0,0,0,0,0
270531113001008,37,Lynnhurst,73,73,1000000US270531113001008,"Block 1008, Block Group 1, Census Tract 1113, Hennepin County, Minnesota",66,66,0,0,0,0,0,0,66,66,66,0,0,0,0,0,0,0,0,0,0,0,0,0,0
270531113001007,37,Lynnhurst,73,73,1000000US270531113001007,"Block 1007, Block Group 1, Census Tract 1113, Hennepin County, Minnesota",81,70,2,0,4,0,0,5,81,81,70,2,0,4,0,0,5,0,0,0,0,0,0,0,0
270531113001013,37,Lynnhurst,73,73,1000000US270531113001013,"Block 1013, Block Group 1, Census Tract 1113, Hennepin County, Minnesota",81,78,0,0,1,0,2,0,81,79,78,0,0,1,0,0,0,2,0,0,0,0,0,2,0
270531113001005,37,Lynnhurst,73,73,1000000US270531113001005,"Block 1005, Block Group 1, Census Tract 1113, Hennepin County, Minnesota",46,43,0,0,1,0,0,2,46,44,41,0,0,1,0,0,2,2,2,0,0,0,0,0,0
270531113001006,37,Lynnhurst,73,73,1000000US270531113001006,"Block 1006, Block Group 1, Census Tract 1113, Hennepin County, Minnesota",58,58,0,0,0,0,0,0,58,58,58,0,0,0,0,0,0,0,0,0,0,0,0,0,0
270531114001008,37,Lynnhurst,73,73,1000000US270531114001008,"Block 1008, Block Group 1, Census Tract 1114, Hennepin County, Minnesota",25,22,0,0,0,0,0,3,25,25,22,0,0,0,0,0,3,0,0,0,0,0,0,0,0
270530107002011,37,Lynnhurst,73,73,1000000US270530107002011,"Block 2011, Block Group 2, Census Tract 107, Hennepin County, Minnesota",73,65,0,3,0,0,0,5,73,71,63,0,3,0,0,0,5,2,2,0,0,0,0,0,0
270531114001011,37,Lynnhurst,73,73,1000000US270531114001011,"Block 1011, Block Group 1, Census Tract 1114, Hennepin County, Minnesota",82,73,0,0,0,0,3,6,82,80,73,0,0,0,0,1,6,2,0,0,0,0,0,2,0
270530107002000,37,Lynnhurst,73,73,1000000US270530107002000,"Block 2000, Block Group 2, Census Tract 107, Hennepin County, Minnesota",74,63,0,0,4,0,0,7,74,73,62,0,0,4,0,0,7,1,1,0,0,0,0,0,0
270531114002006,37,Lynnhurst,73,73,1000000US270531114002006,"Block 2006, Block Group 2, Census Tract 1114, Hennepin County, Minnesota",57,53,0,0,1,0,1,2,57,54,53,0,0,1,0,0,0,3,0,0,0,0,0,1,2
270531114002014,37,Lynnhurst,73,73,1000000US270531114002014,"Block 2014, Block Group 2, Census Tract 1114, Hennepin County, Minnesota",53,53,0,0,0,0,0,0,53,50,50,0,0,0,0,0,0,3,3,0,0,0,0,0,0
270531114003010,37,Lynnhurst,73,73,1000000US270531114003010,"Block 3010, Block Group 3, Census Tract 1114, Hennepin County, Minnesota",73,63,0,0,3,0,1,6,73,68,60,0,0,3,0,0,5,5,3,0,0,0,0,1,1
270531114003004,37,Lynnhurst,73,73,1000000US270531114003004,"Block 3004, Block Group 3, Census Tract 1114, Hennepin County, Minnesota",30,30,0,0,0,0,0,0,30,27,27,0,0,0,0,0,0,3,3,0,0,0,0,0,0
270531114002008,37,Lynnhurst,73,73,1000000US270531114002008,"Block 2008, Block Group 2, Census Tract 1114, Hennepin County, Minnesota",0,0,0,0,0,0,0,0,0,0,0,0,0,0,0,0,0,0,0,0,0,0,0,0,0
270531113002006,37,Lynnhurst,73,73,1000000US270531113002006,"Block 2006, Block Group 2, Census Tract 1113, Hennepin County, Minnesota",24,22,0,0,2,0,0,0,24,24,22,0,0,2,0,0,0,0,0,0,0,0,0,0,0
270530106001007,37,Lynnhurst,73,73,1000000US270530106001007,"Block 1007, Block Group 1, Census Tract 106, Hennepin County, Minnesota",35,32,0,0,1,0,1,1,35,35,32,0,0,1,0,1,1,0,0,0,0,0,0,0,0
270531099004022,37,Lynnhurst,73,73,1000000US270531099004022,"Block 4022, Block Group 4, Census Tract 1099, Hennepin County, Minnesota",0,0,0,0,0,0,0,0,0,0,0,0,0,0,0,0,0,0,0,0,0,0,0,0,0
270531113001011,37,Lynnhurst,73,73,1000000US270531113001011,"Block 1011, Block Group 1, Census Tract 1113, Hennepin County, Minnesota",79,73,1,0,5,0,0,0,79,79,73,1,0,5,0,0,0,0,0,0,0,0,0,0,0
270530106001009,37,Lynnhurst,73,73,1000000US270530106001009,"Block 1009, Block Group 1, Census Tract 106, Hennepin County, Minnesota",58,57,0,0,1,0,0,0,58,56,55,0,0,1,0,0,0,2,2,0,0,0,0,0,0
270530106001003,37,Lynnhurst,73,73,1000000US270530106001003,"Block 1003, Block Group 1, Census Tract 106, Hennepin County, Minnesota",14,14,0,0,0,0,0,0,14,14,14,0,0,0,0,0,0,0,0,0,0,0,0,0,0
270530106001012,37,Lynnhurst,73,73,1000000US270530106001012,"Block 1012, Block Group 1, Census Tract 106, Hennepin County, Minnesota",73,66,0,0,2,0,0,5,73,69,62,0,0,2,0,0,5,4,4,0,0,0,0,0,0
270530106001000,37,Lynnhurst,73,73,1000000US270530106001000,"Block 1000, Block Group 1, Census Tract 106, Hennepin County, Minnesota",0,0,0,0,0,0,0,0,0,0,0,0,0,0,0,0,0,0,0,0,0,0,0,0,0
270531113002000,37,Lynnhurst,73,73,1000000US270531113002000,"Block 2000, Block Group 2, Census Tract 1113, Hennepin County, Minnesota",52,50,0,0,0,0,2,0,52,50,50,0,0,0,0,0,0,2,0,0,0,0,0,2,0
270530106001002,37,Lynnhurst,73,73,1000000US270530106001002,"Block 1002, Block Group 1, Census Tract 106, Hennepin County, Minnesota",57,52,0,0,2,0,0,3,57,55,50,0,0,2,0,0,3,2,2,0,0,0,0,0,0
270531113001012,37,Lynnhurst,73,73,1000000US270531113001012,"Block 1012, Block Group 1, Census Tract 1113, Hennepin County, Minnesota",58,58,0,0,0,0,0,0,58,57,57,0,0,0,0,0,0,1,1,0,0,0,0,0,0
270531114002009,37,Lynnhurst,73,73,1000000US270531114002009,"Block 2009, Block Group 2, Census Tract 1114, Hennepin County, Minnesota",0,0,0,0,0,0,0,0,0,0,0,0,0,0,0,0,0,0,0,0,0,0,0,0,0
270531113001014,37,Lynnhurst,73,73,1000000US270531113001014,"Block 1014, Block Group 1, Census Tract 1113, Hennepin County, Minnesota",69,64,1,1,1,0,0,2,69,68,63,1,1,1,0,0,2,1,1,0,0,0,0,0,0
270531099004023,37,Lynnhurst,73,73,1000000US270531099004023,"Block 4023, Block Group 4, Census Tract 1099, Hennepin County, Minnesota",0,0,0,0,0,0,0,0,0,0,0,0,0,0,0,0,0,0,0,0,0,0,0,0,0
270530106001013,37,Lynnhurst,73,73,1000000US270530106001013,"Block 1013, Block Group 1, Census Tract 106, Hennepin County, Minnesota",52,52,0,0,0,0,0,0,52,52,52,0,0,0,0,0,0,0,0,0,0,0,0,0,0
270531113002012,37,Lynnhurst,73,73,1000000US270531113002012,"Block 2012, Block Group 2, Census Tract 1113, Hennepin County, Minnesota",52,49,0,0,2,1,0,0,52,51,49,0,0,2,0,0,0,1,0,0,0,0,1,0,0
270531113002013,37,Lynnhurst,73,73,1000000US270531113002013,"Block 2013, Block Group 2, Census Tract 1113, Hennepin County, Minnesota",74,69,0,0,3,0,0,2,74,73,69,0,0,3,0,0,1,1,0,0,0,0,0,0,1
270531113001004,37,Lynnhurst,73,73,1000000US270531113001004,"Block 1004, Block Group 1, Census Tract 1113, Hennepin County, Minnesota",44,31,1,0,2,0,0,10,44,44,31,1,0,2,0,0,10,0,0,0,0,0,0,0,0
270530107002014,37,Lynnhurst,73,73,1000000US270530107002014,"Block 2014, Block Group 2, Census Tract 107, Hennepin County, Minnesota",33,33,0,0,0,0,0,0,33,32,32,0,0,0,0,0,0,1,1,0,0,0,0,0,0
270530107002002,37,Lynnhurst,73,73,1000000US270530107002002,"Block 2002, Block Group 2, Census Tract 107, Hennepin County, Minnesota",89,84,1,0,4,0,0,0,89,88,84,0,0,4,0,0,0,1,0,1,0,0,0,0,0
270531114001010,37,Lynnhurst,73,73,1000000US270531114001010,"Block 1010, Block Group 1, Census Tract 1114, Hennepin County, Minnesota",70,64,0,2,4,0,0,0,70,70,64,0,2,4,0,0,0,0,0,0,0,0,0,0,0
270530106001001,37,Lynnhurst,73,73,1000000US270530106001001,"Block 1001, Block Group 1, Census Tract 106, Hennepin County, Minnesota",30,30,0,0,0,0,0,0,30,29,29,0,0,0,0,0,0,1,1,0,0,0,0,0,0
270530107002016,37,Lynnhurst,73,73,1000000US270530107002016,"Block 2016, Block Group 2, Census Tract 107, Hennepin County, Minnesota",30,30,0,0,0,0,0,0,30,30,30,0,0,0,0,0,0,0,0,0,0,0,0,0,0
270531113001001,37,Lynnhurst,73,73,1000000US270531113001001,"Block 1001, Block Group 1, Census Tract 1113, Hennepin County, Minnesota",0,0,0,0,0,0,0,0,0,0,0,0,0,0,0,0,0,0,0,0,0,0,0,0,0
270531114003006,37,Lynnhurst,73,73,1000000US270531114003006,"Block 3006, Block Group 3, Census Tract 1114, Hennepin County, Minnesota",52,44,0,0,6,0,0,2,52,52,44,0,0,6,0,0,2,0,0,0,0,0,0,0,0
270530107002012,37,Lynnhurst,73,73,1000000US270530107002012,"Block 2012, Block Group 2, Census Tract 107, Hennepin County, Minnesota",40,36,0,0,2,0,0,2,40,39,36,0,0,2,0,0,1,1,0,0,0,0,0,0,1
270531114001003,37,Lynnhurst,73,73,1000000US270531114001003,"Block 1003, Block Group 1, Census Tract 1114, Hennepin County, Minnesota",52,40,0,0,9,0,0,3,52,52,40,0,0,9,0,0,3,0,0,0,0,0,0,0,0
270530106001008,37,Lynnhurst,73,73,1000000US270530106001008,"Block 1008, Block Group 1, Census Tract 106, Hennepin County, Minnesota",72,68,0,0,3,0,1,0,72,71,67,0,0,3,0,1,0,1,1,0,0,0,0,0,0
270531113001009,37,Lynnhurst,73,73,1000000US270531113001009,"Block 1009, Block Group 1, Census Tract 1113, Hennepin County, Minnesota",35,35,0,0,0,0,0,0,35,35,35,0,0,0,0,0,0,0,0,0,0,0,0,0,0
270530107002007,37,Lynnhurst,73,73,1000000US270530107002007,"Block 2007, Block Group 2, Census Tract 107, Hennepin County, Minnesota",16,16,0,0,0,0,0,0,16,16,16,0,0,0,0,0,0,0,0,0,0,0,0,0,0
270531114001012,37,Lynnhurst,73,73,1000000US270531114001012,"Block 1012, Block Group 1, Census Tract 1114, Hennepin County, Minnesota",64,61,0,2,0,0,0,1,64,62,61,0,0,0,0,0,1,2,0,0,2,0,0,0,0
270531114001001,37,Lynnhurst,73,73,1000000US270531114001001,"Block 1001, Block Group 1, Census Tract 1114, Hennepin County, Minnesota",51,51,0,0,0,0,0,0,51,50,50,0,0,0,0,0,0,1,1,0,0,0,0,0,0
270530107002009,37,Lynnhurst,73,73,1000000US270530107002009,"Block 2009, Block Group 2, Census Tract 107, Hennepin County, Minnesota",88,80,4,0,1,0,2,1,88,86,80,4,0,1,0,0,1,2,0,0,0,0,0,2,0
270531114002007,37,Lynnhurst,73,73,1000000US270531114002007,"Block 2007, Block Group 2, Census Tract 1114, Hennepin County, Minnesota",29,29,0,0,0,0,0,0,29,29,29,0,0,0,0,0,0,0,0,0,0,0,0,0,0
270531114003002,37,Lynnhurst,73,73,1000000US270531114003002,"Block 3002, Block Group 3, Census Tract 1114, Hennepin County, Minnesota",100,99,0,0,1,0,0,0,100,100,99,0,0,1,0,0,0,0,0,0,0,0,0,0,0
270531114002013,37,Lynnhurst,73,73,1000000US270531114002013,"Block 2013, Block Group 2, Census Tract 1114, Hennepin County, Minnesota",54,54,0,0,0,0,0,0,54,54,54,0,0,0,0,0,0,0,0,0,0,0,0,0,0
270531114002002,37,Lynnhurst,73,73,1000000US270531114002002,"Block 2002, Block Group 2, Census Tract 1114, Hennepin County, Minnesota",54,46,0,0,8,0,0,0,54,53,45,0,0,8,0,0,0,1,1,0,0,0,0,0,0
270531114003003,37,Lynnhurst,73,73,1000000US270531114003003,"Block 3003, Block Group 3, Census Tract 1114, Hennepin County, Minnesota",62,60,0,0,2,0,0,0,62,59,57,0,0,2,0,0,0,3,3,0,0,0,0,0,0
270531114002001,37,Lynnhurst,73,73,1000000US270531114002001,"Block 2001, Block Group 2, Census Tract 1114, Hennepin County, Minnesota",61,56,1,0,1,0,0,3,61,61,56,1,0,1,0,0,3,0,0,0,0,0,0,0,0
270530107002015,37,Lynnhurst,73,73,1000000US270530107002015,"Block 2015, Block Group 2, Census Tract 107, Hennepin County, Minnesota",33,32,0,0,1,0,0,0,33,32,31,0,0,1,0,0,0,1,1,0,0,0,0,0,0
270531113002005,37,Lynnhurst,73,73,1000000US270531113002005,"Block 2005, Block Group 2, Census Tract 1113, Hennepin County, Minnesota",67,62,0,0,5,0,0,0,67,66,61,0,0,5,0,0,0,1,1,0,0,0,0,0,0
270530106001011,37,Lynnhurst,73,73,1000000US270530106001011,"Block 1011, Block Group 1, Census Tract 106, Hennepin County, Minnesota",72,67,0,0,5,0,0,0,72,69,64,0,0,5,0,0,0,3,3,0,0,0,0,0,0
270531113001000,37,Lynnhurst,73,73,1000000US270531113001000,"Block 1000, Block Group 1, Census Tract 1113, Hennepin County, Minnesota",0,0,0,0,0,0,0,0,0,0,0,0,0,0,0,0,0,0,0,0,0,0,0,0,0
270531113001003,37,Lynnhurst,73,73,1000000US270531113001003,"Block 1003, Block Group 1, Census Tract 1113, Hennepin County, Minnesota",0,0,0,0,0,0,0,0,0,0,0,0,0,0,0,0,0,0,0,0,0,0,0,0,0
270530107002013,37,Lynnhurst,73,73,1000000US270530107002013,"Block 2013, Block Group 2, Census Tract 107, Hennepin County, Minnesota",48,44,0,0,4,0,0,0,48,48,44,0,0,4,0,0,0,0,0,0,0,0,0,0,0
270530107002003,37,Lynnhurst,73,73,1000000US270530107002003,"Block 2003, Block Group 2, Census Tract 107, Hennepin County, Minnesota",73,68,1,0,0,0,0,4,73,73,68,1,0,0,0,0,4,0,0,0,0,0,0,0,0
270531114001005,37,Lynnhurst,73,73,1000000US270531114001005,"Block 1005, Block Group 1, Census Tract 1114, Hennepin County, Minnesota",63,60,1,0,0,0,0,2,63,63,60,1,0,0,0,0,2,0,0,0,0,0,0,0,0
270530107002008,37,Lynnhurst,73,73,1000000US270530107002008,"Block 2008, Block Group 2, Census Tract 107, Hennepin County, Minnesota",71,63,1,0,1,0,0,6,71,69,61,1,0,1,0,0,6,2,2,0,0,0,0,0,0
270531114001014,37,Lynnhurst,73,73,1000000US270531114001014,"Block 1014, Block Group 1, Census Tract 1114, Hennepin County, Minnesota",86,79,3,0,1,0,0,3,86,85,78,3,0,1,0,0,3,1,1,0,0,0,0,0,0
270531114003000,37,Lynnhurst,73,73,1000000US270531114003000,"Block 3000, Block Group 3, Census Tract 1114, Hennepin County, Minnesota",0,0,0,0,0,0,0,0,0,0,0,0,0,0,0,0,0,0,0,0,0,0,0,0,0
270531114001013,37,Lynnhurst,73,73,1000000US270531114001013,"Block 1013, Block Group 1, Census Tract 1114, Hennepin County, Minnesota",78,76,0,0,1,0,0,1,78,76,75,0,0,1,0,0,0,2,1,0,0,0,0,0,1
270531114001000,37,Lynnhurst,73,73,1000000US270531114001000,"Block 1000, Block Group 1, Census Tract 1114, Hennepin County, Minnesota",55,52,0,0,0,0,3,0,55,52,52,0,0,0,0,0,0,3,0,0,0,0,0,3,0
270531114003008,37,Lynnhurst,73,73,1000000US270531114003008,"Block 3008, Block Group 3, Census Tract 1114, Hennepin County, Minnesota",81,73,4,2,2,0,0,0,81,79,72,3,2,2,0,0,0,2,1,1,0,0,0,0,0
270531114003009,37,Lynnhurst,73,73,1000000US270531114003009,"Block 3009, Block Group 3, Census Tract 1114, Hennepin County, Minnesota",53,50,0,0,2,0,1,0,53,53,50,0,0,2,0,1,0,0,0,0,0,0,0,0,0
270531114002012,37,Lynnhurst,73,73,1000000US270531114002012,"Block 2012, Block Group 2, Census Tract 1114, Hennepin County, Minnesota",58,51,0,0,2,1,1,3,58,57,51,0,0,2,1,0,3,1,0,0,0,0,0,1,0
270531114002010,37,Lynnhurst,73,73,1000000US270531114002010,"Block 2010, Block Group 2, Census Tract 1114, Hennepin County, Minnesota",74,74,0,0,0,0,0,0,74,73,73,0,0,0,0,0,0,1,1,0,0,0,0,0,0
270531114002015,37,Lynnhurst,73,73,1000000US270531114002015,"Block 2015, Block Group 2, Census Tract 1114, Hennepin County, Minnesota",69,45,11,0,9,0,3,1,69,65,45,11,0,9,0,0,0,4,0,0,0,0,0,3,1
270530107002001,37,Lynnhurst,73,73,1000000US270530107002001,"Block 2001, Block Group 2, Census Tract 107, Hennepin County, Minnesota",77,71,1,0,0,0,1,4,77,76,71,1,0,0,0,0,4,1,0,0,0,0,0,1,0
270531114001015,37,Lynnhurst,73,73,1000000US270531114001015,"Block 1015, Block Group 1, Census Tract 1114, Hennepin County, Minnesota",84,75,6,2,1,0,0,0,84,84,75,6,2,1,0,0,0,0,0,0,0,0,0,0,0
270531114002004,37,Lynnhurst,73,73,1000000US270531114002004,"Block 2004, Block Group 2, Census Tract 1114, Hennepin County, Minnesota",63,59,1,0,0,0,3,0,63,62,58,1,0,0,0,3,0,1,1,0,0,0,0,0,0
270531114003005,37,Lynnhurst,73,73,1000000US270531114003005,"Block 3005, Block Group 3, Census Tract 1114, Hennepin County, Minnesota",54,52,0,0,0,0,2,0,54,52,52,0,0,0,0,0,0,2,0,0,0,0,0,2,0
270531114002003,37,Lynnhurst,73,73,1000000US270531114002003,"Block 2003, Block Group 2, Census Tract 1114, Hennepin County, Minnesota",67,56,8,0,1,0,0,2,67,67,56,8,0,1,0,0,2,0,0,0,0,0,0,0,0
270531114003011,37,Lynnhurst,73,73,1000000US270531114003011,"Block 3011, Block Group 3, Census Tract 1114, Hennepin County, Minnesota",58,57,0,0,1,0,0,0,58,58,57,0,0,1,0,0,0,0,0,0,0,0,0,0,0
270531114002000,37,Lynnhurst,73,73,1000000US270531114002000,"Block 2000, Block Group 2, Census Tract 1114, Hennepin County, Minnesota",62,52,1,0,1,0,8,0,62,52,50,1,0,1,0,0,0,10,2,0,0,0,0,8,0
270531114003012,37,Lynnhurst,73,73,1000000US270531114003012,"Block 3012, Block Group 3, Census Tract 1114, Hennepin County, Minnesota",101,38,63,0,0,0,0,0,101,101,38,63,0,0,0,0,0,0,0,0,0,0,0,0,0
270530106001004,37,Lynnhurst,73,73,1000000US270530106001004,"Block 1004, Block Group 1, Census Tract 106, Hennepin County, Minnesota",51,42,0,0,4,0,2,3,51,49,40,0,0,4,0,2,3,2,2,0,0,0,0,0,0
270530106001014,37,Lynnhurst,73,73,1000000US270530106001014,"Block 1014, Block Group 1, Census Tract 106, Hennepin County, Minnesota",34,31,3,0,0,0,0,0,34,34,31,3,0,0,0,0,0,0,0,0,0,0,0,0,0
270531113002009,37,Lynnhurst,73,73,1000000US270531113002009,"Block 2009, Block Group 2, Census Tract 1113, Hennepin County, Minnesota",53,42,5,0,1,0,0,5,53,52,42,5,0,1,0,0,4,1,0,0,0,0,0,0,1
270531114003001,37,Lynnhurst,73,73,1000000US270531114003001,"Block 3001, Block Group 3, Census Tract 1114, Hennepin County, Minnesota",80,75,1,0,3,0,0,1,80,80,75,1,0,3,0,0,1,0,0,0,0,0,0,0,0
270530107002005,37,Lynnhurst,73,73,1000000US270530107002005,"Block 2005, Block Group 2, Census Tract 107, Hennepin County, Minnesota",40,40,0,0,0,0,0,0,40,40,40,0,0,0,0,0,0,0,0,0,0,0,0,0,0
270531114001006,37,Lynnhurst,73,73,1000000US270531114001006,"Block 1006, Block Group 1, Census Tract 1114, Hennepin County, Minnesota",54,46,0,0,1,0,2,5,54,49,46,0,0,1,0,0,2,5,0,0,0,0,0,2,3
270531114001009,37,Lynnhurst,73,73,1000000US270531114001009,"Block 1009, Block Group 1, Census Tract 1114, Hennepin County, Minnesota",74,74,0,0,0,0,0,0,74,74,74,0,0,0,0,0,0,0,0,0,0,0,0,0,0
270531114001004,37,Lynnhurst,73,73,1000000US270531114001004,"Block 1004, Block Group 1, Census Tract 1114, Hennepin County, Minnesota",79,75,0,0,0,0,1,3,79,78,75,0,0,0,0,0,3,1,0,0,0,0,0,1,0
270531114001007,37,Lynnhurst,73,73,1000000US270531114001007,"Block 1007, Block Group 1, Census Tract 1114, Hennepin County, Minnesota",35,35,0,0,0,0,0,0,35,33,33,0,0,0,0,0,0,2,2,0,0,0,0,0,0
270531113002003,37,Lynnhurst,73,73,1000000US270531113002003,"Block 2003, Block Group 2, Census Tract 1113, Hennepin County, Minnesota",68,56,5,0,4,0,0,3,68,65,56,4,0,4,0,0,1,3,0,1,0,0,0,0,2
270531114002005,37,Lynnhurst,73,73,1000000US270531114002005,"Block 2005, Block Group 2, Census Tract 1114, Hennepin County, Minnesota",63,58,0,1,3,0,0,1,63,59,56,0,0,3,0,0,0,4,2,0,1,0,0,0,1
270531113002007,37,Lynnhurst,73,73,1000000US270531113002007,"Block 2007, Block Group 2, Census Tract 1113, Hennepin County, Minnesota",44,44,0,0,0,0,0,0,44,44,44,0,0,0,0,0,0,0,0,0,0,0,0,0,0
270531114002011,37,Lynnhurst,73,73,1000000US270531114002011,"Block 2011, Block Group 2, Census Tract 1114, Hennepin County, Minnesota",63,63,0,0,0,0,0,0,63,63,63,0,0,0,0,0,0,0,0,0,0,0,0,0,0
270531114003007,37,Lynnhurst,73,73,1000000US270531114003007,"Block 3007, Block Group 3, Census Tract 1114, Hennepin County, Minnesota",79,77,0,1,0,0,0,1,79,78,76,0,1,0,0,0,1,1,1,0,0,0,0,0,0
270531113002010,37,Lynnhurst,73,73,1000000US270531113002010,"Block 2010, Block Group 2, Census Tract 1113, Hennepin County, Minnesota",59,57,0,0,2,0,0,0,59,59,57,0,0,2,0,0,0,0,0,0,0,0,0,0,0
270531113002011,37,Lynnhurst,73,73,1000000US270531113002011,"Block 2011, Block Group 2, Census Tract 1113, Hennepin County, Minnesota",39,37,0,0,0,0,0,2,39,39,37,0,0,0,0,0,2,0,0,0,0,0,0,0,0
270531113001002,37,Lynnhurst,73,73,1000000US270531113001002,"Block 1002, Block Group 1, Census Tract 1113, Hennepin County, Minnesota",0,0,0,0,0,0,0,0,0,0,0,0,0,0,0,0,0,0,0,0,0,0,0,0,0
270531113001015,37,Lynnhurst,73,73,1000000US270531113001015,"Block 1015, Block Group 1, Census Tract 1113, Hennepin County, Minnesota",74,69,1,0,0,0,4,0,74,70,69,1,0,0,0,0,0,4,0,0,0,0,0,4,0
270530107002006,37,Lynnhurst,73,73,1000000US270530107002006,"Block 2006, Block Group 2, Census Tract 107, Hennepin County, Minnesota",50,50,0,0,0,0,0,0,50,50,50,0,0,0,0,0,0,0,0,0,0,0,0,0,0
270530107002004,37,Lynnhurst,73,73,1000000US270530107002004,"Block 2004, Block Group 2, Census Tract 107, Hennepin County, Minnesota",48,43,0,0,2,3,0,0,48,48,43,0,0,2,3,0,0,0,0,0,0,0,0,0,0
270530107002010,37,Lynnhurst,73,73,1000000US270530107002010,"Block 2010, Block Group 2, Census Tract 107, Hennepin County, Minnesota",76,70,0,0,1,1,0,4,76,76,70,0,0,1,1,0,4,0,0,0,0,0,0,0,0
270531114001002,37,Lynnhurst,73,73,1000000US270531114001002,"Block 1002, Block Group 1, Census Tract 1114, Hennepin County, Minnesota",49,44,5,0,0,0,0,0,49,47,42,5,0,0,0,0,0,2,2,0,0,0,0,0,0
270530096003007,38,Bancroft,58,58,1000000US270530096003007,"Block 3007, Block Group 3, Census Tract 96, Hennepin County, Minnesota",83,59,10,0,3,0,1,10,83,82,59,10,0,3,0,0,10,1,0,0,0,0,0,1,0
270530096003005,38,Bancroft,58,58,1000000US270530096003005,"Block 3005, Block Group 3, Census Tract 96, Hennepin County, Minnesota",86,40,26,4,0,0,16,0,86,59,29,26,4,0,0,0,0,27,11,0,0,0,0,16,0
270531101002010,38,Bancroft,58,58,1000000US270531101002010,"Block 2010, Block Group 2, Census Tract 1101, Hennepin County, Minnesota",70,57,9,2,0,0,0,2,70,65,54,8,2,0,0,0,1,5,3,1,0,0,0,0,1
270531101002000,38,Bancroft,58,58,1000000US270531101002000,"Block 2000, Block Group 2, Census Tract 1101, Hennepin County, Minnesota",92,40,25,0,2,0,21,4,92,64,33,25,0,2,0,0,4,28,7,0,0,0,0,21,0
270531101003010,38,Bancroft,58,58,1000000US270531101003010,"Block 3010, Block Group 3, Census Tract 1101, Hennepin County, Minnesota",49,47,1,0,0,0,0,1,49,48,47,1,0,0,0,0,0,1,0,0,0,0,0,0,1
270531101002011,38,Bancroft,58,58,1000000US270531101002011,"Block 2011, Block Group 2, Census Tract 1101, Hennepin County, Minnesota",62,53,5,1,1,0,1,1,62,60,52,5,1,1,0,0,1,2,1,0,0,0,0,1,0
270531101002005,38,Bancroft,58,58,1000000US270531101002005,"Block 2005, Block Group 2, Census Tract 1101, Hennepin County, Minnesota",88,60,11,4,0,0,7,6,88,78,55,11,4,0,0,2,6,10,5,0,0,0,0,5,0
270531101002006,38,Bancroft,58,58,1000000US270531101002006,"Block 2006, Block Group 2, Census Tract 1101, Hennepin County, Minnesota",72,48,8,5,0,0,4,7,72,65,47,8,5,0,0,0,5,7,1,0,0,0,0,4,2
270530096004011,38,Bancroft,58,58,1000000US270530096004011,"Block 4011, Block Group 4, Census Tract 96, Hennepin County, Minnesota",56,23,4,10,0,0,16,3,56,39,22,4,10,0,0,0,3,17,1,0,0,0,0,16,0
270531101003006,38,Bancroft,58,58,1000000US270531101003006,"Block 3006, Block Group 3, Census Tract 1101, Hennepin County, Minnesota",77,44,4,10,1,0,14,4,77,56,38,4,9,1,0,0,4,21,6,0,1,0,0,14,0
270531101002007,38,Bancroft,58,58,1000000US270531101002007,"Block 2007, Block Group 2, Census Tract 1101, Hennepin County, Minnesota",85,57,11,3,10,0,4,0,85,76,56,7,3,10,0,0,0,9,1,4,0,0,0,4,0
270531101002009,38,Bancroft,58,58,1000000US270531101002009,"Block 2009, Block Group 2, Census Tract 1101, Hennepin County, Minnesota",92,67,19,2,0,0,0,4,92,92,67,19,2,0,0,0,4,0,0,0,0,0,0,0,0
270531101003002,38,Bancroft,58,58,1000000US270531101003002,"Block 3002, Block Group 3, Census Tract 1101, Hennepin County, Minnesota",85,41,17,8,15,0,2,2,85,82,40,17,8,15,0,0,2,3,1,0,0,0,0,2,0
270531101003000,38,Bancroft,58,58,1000000US270531101003000,"Block 3000, Block Group 3, Census Tract 1101, Hennepin County, Minnesota",81,46,14,6,0,0,4,11,81,75,46,14,4,0,0,0,11,6,0,0,2,0,0,4,0
270531101002002,38,Bancroft,58,58,1000000US270531101002002,"Block 2002, Block Group 2, Census Tract 1101, Hennepin County, Minnesota",54,46,1,1,1,0,5,0,54,49,46,1,1,1,0,0,0,5,0,0,0,0,0,5,0
270531101003009,38,Bancroft,58,58,1000000US270531101003009,"Block 3009, Block Group 3, Census Tract 1101, Hennepin County, Minnesota",0,0,0,0,0,0,0,0,0,0,0,0,0,0,0,0,0,0,0,0,0,0,0,0,0
270530096003002,38,Bancroft,58,58,1000000US270530096003002,"Block 3002, Block Group 3, Census Tract 96, Hennepin County, Minnesota",84,61,13,1,0,0,2,7,84,75,57,13,1,0,0,0,4,9,4,0,0,0,0,2,3
270530096003001,38,Bancroft,58,58,1000000US270530096003001,"Block 3001, Block Group 3, Census Tract 96, Hennepin County, Minnesota",74,47,7,1,3,0,10,6,74,58,42,7,1,3,0,0,5,16,5,0,0,0,0,10,1
270530096003009,38,Bancroft,58,58,1000000US270530096003009,"Block 3009, Block Group 3, Census Tract 96, Hennepin County, Minnesota",82,57,19,2,1,0,0,3,82,80,56,19,1,1,0,0,3,2,1,0,1,0,0,0,0
270531101002008,38,Bancroft,58,58,1000000US270531101002008,"Block 2008, Block Group 2, Census Tract 1101, Hennepin County, Minnesota",81,52,7,1,3,0,16,2,81,64,51,7,1,3,0,0,2,17,1,0,0,0,0,16,0
270531101003003,38,Bancroft,58,58,1000000US270531101003003,"Block 3003, Block Group 3, Census Tract 1101, Hennepin County, Minnesota",101,43,14,9,6,0,26,3,101,67,38,14,6,6,0,0,3,34,5,0,3,0,0,26,0
270531101003008,38,Bancroft,58,58,1000000US270531101003008,"Block 3008, Block Group 3, Census Tract 1101, Hennepin County, Minnesota",48,12,0,0,2,0,28,6,48,21,5,0,0,2,0,8,6,27,7,0,0,0,0,20,0
270531101002003,38,Bancroft,58,58,1000000US270531101002003,"Block 2003, Block Group 2, Census Tract 1101, Hennepin County, Minnesota",88,45,19,11,0,0,9,4,88,66,41,19,4,0,0,0,2,22,4,0,7,0,0,9,2
270530096004002,38,Bancroft,58,58,1000000US270530096004002,"Block 4002, Block Group 4, Census Tract 96, Hennepin County, Minnesota",65,42,12,6,0,0,1,4,65,61,42,12,3,0,0,0,4,4,0,0,3,0,0,1,0
270530096003011,38,Bancroft,58,58,1000000US270530096003011,"Block 3011, Block Group 3, Census Tract 96, Hennepin County, Minnesota",94,55,16,1,2,0,18,2,94,74,53,16,1,2,0,0,2,20,2,0,0,0,0,18,0
270531101002004,38,Bancroft,58,58,1000000US270531101002004,"Block 2004, Block Group 2, Census Tract 1101, Hennepin County, Minnesota",54,50,2,0,0,0,0,2,54,54,50,2,0,0,0,0,2,0,0,0,0,0,0,0,0
270530096003000,38,Bancroft,58,58,1000000US270530096003000,"Block 3000, Block Group 3, Census Tract 96, Hennepin County, Minnesota",0,0,0,0,0,0,0,0,0,0,0,0,0,0,0,0,0,0,0,0,0,0,0,0,0
270530096003010,38,Bancroft,58,58,1000000US270530096003010,"Block 3010, Block Group 3, Census Tract 96, Hennepin County, Minnesota",91,59,19,0,8,0,5,0,91,85,58,19,0,8,0,0,0,6,1,0,0,0,0,5,0
270530096004009,38,Bancroft,58,58,1000000US270530096004009,"Block 4009, Block Group 4, Census Tract 96, Hennepin County, Minnesota",63,54,5,0,2,0,0,2,63,56,47,5,0,2,0,0,2,7,7,0,0,0,0,0,0
270530096004010,38,Bancroft,58,58,1000000US270530096004010,"Block 4010, Block Group 4, Census Tract 96, Hennepin County, Minnesota",55,28,15,0,0,0,7,5,55,43,28,10,0,0,0,0,5,12,0,5,0,0,0,7,0
270530096004008,38,Bancroft,58,58,1000000US270530096004008,"Block 4008, Block Group 4, Census Tract 96, Hennepin County, Minnesota",60,40,8,0,7,0,1,4,60,60,40,8,0,7,0,1,4,0,0,0,0,0,0,0,0
270530096004000,38,Bancroft,58,58,1000000US270530096004000,"Block 4000, Block Group 4, Census Tract 96, Hennepin County, Minnesota",82,58,15,0,2,0,0,7,82,82,58,15,0,2,0,0,7,0,0,0,0,0,0,0,0
270531101003004,38,Bancroft,58,58,1000000US270531101003004,"Block 3004, Block Group 3, Census Tract 1101, Hennepin County, Minnesota",0,0,0,0,0,0,0,0,0,0,0,0,0,0,0,0,0,0,0,0,0,0,0,0,0
270531101003007,38,Bancroft,58,58,1000000US270531101003007,"Block 3007, Block Group 3, Census Tract 1101, Hennepin County, Minnesota",0,0,0,0,0,0,0,0,0,0,0,0,0,0,0,0,0,0,0,0,0,0,0,0,0
270530096004007,38,Bancroft,58,58,1000000US270530096004007,"Block 4007, Block Group 4, Census Tract 96, Hennepin County, Minnesota",76,44,24,3,5,0,0,0,76,72,41,24,3,4,0,0,0,4,3,0,0,1,0,0,0
270530096004005,38,Bancroft,58,58,1000000US270530096004005,"Block 4005, Block Group 4, Census Tract 96, Hennepin County, Minnesota",68,42,20,1,1,0,0,4,68,64,39,20,1,1,0,0,3,4,3,0,0,0,0,0,1
270530096003008,38,Bancroft,58,58,1000000US270530096003008,"Block 3008, Block Group 3, Census Tract 96, Hennepin County, Minnesota",71,46,13,0,2,0,0,10,71,70,46,13,0,2,0,0,9,1,0,0,0,0,0,0,1
270530096004001,38,Bancroft,58,58,1000000US270530096004001,"Block 4001, Block Group 4, Census Tract 96, Hennepin County, Minnesota",69,52,0,0,5,0,12,0,69,58,52,0,0,5,0,1,0,11,0,0,0,0,0,11,0
270531101003005,38,Bancroft,58,58,1000000US270531101003005,"Block 3005, Block Group 3, Census Tract 1101, Hennepin County, Minnesota",178,118,42,2,6,0,2,8,178,162,107,42,2,6,0,1,4,16,11,0,0,0,0,1,4
270530096003004,38,Bancroft,58,58,1000000US270530096003004,"Block 3004, Block Group 3, Census Tract 96, Hennepin County, Minnesota",69,46,9,5,3,0,0,6,69,68,46,9,4,3,0,0,6,1,0,0,1,0,0,0,0
270530096004004,38,Bancroft,58,58,1000000US270530096004004,"Block 4004, Block Group 4, Census Tract 96, Hennepin County, Minnesota",82,46,20,4,6,0,1,5,82,82,46,20,4,6,0,1,5,0,0,0,0,0,0,0,0
270530096003003,38,Bancroft,58,58,1000000US270530096003003,"Block 3003, Block Group 3, Census Tract 96, Hennepin County, Minnesota",78,59,15,0,0,0,1,3,78,71,55,15,0,0,0,0,1,7,4,0,0,0,0,1,2
270531101002001,38,Bancroft,58,58,1000000US270531101002001,"Block 2001, Block Group 2, Census Tract 1101, Hennepin County, Minnesota",52,37,6,0,6,0,0,3,52,52,37,6,0,6,0,0,3,0,0,0,0,0,0,0,0
270531101003001,38,Bancroft,58,58,1000000US270531101003001,"Block 3001, Block Group 3, Census Tract 1101, Hennepin County, Minnesota",61,55,5,0,1,0,0,0,61,56,50,5,0,1,0,0,0,5,5,0,0,0,0,0,0
270531101003011,38,Bancroft,58,58,1000000US270531101003011,"Block 3011, Block Group 3, Census Tract 1101, Hennepin County, Minnesota",44,27,0,0,11,0,6,0,44,35,24,0,0,11,0,0,0,9,3,0,0,0,0,6,0
270530096004003,38,Bancroft,58,58,1000000US270530096004003,"Block 4003, Block Group 4, Census Tract 96, Hennepin County, Minnesota",78,70,2,3,0,0,3,0,78,69,64,2,3,0,0,0,0,9,6,0,0,0,0,3,0
270530096003006,38,Bancroft,58,58,1000000US270530096003006,"Block 3006, Block Group 3, Census Tract 96, Hennepin County, Minnesota",112,61,34,0,1,0,11,5,112,90,54,34,0,1,0,0,1,22,7,0,0,0,0,11,4
270530096004006,38,Bancroft,58,58,1000000US270530096004006,"Block 4006, Block Group 4, Census Tract 96, Hennepin County, Minnesota",79,43,27,1,0,0,0,8,79,79,43,27,1,0,0,0,8,0,0,0,0,0,0,0,0
270531087003014,39,Standish,59,59,1000000US270531087003014,"Block 3014, Block Group 3, Census Tract 1087, Hennepin County, Minnesota",45,38,2,1,3,0,1,0,45,40,34,2,1,3,0,0,0,5,4,0,0,0,0,1,0
270531101001017,39,Standish,59,59,1000000US270531101001017,"Block 1017, Block Group 1, Census Tract 1101, Hennepin County, Minnesota",58,48,1,1,1,0,1,6,58,57,48,1,1,1,0,0,6,1,0,0,0,0,0,1,0
270531101001007,39,Standish,59,59,1000000US270531101001007,"Block 1007, Block Group 1, Census Tract 1101, Hennepin County, Minnesota",58,57,0,0,0,0,0,1,58,58,57,0,0,0,0,0,1,0,0,0,0,0,0,0,0
270531087003003,39,Standish,59,59,1000000US270531087003003,"Block 3003, Block Group 3, Census Tract 1087, Hennepin County, Minnesota",64,51,3,1,1,0,4,4,64,60,51,3,1,1,0,0,4,4,0,0,0,0,0,4,0
270531102001011,39,Standish,59,59,1000000US270531102001011,"Block 1011, Block Group 1, Census Tract 1102, Hennepin County, Minnesota",57,54,0,0,0,0,1,2,57,54,53,0,0,0,0,0,1,3,1,0,0,0,0,1,1
270531102002011,39,Standish,59,59,1000000US270531102002011,"Block 2011, Block Group 2, Census Tract 1102, Hennepin County, Minnesota",65,62,0,0,2,0,0,1,65,62,59,0,0,2,0,0,1,3,3,0,0,0,0,0,0
270531102003006,39,Standish,59,59,1000000US270531102003006,"Block 3006, Block Group 3, Census Tract 1102, Hennepin County, Minnesota",59,49,0,1,5,0,1,3,59,57,48,0,1,5,0,0,3,2,1,0,0,0,0,1,0
270531102004006,39,Standish,59,59,1000000US270531102004006,"Block 4006, Block Group 4, Census Tract 1102, Hennepin County, Minnesota",70,51,3,2,0,0,14,0,70,54,45,3,2,0,0,4,0,16,6,0,0,0,0,10,0
270531097001001,39,Standish,59,59,1000000US270531097001001,"Block 1001, Block Group 1, Census Tract 1097, Hennepin County, Minnesota",64,32,3,4,6,0,14,5,64,46,31,3,3,6,0,0,3,18,1,0,1,0,0,14,2
270531101001008,39,Standish,59,59,1000000US270531101001008,"Block 1008, Block Group 1, Census Tract 1101, Hennepin County, Minnesota",71,55,10,0,0,0,6,0,71,63,53,10,0,0,0,0,0,8,2,0,0,0,0,6,0
270531101001012,39,Standish,59,59,1000000US270531101001012,"Block 1012, Block Group 1, Census Tract 1101, Hennepin County, Minnesota",77,69,6,0,0,0,1,1,77,69,63,6,0,0,0,0,0,8,6,0,0,0,0,1,1
270531101001014,39,Standish,59,59,1000000US270531101001014,"Block 1014, Block Group 1, Census Tract 1101, Hennepin County, Minnesota",87,67,8,0,1,0,10,1,87,77,67,8,0,1,0,0,1,10,0,0,0,0,0,10,0
270531087003006,39,Standish,59,59,1000000US270531087003006,"Block 3006, Block Group 3, Census Tract 1087, Hennepin County, Minnesota",43,32,5,1,0,0,1,4,43,42,32,5,1,0,0,0,4,1,0,0,0,0,0,1,0
270531087003004,39,Standish,59,59,1000000US270531087003004,"Block 3004, Block Group 3, Census Tract 1087, Hennepin County, Minnesota",52,39,5,3,4,0,0,1,52,50,37,5,3,4,0,0,1,2,2,0,0,0,0,0,0
270531087003019,39,Standish,59,59,1000000US270531087003019,"Block 3019, Block Group 3, Census Tract 1087, Hennepin County, Minnesota",66,47,8,3,1,2,5,0,66,58,44,8,3,1,2,0,0,8,3,0,0,0,0,5,0
270531102003000,39,Standish,59,59,1000000US270531102003000,"Block 3000, Block Group 3, Census Tract 1102, Hennepin County, Minnesota",30,29,0,0,1,0,0,0,30,30,29,0,0,1,0,0,0,0,0,0,0,0,0,0,0
270531102004011,39,Standish,59,59,1000000US270531102004011,"Block 4011, Block Group 4, Census Tract 1102, Hennepin County, Minnesota",59,42,11,0,0,0,6,0,59,51,40,11,0,0,0,0,0,8,2,0,0,0,0,6,0
270531097001002,39,Standish,59,59,1000000US270531097001002,"Block 1002, Block Group 1, Census Tract 1097, Hennepin County, Minnesota",70,59,2,0,1,0,2,6,70,58,52,2,0,1,0,0,3,12,7,0,0,0,0,2,3
270531097001000,39,Standish,59,59,1000000US270531097001000,"Block 1000, Block Group 1, Census Tract 1097, Hennepin County, Minnesota",0,0,0,0,0,0,0,0,0,0,0,0,0,0,0,0,0,0,0,0,0,0,0,0,0
270531097001007,39,Standish,59,59,1000000US270531097001007,"Block 1007, Block Group 1, Census Tract 1097, Hennepin County, Minnesota",88,73,5,0,0,0,6,4,88,66,57,5,0,0,0,0,4,22,16,0,0,0,0,6,0
270531101001000,39,Standish,59,59,1000000US270531101001000,"Block 1000, Block Group 1, Census Tract 1101, Hennepin County, Minnesota",65,58,4,0,1,0,0,2,65,63,56,4,0,1,0,0,2,2,2,0,0,0,0,0,0
270531101001015,39,Standish,59,59,1000000US270531101001015,"Block 1015, Block Group 1, Census Tract 1101, Hennepin County, Minnesota",66,58,0,0,0,0,3,5,66,63,58,0,0,0,0,0,5,3,0,0,0,0,0,3,0
270531087003010,39,Standish,59,59,1000000US270531087003010,"Block 3010, Block Group 3, Census Tract 1087, Hennepin County, Minnesota",33,28,3,0,0,0,0,2,33,27,22,3,0,0,0,0,2,6,6,0,0,0,0,0,0
270531102001003,39,Standish,59,59,1000000US270531102001003,"Block 1003, Block Group 1, Census Tract 1102, Hennepin County, Minnesota",89,66,8,0,5,0,0,10,89,86,63,8,0,5,0,0,10,3,3,0,0,0,0,0,0
270531102002003,39,Standish,59,59,1000000US270531102002003,"Block 2003, Block Group 2, Census Tract 1102, Hennepin County, Minnesota",71,45,3,4,2,0,12,5,71,54,43,3,4,2,0,0,2,17,2,0,0,0,0,12,3
270531087003021,39,Standish,59,59,1000000US270531087003021,"Block 3021, Block Group 3, Census Tract 1087, Hennepin County, Minnesota",0,0,0,0,0,0,0,0,0,0,0,0,0,0,0,0,0,0,0,0,0,0,0,0,0
270531102004003,39,Standish,59,59,1000000US270531102004003,"Block 4003, Block Group 4, Census Tract 1102, Hennepin County, Minnesota",104,89,9,0,1,0,0,5,104,91,77,9,0,1,0,0,4,13,12,0,0,0,0,0,1
270531102004004,39,Standish,59,59,1000000US270531102004004,"Block 4004, Block Group 4, Census Tract 1102, Hennepin County, Minnesota",63,52,1,1,2,0,0,7,63,59,52,1,1,2,0,0,3,4,0,0,0,0,0,0,4
270531102002007,39,Standish,59,59,1000000US270531102002007,"Block 2007, Block Group 2, Census Tract 1102, Hennepin County, Minnesota",55,44,3,3,0,0,1,4,55,51,42,3,3,0,0,0,3,4,2,0,0,0,0,1,1
270531102001014,39,Standish,59,59,1000000US270531102001014,"Block 1014, Block Group 1, Census Tract 1102, Hennepin County, Minnesota",68,63,2,2,0,0,0,1,68,65,60,2,2,0,0,0,1,3,3,0,0,0,0,0,0
270531102003003,39,Standish,59,59,1000000US270531102003003,"Block 3003, Block Group 3, Census Tract 1102, Hennepin County, Minnesota",56,53,2,0,0,0,1,0,56,53,50,2,0,0,0,1,0,3,3,0,0,0,0,0,0
270531102001016,39,Standish,59,59,1000000US270531102001016,"Block 1016, Block Group 1, Census Tract 1102, Hennepin County, Minnesota",56,54,0,0,0,0,1,1,56,49,48,0,0,0,0,0,1,7,6,0,0,0,0,1,0
270531102001001,39,Standish,59,59,1000000US270531102001001,"Block 1001, Block Group 1, Census Tract 1102, Hennepin County, Minnesota",98,78,9,0,0,0,11,0,98,72,63,9,0,0,0,0,0,26,15,0,0,0,0,11,0
270531102004005,39,Standish,59,59,1000000US270531102004005,"Block 4005, Block Group 4, Census Tract 1102, Hennepin County, Minnesota",66,55,0,0,2,0,8,1,66,59,52,0,0,2,0,4,1,7,3,0,0,0,0,4,0
270531102001015,39,Standish,59,59,1000000US270531102001015,"Block 1015, Block Group 1, Census Tract 1102, Hennepin County, Minnesota",71,52,5,6,0,0,0,8,71,69,50,5,6,0,0,0,8,2,2,0,0,0,0,0,0
270531102003004,39,Standish,59,59,1000000US270531102003004,"Block 3004, Block Group 3, Census Tract 1102, Hennepin County, Minnesota",72,66,2,0,0,0,0,4,72,68,62,2,0,0,0,0,4,4,4,0,0,0,0,0,0
270531102003010,39,Standish,59,59,1000000US270531102003010,"Block 3010, Block Group 3, Census Tract 1102, Hennepin County, Minnesota",58,48,5,0,4,0,1,0,58,54,45,5,0,4,0,0,0,4,3,0,0,0,0,1,0
270531102002008,39,Standish,59,59,1000000US270531102002008,"Block 2008, Block Group 2, Census Tract 1102, Hennepin County, Minnesota",71,60,0,9,0,0,0,2,71,71,60,0,9,0,0,0,2,0,0,0,0,0,0,0,0
270531102003005,39,Standish,59,59,1000000US270531102003005,"Block 3005, Block Group 3, Census Tract 1102, Hennepin County, Minnesota",50,39,8,0,1,0,1,1,50,48,39,8,0,1,0,0,0,2,0,0,0,0,0,1,1
270531102004009,39,Standish,59,59,1000000US270531102004009,"Block 4009, Block Group 4, Census Tract 1102, Hennepin County, Minnesota",0,0,0,0,0,0,0,0,0,0,0,0,0,0,0,0,0,0,0,0,0,0,0,0,0
270531102001013,39,Standish,59,59,1000000US270531102001013,"Block 1013, Block Group 1, Census Tract 1102, Hennepin County, Minnesota",31,28,0,0,1,0,0,2,31,31,28,0,0,1,0,0,2,0,0,0,0,0,0,0,0
270531102002000,39,Standish,59,59,1000000US270531102002000,"Block 2000, Block Group 2, Census Tract 1102, Hennepin County, Minnesota",31,31,0,0,0,0,0,0,31,30,30,0,0,0,0,0,0,1,1,0,0,0,0,0,0
270531102004016,39,Standish,59,59,1000000US270531102004016,"Block 4016, Block Group 4, Census Tract 1102, Hennepin County, Minnesota",114,56,0,6,0,0,33,19,114,77,56,0,2,0,0,0,19,37,0,0,4,0,0,33,0
270531102002009,39,Standish,59,59,1000000US270531102002009,"Block 2009, Block Group 2, Census Tract 1102, Hennepin County, Minnesota",61,59,0,0,0,0,0,2,61,61,59,0,0,0,0,0,2,0,0,0,0,0,0,0,0
270531102004010,39,Standish,59,59,1000000US270531102004010,"Block 4010, Block Group 4, Census Tract 1102, Hennepin County, Minnesota",76,38,11,0,1,0,24,2,76,33,21,11,0,1,0,0,0,43,17,0,0,0,0,24,2
270531102001000,39,Standish,59,59,1000000US270531102001000,"Block 1000, Block Group 1, Census Tract 1102, Hennepin County, Minnesota",76,55,7,7,2,0,0,5,76,63,42,7,7,2,0,0,5,13,13,0,0,0,0,0,0
270531087003002,39,Standish,59,59,1000000US270531087003002,"Block 3002, Block Group 3, Census Tract 1087, Hennepin County, Minnesota",76,64,5,1,0,0,1,5,76,74,62,5,1,0,0,1,5,2,2,0,0,0,0,0,0
270531087003001,39,Standish,59,59,1000000US270531087003001,"Block 3001, Block Group 3, Census Tract 1087, Hennepin County, Minnesota",79,40,7,3,7,0,22,0,79,57,40,7,3,7,0,0,0,22,0,0,0,0,0,22,0
270531101001011,39,Standish,59,59,1000000US270531101001011,"Block 1011, Block Group 1, Census Tract 1101, Hennepin County, Minnesota",58,42,8,0,5,0,0,3,58,48,35,7,0,5,0,0,1,10,7,1,0,0,0,0,2
270531102004001,39,Standish,59,59,1000000US270531102004001,"Block 4001, Block Group 4, Census Tract 1102, Hennepin County, Minnesota",47,28,7,5,2,0,3,2,47,34,16,7,5,2,0,2,2,13,12,0,0,0,0,1,0
270531087003017,39,Standish,59,59,1000000US270531087003017,"Block 3017, Block Group 3, Census Tract 1087, Hennepin County, Minnesota",64,55,0,0,0,0,4,5,64,47,43,0,0,0,0,0,4,17,12,0,0,0,0,4,1
270531102001012,39,Standish,59,59,1000000US270531102001012,"Block 1012, Block Group 1, Census Tract 1102, Hennepin County, Minnesota",21,19,0,1,0,0,0,1,21,20,19,0,1,0,0,0,0,1,0,0,0,0,0,0,1
270531102001005,39,Standish,59,59,1000000US270531102001005,"Block 1005, Block Group 1, Census Tract 1102, Hennepin County, Minnesota",34,23,5,0,5,0,0,1,34,34,23,5,0,5,0,0,1,0,0,0,0,0,0,0,0
270531097001003,39,Standish,59,59,1000000US270531097001003,"Block 1003, Block Group 1, Census Tract 1097, Hennepin County, Minnesota",131,58,31,3,2,0,30,7,131,80,38,31,3,2,0,0,6,51,20,0,0,0,0,30,1
270531097001004,39,Standish,59,59,1000000US270531097001004,"Block 1004, Block Group 1, Census Tract 1097, Hennepin County, Minnesota",195,74,3,5,2,0,97,14,195,42,25,3,5,2,0,0,7,153,49,0,0,0,0,97,7
270531101001001,39,Standish,59,59,1000000US270531101001001,"Block 1001, Block Group 1, Census Tract 1101, Hennepin County, Minnesota",43,33,1,1,2,0,1,5,43,42,33,1,1,2,0,0,5,1,0,0,0,0,0,1,0
270531102002004,39,Standish,59,59,1000000US270531102002004,"Block 2004, Block Group 2, Census Tract 1102, Hennepin County, Minnesota",63,54,4,2,1,0,1,1,63,62,54,4,2,1,0,0,1,1,0,0,0,0,0,1,0
270531102001006,39,Standish,59,59,1000000US270531102001006,"Block 1006, Block Group 1, Census Tract 1102, Hennepin County, Minnesota",47,44,0,0,3,0,0,0,47,44,41,0,0,3,0,0,0,3,3,0,0,0,0,0,0
270531087003015,39,Standish,59,59,1000000US270531087003015,"Block 3015, Block Group 3, Census Tract 1087, Hennepin County, Minnesota",47,44,1,0,0,0,0,2,47,46,43,1,0,0,0,0,2,1,1,0,0,0,0,0,0
270531087003016,39,Standish,59,59,1000000US270531087003016,"Block 3016, Block Group 3, Census Tract 1087, Hennepin County, Minnesota",61,54,3,1,1,0,1,1,61,59,53,3,1,1,0,0,1,2,1,0,0,0,0,1,0
270531102004002,39,Standish,59,59,1000000US270531102004002,"Block 4002, Block Group 4, Census Tract 1102, Hennepin County, Minnesota",67,58,3,0,0,0,5,1,67,61,58,3,0,0,0,0,0,6,0,0,0,0,0,5,1
270531102004015,39,Standish,59,59,1000000US270531102004015,"Block 4015, Block Group 4, Census Tract 1102, Hennepin County, Minnesota",88,72,0,0,1,0,11,4,88,64,59,0,0,1,0,0,4,24,13,0,0,0,0,11,0
270531102003002,39,Standish,59,59,1000000US270531102003002,"Block 3002, Block Group 3, Census Tract 1102, Hennepin County, Minnesota",68,48,5,1,1,0,11,2,68,54,46,5,0,1,0,0,2,14,2,0,1,0,0,11,0
270531102004000,39,Standish,59,59,1000000US270531102004000,"Block 4000, Block Group 4, Census Tract 1102, Hennepin County, Minnesota",0,0,0,0,0,0,0,0,0,0,0,0,0,0,0,0,0,0,0,0,0,0,0,0,0
270531102004007,39,Standish,59,59,1000000US270531102004007,"Block 4007, Block Group 4, Census Tract 1102, Hennepin County, Minnesota",59,36,14,0,0,0,8,1,59,39,24,14,0,0,0,0,1,20,12,0,0,0,0,8,0
270531087003018,39,Standish,59,59,1000000US270531087003018,"Block 3018, Block Group 3, Census Tract 1087, Hennepin County, Minnesota",61,42,10,2,1,0,1,5,61,56,38,10,2,1,0,0,5,5,4,0,0,0,0,1,0
270531087003000,39,Standish,59,59,1000000US270531087003000,"Block 3000, Block Group 3, Census Tract 1087, Hennepin County, Minnesota",49,13,7,8,13,0,5,3,49,44,13,7,8,13,0,0,3,5,0,0,0,0,0,5,0
270531102002001,39,Standish,59,59,1000000US270531102002001,"Block 2001, Block Group 2, Census Tract 1102, Hennepin County, Minnesota",29,29,0,0,0,0,0,0,29,29,29,0,0,0,0,0,0,0,0,0,0,0,0,0,0
270531087003020,39,Standish,59,59,1000000US270531087003020,"Block 3020, Block Group 3, Census Tract 1087, Hennepin County, Minnesota",15,15,0,0,0,0,0,0,15,15,15,0,0,0,0,0,0,0,0,0,0,0,0,0,0
270531102001008,39,Standish,59,59,1000000US270531102001008,"Block 1008, Block Group 1, Census Tract 1102, Hennepin County, Minnesota",72,47,10,10,0,0,4,1,72,51,32,10,9,0,0,0,0,21,15,0,1,0,0,4,1
270531101001010,39,Standish,59,59,1000000US270531101001010,"Block 1010, Block Group 1, Census Tract 1101, Hennepin County, Minnesota",59,45,2,3,4,0,4,1,59,53,45,2,3,3,0,0,0,6,0,0,0,1,0,4,1
270531102001009,39,Standish,59,59,1000000US270531102001009,"Block 1009, Block Group 1, Census Tract 1102, Hennepin County, Minnesota",47,38,1,0,0,0,0,8,47,39,37,0,0,0,0,0,2,8,1,1,0,0,0,0,6
270531087003011,39,Standish,59,59,1000000US270531087003011,"Block 3011, Block Group 3, Census Tract 1087, Hennepin County, Minnesota",30,30,0,0,0,0,0,0,30,29,29,0,0,0,0,0,0,1,1,0,0,0,0,0,0
270531087003012,39,Standish,59,59,1000000US270531087003012,"Block 3012, Block Group 3, Census Tract 1087, Hennepin County, Minnesota",200,143,31,13,7,0,4,2,200,195,143,31,12,7,0,0,2,5,0,0,1,0,0,4,0
270531102001002,39,Standish,59,59,1000000US270531102001002,"Block 1002, Block Group 1, Census Tract 1102, Hennepin County, Minnesota",57,38,5,0,0,0,0,14,57,55,38,4,0,0,0,0,13,2,0,1,0,0,0,0,1
270531101001002,39,Standish,59,59,1000000US270531101001002,"Block 1002, Block Group 1, Census Tract 1101, Hennepin County, Minnesota",44,36,0,0,2,0,6,0,44,38,36,0,0,2,0,0,0,6,0,0,0,0,0,6,0
270531087003008,39,Standish,59,59,1000000US270531087003008,"Block 3008, Block Group 3, Census Tract 1087, Hennepin County, Minnesota",44,33,0,0,0,0,11,0,44,23,23,0,0,0,0,0,0,21,10,0,0,0,0,11,0
270531101001005,39,Standish,59,59,1000000US270531101001005,"Block 1005, Block Group 1, Census Tract 1101, Hennepin County, Minnesota",0,0,0,0,0,0,0,0,0,0,0,0,0,0,0,0,0,0,0,0,0,0,0,0,0
270531101001009,39,Standish,59,59,1000000US270531101001009,"Block 1009, Block Group 1, Census Tract 1101, Hennepin County, Minnesota",61,52,2,0,2,0,1,4,61,60,52,2,0,2,0,0,4,1,0,0,0,0,0,1,0
270531101001013,39,Standish,59,59,1000000US270531101001013,"Block 1013, Block Group 1, Census Tract 1101, Hennepin County, Minnesota",66,63,1,0,1,0,0,1,66,65,62,1,0,1,0,0,1,1,1,0,0,0,0,0,0
270531087003009,39,Standish,59,59,1000000US270531087003009,"Block 3009, Block Group 3, Census Tract 1087, Hennepin County, Minnesota",26,24,0,0,0,0,0,2,26,26,24,0,0,0,0,0,2,0,0,0,0,0,0,0,0
270531102003001,39,Standish,59,59,1000000US270531102003001,"Block 3001, Block Group 3, Census Tract 1102, Hennepin County, Minnesota",63,54,9,0,0,0,0,0,63,63,54,9,0,0,0,0,0,0,0,0,0,0,0,0,0
270531102002010,39,Standish,59,59,1000000US270531102002010,"Block 2010, Block Group 2, Census Tract 1102, Hennepin County, Minnesota",62,55,2,0,0,0,0,5,62,60,54,1,0,0,0,0,5,2,1,1,0,0,0,0,0
270531102003011,39,Standish,59,59,1000000US270531102003011,"Block 3011, Block Group 3, Census Tract 1102, Hennepin County, Minnesota",64,59,0,0,3,0,0,2,64,64,59,0,0,3,0,0,2,0,0,0,0,0,0,0,0
270531102004008,39,Standish,59,59,1000000US270531102004008,"Block 4008, Block Group 4, Census Tract 1102, Hennepin County, Minnesota",0,0,0,0,0,0,0,0,0,0,0,0,0,0,0,0,0,0,0,0,0,0,0,0,0
270531101001003,39,Standish,59,59,1000000US270531101001003,"Block 1003, Block Group 1, Census Tract 1101, Hennepin County, Minnesota",65,45,8,0,12,0,0,0,65,60,40,8,0,12,0,0,0,5,5,0,0,0,0,0,0
270531097001006,39,Standish,59,59,1000000US270531097001006,"Block 1006, Block Group 1, Census Tract 1097, Hennepin County, Minnesota",70,59,7,0,3,0,1,0,70,60,49,7,0,3,0,1,0,10,10,0,0,0,0,0,0
270531087003013,39,Standish,59,59,1000000US270531087003013,"Block 3013, Block Group 3, Census Tract 1087, Hennepin County, Minnesota",64,32,13,7,5,0,5,2,64,53,31,13,7,0,0,0,2,11,1,0,0,5,0,5,0
270531101001004,39,Standish,59,59,1000000US270531101001004,"Block 1004, Block Group 1, Census Tract 1101, Hennepin County, Minnesota",89,44,20,0,4,0,17,4,89,64,42,14,0,4,0,1,3,25,2,6,0,0,0,16,1
270531101001006,39,Standish,59,59,1000000US270531101001006,"Block 1006, Block Group 1, Census Tract 1101, Hennepin County, Minnesota",82,60,4,0,2,0,14,2,82,67,59,4,0,2,0,0,2,15,1,0,0,0,0,14,0
270531102001007,39,Standish,59,59,1000000US270531102001007,"Block 1007, Block Group 1, Census Tract 1102, Hennepin County, Minnesota",79,60,12,7,0,0,0,0,79,75,57,12,6,0,0,0,0,4,3,0,1,0,0,0,0
270531101001016,39,Standish,59,59,1000000US270531101001016,"Block 1016, Block Group 1, Census Tract 1101, Hennepin County, Minnesota",72,62,6,0,0,0,4,0,72,68,62,6,0,0,0,0,0,4,0,0,0,0,0,4,0
270531102002005,39,Standish,59,59,1000000US270531102002005,"Block 2005, Block Group 2, Census Tract 1102, Hennepin County, Minnesota",68,68,0,0,0,0,0,0,68,61,61,0,0,0,0,0,0,7,7,0,0,0,0,0,0
270531102002012,39,Standish,59,59,1000000US270531102002012,"Block 2012, Block Group 2, Census Tract 1102, Hennepin County, Minnesota",60,53,6,0,1,0,0,0,60,60,53,6,0,1,0,0,0,0,0,0,0,0,0,0,0
270531102001004,39,Standish,59,59,1000000US270531102001004,"Block 1004, Block Group 1, Census Tract 1102, Hennepin County, Minnesota",31,19,0,12,0,0,0,0,31,31,19,0,12,0,0,0,0,0,0,0,0,0,0,0,0
270531102001017,39,Standish,59,59,1000000US270531102001017,"Block 1017, Block Group 1, Census Tract 1102, Hennepin County, Minnesota",64,50,6,1,0,0,2,5,64,62,50,6,1,0,0,0,5,2,0,0,0,0,0,2,0
270531102003009,39,Standish,59,59,1000000US270531102003009,"Block 3009, Block Group 3, Census Tract 1102, Hennepin County, Minnesota",50,40,5,0,1,0,4,0,50,46,40,5,0,1,0,0,0,4,0,0,0,0,0,4,0
270531102003007,39,Standish,59,59,1000000US270531102003007,"Block 3007, Block Group 3, Census Tract 1102, Hennepin County, Minnesota",56,45,7,2,0,0,1,1,56,55,45,7,2,0,0,0,1,1,0,0,0,0,0,1,0
270531102003008,39,Standish,59,59,1000000US270531102003008,"Block 3008, Block Group 3, Census Tract 1102, Hennepin County, Minnesota",61,43,2,3,1,0,6,6,61,54,42,2,3,1,0,0,6,7,1,0,0,0,0,6,0
270531102004012,39,Standish,59,59,1000000US270531102004012,"Block 4012, Block Group 4, Census Tract 1102, Hennepin County, Minnesota",74,52,11,0,1,0,3,7,74,54,36,11,0,1,0,1,5,20,16,0,0,0,0,2,2
270531102004014,39,Standish,59,59,1000000US270531102004014,"Block 4014, Block Group 4, Census Tract 1102, Hennepin County, Minnesota",66,61,1,0,0,0,0,4,66,66,61,1,0,0,0,0,4,0,0,0,0,0,0,0,0
270531097001005,39,Standish,59,59,1000000US270531097001005,"Block 1005, Block Group 1, Census Tract 1097, Hennepin County, Minnesota",64,50,2,0,1,0,11,0,64,51,48,2,0,1,0,0,0,13,2,0,0,0,0,11,0
270531087003007,39,Standish,59,59,1000000US270531087003007,"Block 3007, Block Group 3, Census Tract 1087, Hennepin County, Minnesota",50,32,4,4,0,0,10,0,50,41,32,4,4,0,0,1,0,9,0,0,0,0,0,9,0
270531102001010,39,Standish,59,59,1000000US270531102001010,"Block 1010, Block Group 1, Census Tract 1102, Hennepin County, Minnesota",52,50,1,0,0,0,0,1,52,51,49,1,0,0,0,0,1,1,1,0,0,0,0,0,0
270531087003005,39,Standish,59,59,1000000US270531087003005,"Block 3005, Block Group 3, Census Tract 1087, Hennepin County, Minnesota",33,31,1,0,1,0,0,0,33,33,31,1,0,1,0,0,0,0,0,0,0,0,0,0,0
270531102002002,39,Standish,59,59,1000000US270531102002002,"Block 2002, Block Group 2, Census Tract 1102, Hennepin County, Minnesota",72,56,1,13,0,0,1,1,72,71,56,1,13,0,0,0,1,1,0,0,0,0,0,1,0
270531102002006,39,Standish,59,59,1000000US270531102002006,"Block 2006, Block Group 2, Census Tract 1102, Hennepin County, Minnesota",64,51,2,0,8,0,3,0,64,57,48,1,0,8,0,0,0,7,3,1,0,0,0,3,0
270531102004013,39,Standish,59,59,1000000US270531102004013,"Block 4013, Block Group 4, Census Tract 1102, Hennepin County, Minnesota",60,37,16,0,1,0,0,6,60,44,21,16,0,1,0,0,6,16,16,0,0,0,0,0,0
270531064002011,40,Seward,60,60,1000000US270531064002011,"Block 2011, Block Group 2, Census Tract 1064, Hennepin County, Minnesota",73,67,1,1,3,0,0,1,73,72,66,1,1,3,0,0,1,1,1,0,0,0,0,0,0
270531064002024,40,Seward,60,60,1000000US270531064002024,"Block 2024, Block Group 2, Census Tract 1064, Hennepin County, Minnesota",27,14,12,0,1,0,0,0,27,27,14,12,0,1,0,0,0,0,0,0,0,0,0,0,0
270531062003003,40,Seward,60,60,1000000US270531062003003,"Block 3003, Block Group 3, Census Tract 1062, Hennepin County, Minnesota",144,20,113,6,0,0,0,5,144,144,20,113,6,0,0,0,5,0,0,0,0,0,0,0,0
270531075002007,40,Seward,60,60,1000000US270531075002007,"Block 2007, Block Group 2, Census Tract 1075, Hennepin County, Minnesota",2,2,0,0,0,0,0,0,2,1,1,0,0,0,0,0,0,1,1,0,0,0,0,0,0
270531075002003,40,Seward,60,60,1000000US270531075002003,"Block 2003, Block Group 2, Census Tract 1075, Hennepin County, Minnesota",80,30,35,0,5,0,3,7,80,72,28,35,0,5,0,1,3,8,2,0,0,0,0,2,4
270531062001004,40,Seward,60,60,1000000US270531062001004,"Block 1004, Block Group 1, Census Tract 1062, Hennepin County, Minnesota",744,186,435,19,67,0,10,27,744,724,181,431,19,67,0,0,26,20,5,4,0,0,0,10,1
270531062002004,40,Seward,60,60,1000000US270531062002004,"Block 2004, Block Group 2, Census Tract 1062, Hennepin County, Minnesota",83,55,18,0,5,0,0,5,83,82,55,18,0,5,0,0,4,1,0,0,0,0,0,0,1
270531062002005,40,Seward,60,60,1000000US270531062002005,"Block 2005, Block Group 2, Census Tract 1062, Hennepin County, Minnesota",90,68,20,1,0,0,0,1,90,89,67,20,1,0,0,0,1,1,1,0,0,0,0,0,0
270531075002015,40,Seward,60,60,1000000US270531075002015,"Block 2015, Block Group 2, Census Tract 1075, Hennepin County, Minnesota",0,0,0,0,0,0,0,0,0,0,0,0,0,0,0,0,0,0,0,0,0,0,0,0,0
270531064002003,40,Seward,60,60,1000000US270531064002003,"Block 2003, Block Group 2, Census Tract 1064, Hennepin County, Minnesota",0,0,0,0,0,0,0,0,0,0,0,0,0,0,0,0,0,0,0,0,0,0,0,0,0
270531075001020,40,Seward,60,60,1000000US270531075001020,"Block 1020, Block Group 1, Census Tract 1075, Hennepin County, Minnesota",81,76,0,1,1,0,0,3,81,81,76,0,1,1,0,0,3,0,0,0,0,0,0,0,0
270531062001006,40,Seward,60,60,1000000US270531062001006,"Block 1006, Block Group 1, Census Tract 1062, Hennepin County, Minnesota",202,75,98,3,20,0,6,0,202,196,75,97,3,20,0,1,0,6,0,1,0,0,0,5,0
270531062001007,40,Seward,60,60,1000000US270531062001007,"Block 1007, Block Group 1, Census Tract 1062, Hennepin County, Minnesota",0,0,0,0,0,0,0,0,0,0,0,0,0,0,0,0,0,0,0,0,0,0,0,0,0
270531062002002,40,Seward,60,60,1000000US270531062002002,"Block 2002, Block Group 2, Census Tract 1062, Hennepin County, Minnesota",152,109,20,0,10,0,1,12,152,141,108,20,0,10,0,1,2,11,1,0,0,0,0,0,10
270531062002001,40,Seward,60,60,1000000US270531062002001,"Block 2001, Block Group 2, Census Tract 1062, Hennepin County, Minnesota",69,49,0,3,10,0,0,7,69,67,49,0,3,10,0,0,5,2,0,0,0,0,0,0,2
270531075002030,40,Seward,60,60,1000000US270531075002030,"Block 2030, Block Group 2, Census Tract 1075, Hennepin County, Minnesota",0,0,0,0,0,0,0,0,0,0,0,0,0,0,0,0,0,0,0,0,0,0,0,0,0
270531075002005,40,Seward,60,60,1000000US270531075002005,"Block 2005, Block Group 2, Census Tract 1075, Hennepin County, Minnesota",36,32,1,0,1,0,0,2,36,36,32,1,0,1,0,0,2,0,0,0,0,0,0,0,0
270531062003005,40,Seward,60,60,1000000US270531062003005,"Block 3005, Block Group 3, Census Tract 1062, Hennepin County, Minnesota",19,11,7,1,0,0,0,0,19,19,11,7,1,0,0,0,0,0,0,0,0,0,0,0,0
270531062003007,40,Seward,60,60,1000000US270531062003007,"Block 3007, Block Group 3, Census Tract 1062, Hennepin County, Minnesota",71,55,12,0,3,0,1,0,71,66,50,12,0,3,0,1,0,5,5,0,0,0,0,0,0
270531062002006,40,Seward,60,60,1000000US270531062002006,"Block 2006, Block Group 2, Census Tract 1062, Hennepin County, Minnesota",132,105,16,0,4,0,0,7,132,123,96,16,0,4,0,0,7,9,9,0,0,0,0,0,0
270531075002024,40,Seward,60,60,1000000US270531075002024,"Block 2024, Block Group 2, Census Tract 1075, Hennepin County, Minnesota",0,0,0,0,0,0,0,0,0,0,0,0,0,0,0,0,0,0,0,0,0,0,0,0,0
270531075001026,40,Seward,60,60,1000000US270531075001026,"Block 1026, Block Group 1, Census Tract 1075, Hennepin County, Minnesota",0,0,0,0,0,0,0,0,0,0,0,0,0,0,0,0,0,0,0,0,0,0,0,0,0
270531075001023,40,Seward,60,60,1000000US270531075001023,"Block 1023, Block Group 1, Census Tract 1075, Hennepin County, Minnesota",73,51,13,4,0,0,0,5,73,71,50,13,4,0,0,0,4,2,1,0,0,0,0,0,1
270531062003000,40,Seward,60,60,1000000US270531062003000,"Block 3000, Block Group 3, Census Tract 1062, Hennepin County, Minnesota",87,65,14,4,3,0,0,1,87,86,64,14,4,3,0,0,1,1,1,0,0,0,0,0,0
270531064001007,40,Seward,60,60,1000000US270531064001007,"Block 1007, Block Group 1, Census Tract 1064, Hennepin County, Minnesota",552,62,474,4,2,0,2,8,552,548,61,472,4,2,0,2,7,4,1,2,0,0,0,0,1
270531064002022,40,Seward,60,60,1000000US270531064002022,"Block 2022, Block Group 2, Census Tract 1064, Hennepin County, Minnesota",0,0,0,0,0,0,0,0,0,0,0,0,0,0,0,0,0,0,0,0,0,0,0,0,0
270531075002002,40,Seward,60,60,1000000US270531075002002,"Block 2002, Block Group 2, Census Tract 1075, Hennepin County, Minnesota",0,0,0,0,0,0,0,0,0,0,0,0,0,0,0,0,0,0,0,0,0,0,0,0,0
270531075002001,40,Seward,60,60,1000000US270531075002001,"Block 2001, Block Group 2, Census Tract 1075, Hennepin County, Minnesota",75,68,3,0,2,0,2,0,75,69,62,3,0,2,0,2,0,6,6,0,0,0,0,0,0
270531064002000,40,Seward,60,60,1000000US270531064002000,"Block 2000, Block Group 2, Census Tract 1064, Hennepin County, Minnesota",0,0,0,0,0,0,0,0,0,0,0,0,0,0,0,0,0,0,0,0,0,0,0,0,0
270531075002020,40,Seward,60,60,1000000US270531075002020,"Block 2020, Block Group 2, Census Tract 1075, Hennepin County, Minnesota",83,55,8,4,10,0,4,2,83,78,55,8,4,10,0,0,1,5,0,0,0,0,0,4,1
270531075001012,40,Seward,60,60,1000000US270531075001012,"Block 1012, Block Group 1, Census Tract 1075, Hennepin County, Minnesota",68,61,0,0,5,0,0,2,68,67,60,0,0,5,0,0,2,1,1,0,0,0,0,0,0
270531062001009,40,Seward,60,60,1000000US270531062001009,"Block 1009, Block Group 1, Census Tract 1062, Hennepin County, Minnesota",0,0,0,0,0,0,0,0,0,0,0,0,0,0,0,0,0,0,0,0,0,0,0,0,0
270531062003001,40,Seward,60,60,1000000US270531062003001,"Block 3001, Block Group 3, Census Tract 1062, Hennepin County, Minnesota",161,126,14,8,6,0,4,3,161,159,125,14,8,6,0,3,3,2,1,0,0,0,0,1,0
270531075002004,40,Seward,60,60,1000000US270531075002004,"Block 2004, Block Group 2, Census Tract 1075, Hennepin County, Minnesota",81,43,20,1,4,0,1,12,81,77,43,20,1,4,0,0,9,4,0,0,0,0,0,1,3
270531062001011,40,Seward,60,60,1000000US270531062001011,"Block 1011, Block Group 1, Census Tract 1062, Hennepin County, Minnesota",506,49,443,2,2,0,1,9,506,501,48,441,2,2,0,0,8,5,1,2,0,0,0,1,1
270531064002008,40,Seward,60,60,1000000US270531064002008,"Block 2008, Block Group 2, Census Tract 1064, Hennepin County, Minnesota",0,0,0,0,0,0,0,0,0,0,0,0,0,0,0,0,0,0,0,0,0,0,0,0,0
270531075002014,40,Seward,60,60,1000000US270531075002014,"Block 2014, Block Group 2, Census Tract 1075, Hennepin County, Minnesota",0,0,0,0,0,0,0,0,0,0,0,0,0,0,0,0,0,0,0,0,0,0,0,0,0
270531064001000,40,Seward,60,60,1000000US270531064001000,"Block 1000, Block Group 1, Census Tract 1064, Hennepin County, Minnesota",0,0,0,0,0,0,0,0,0,0,0,0,0,0,0,0,0,0,0,0,0,0,0,0,0
270531075002017,40,Seward,60,60,1000000US270531075002017,"Block 2017, Block Group 2, Census Tract 1075, Hennepin County, Minnesota",32,28,0,1,1,0,0,2,32,29,26,0,1,0,0,0,2,3,2,0,0,1,0,0,0
270531075001008,40,Seward,60,60,1000000US270531075001008,"Block 1008, Block Group 1, Census Tract 1075, Hennepin County, Minnesota",73,68,1,0,0,0,2,2,73,71,68,1,0,0,0,0,2,2,0,0,0,0,0,2,0
270531075001001,40,Seward,60,60,1000000US270531075001001,"Block 1001, Block Group 1, Census Tract 1075, Hennepin County, Minnesota",0,0,0,0,0,0,0,0,0,0,0,0,0,0,0,0,0,0,0,0,0,0,0,0,0
270531075002021,40,Seward,60,60,1000000US270531075002021,"Block 2021, Block Group 2, Census Tract 1075, Hennepin County, Minnesota",4,3,1,0,0,0,0,0,4,4,3,1,0,0,0,0,0,0,0,0,0,0,0,0,0
270531064001008,40,Seward,60,60,1000000US270531064001008,"Block 1008, Block Group 1, Census Tract 1064, Hennepin County, Minnesota",34,27,4,0,1,0,1,1,34,22,18,3,0,1,0,0,0,12,9,1,0,0,0,1,1
270531064001003,40,Seward,60,60,1000000US270531064001003,"Block 1003, Block Group 1, Census Tract 1064, Hennepin County, Minnesota",6,5,0,0,0,0,0,1,6,6,5,0,0,0,0,0,1,0,0,0,0,0,0,0,0
270531064001009,40,Seward,60,60,1000000US270531064001009,"Block 1009, Block Group 1, Census Tract 1064, Hennepin County, Minnesota",171,42,118,9,2,0,0,0,171,167,41,115,9,2,0,0,0,4,1,3,0,0,0,0,0
270531064002010,40,Seward,60,60,1000000US270531064002010,"Block 2010, Block Group 2, Census Tract 1064, Hennepin County, Minnesota",64,60,2,0,0,0,2,0,64,62,60,2,0,0,0,0,0,2,0,0,0,0,0,2,0
270531075002019,40,Seward,60,60,1000000US270531075002019,"Block 2019, Block Group 2, Census Tract 1075, Hennepin County, Minnesota",85,64,8,0,4,0,0,9,85,83,62,8,0,4,0,0,9,2,2,0,0,0,0,0,0
270531075002000,40,Seward,60,60,1000000US270531075002000,"Block 2000, Block Group 2, Census Tract 1075, Hennepin County, Minnesota",94,86,5,0,1,0,0,2,94,92,86,5,0,0,0,0,1,2,0,0,0,1,0,0,1
270531064002017,40,Seward,60,60,1000000US270531064002017,"Block 2017, Block Group 2, Census Tract 1064, Hennepin County, Minnesota",50,49,0,0,1,0,0,0,50,50,49,0,0,1,0,0,0,0,0,0,0,0,0,0,0
270531075001010,40,Seward,60,60,1000000US270531075001010,"Block 1010, Block Group 1, Census Tract 1075, Hennepin County, Minnesota",60,58,0,0,0,0,0,2,60,58,56,0,0,0,0,0,2,2,2,0,0,0,0,0,0
270531062002000,40,Seward,60,60,1000000US270531062002000,"Block 2000, Block Group 2, Census Tract 1062, Hennepin County, Minnesota",0,0,0,0,0,0,0,0,0,0,0,0,0,0,0,0,0,0,0,0,0,0,0,0,0
270531064002014,40,Seward,60,60,1000000US270531064002014,"Block 2014, Block Group 2, Census Tract 1064, Hennepin County, Minnesota",25,15,0,9,1,0,0,0,25,25,15,0,9,1,0,0,0,0,0,0,0,0,0,0,0
270531064002007,40,Seward,60,60,1000000US270531064002007,"Block 2007, Block Group 2, Census Tract 1064, Hennepin County, Minnesota",0,0,0,0,0,0,0,0,0,0,0,0,0,0,0,0,0,0,0,0,0,0,0,0,0
270531064002021,40,Seward,60,60,1000000US270531064002021,"Block 2021, Block Group 2, Census Tract 1064, Hennepin County, Minnesota",71,65,0,0,5,0,0,1,71,69,63,0,0,5,0,0,1,2,2,0,0,0,0,0,0
270531075002016,40,Seward,60,60,1000000US270531075002016,"Block 2016, Block Group 2, Census Tract 1075, Hennepin County, Minnesota",0,0,0,0,0,0,0,0,0,0,0,0,0,0,0,0,0,0,0,0,0,0,0,0,0
270531075002027,40,Seward,60,60,1000000US270531075002027,"Block 2027, Block Group 2, Census Tract 1075, Hennepin County, Minnesota",0,0,0,0,0,0,0,0,0,0,0,0,0,0,0,0,0,0,0,0,0,0,0,0,0
270531075002028,40,Seward,60,60,1000000US270531075002028,"Block 2028, Block Group 2, Census Tract 1075, Hennepin County, Minnesota",0,0,0,0,0,0,0,0,0,0,0,0,0,0,0,0,0,0,0,0,0,0,0,0,0
270531064001005,40,Seward,60,60,1000000US270531064001005,"Block 1005, Block Group 1, Census Tract 1064, Hennepin County, Minnesota",0,0,0,0,0,0,0,0,0,0,0,0,0,0,0,0,0,0,0,0,0,0,0,0,0
270531064001004,40,Seward,60,60,1000000US270531064001004,"Block 1004, Block Group 1, Census Tract 1064, Hennepin County, Minnesota",0,0,0,0,0,0,0,0,0,0,0,0,0,0,0,0,0,0,0,0,0,0,0,0,0
270531064002001,40,Seward,60,60,1000000US270531064002001,"Block 2001, Block Group 2, Census Tract 1064, Hennepin County, Minnesota",0,0,0,0,0,0,0,0,0,0,0,0,0,0,0,0,0,0,0,0,0,0,0,0,0
270531075001000,40,Seward,60,60,1000000US270531075001000,"Block 1000, Block Group 1, Census Tract 1075, Hennepin County, Minnesota",0,0,0,0,0,0,0,0,0,0,0,0,0,0,0,0,0,0,0,0,0,0,0,0,0
270531075001003,40,Seward,60,60,1000000US270531075001003,"Block 1003, Block Group 1, Census Tract 1075, Hennepin County, Minnesota",0,0,0,0,0,0,0,0,0,0,0,0,0,0,0,0,0,0,0,0,0,0,0,0,0
270531064002015,40,Seward,60,60,1000000US270531064002015,"Block 2015, Block Group 2, Census Tract 1064, Hennepin County, Minnesota",74,68,0,3,0,3,0,0,74,71,66,0,2,0,3,0,0,3,2,0,1,0,0,0,0
270531064002012,40,Seward,60,60,1000000US270531064002012,"Block 2012, Block Group 2, Census Tract 1064, Hennepin County, Minnesota",41,40,0,0,1,0,0,0,41,41,40,0,0,1,0,0,0,0,0,0,0,0,0,0,0
270531075002018,40,Seward,60,60,1000000US270531075002018,"Block 2018, Block Group 2, Census Tract 1075, Hennepin County, Minnesota",65,55,4,2,2,0,0,2,65,65,55,4,2,2,0,0,2,0,0,0,0,0,0,0,0
270531075002026,40,Seward,60,60,1000000US270531075002026,"Block 2026, Block Group 2, Census Tract 1075, Hennepin County, Minnesota",0,0,0,0,0,0,0,0,0,0,0,0,0,0,0,0,0,0,0,0,0,0,0,0,0
270531075002022,40,Seward,60,60,1000000US270531075002022,"Block 2022, Block Group 2, Census Tract 1075, Hennepin County, Minnesota",73,59,3,2,3,0,5,1,73,58,53,0,2,3,0,0,0,15,6,3,0,0,0,5,1
270531064002005,40,Seward,60,60,1000000US270531064002005,"Block 2005, Block Group 2, Census Tract 1064, Hennepin County, Minnesota",57,50,0,0,3,0,0,4,57,56,50,0,0,3,0,0,3,1,0,0,0,0,0,0,1
270531064002013,40,Seward,60,60,1000000US270531064002013,"Block 2013, Block Group 2, Census Tract 1064, Hennepin County, Minnesota",20,19,0,0,0,0,0,1,20,20,19,0,0,0,0,0,1,0,0,0,0,0,0,0,0
270531064002016,40,Seward,60,60,1000000US270531064002016,"Block 2016, Block Group 2, Census Tract 1064, Hennepin County, Minnesota",84,76,3,0,0,0,1,4,84,83,76,3,0,0,0,0,4,1,0,0,0,0,0,1,0
270531064002004,40,Seward,60,60,1000000US270531064002004,"Block 2004, Block Group 2, Census Tract 1064, Hennepin County, Minnesota",45,45,0,0,0,0,0,0,45,45,45,0,0,0,0,0,0,0,0,0,0,0,0,0,0
270531075001007,40,Seward,60,60,1000000US270531075001007,"Block 1007, Block Group 1, Census Tract 1075, Hennepin County, Minnesota",70,68,0,0,0,0,0,2,70,69,68,0,0,0,0,0,1,1,0,0,0,0,0,0,1
270531075001009,40,Seward,60,60,1000000US270531075001009,"Block 1009, Block Group 1, Census Tract 1075, Hennepin County, Minnesota",81,72,2,5,0,0,0,2,81,79,70,2,5,0,0,0,2,2,2,0,0,0,0,0,0
270531064002018,40,Seward,60,60,1000000US270531064002018,"Block 2018, Block Group 2, Census Tract 1064, Hennepin County, Minnesota",17,17,0,0,0,0,0,0,17,17,17,0,0,0,0,0,0,0,0,0,0,0,0,0,0
270531075001002,40,Seward,60,60,1000000US270531075001002,"Block 1002, Block Group 1, Census Tract 1075, Hennepin County, Minnesota",0,0,0,0,0,0,0,0,0,0,0,0,0,0,0,0,0,0,0,0,0,0,0,0,0
270531075001019,40,Seward,60,60,1000000US270531075001019,"Block 1019, Block Group 1, Census Tract 1075, Hennepin County, Minnesota",4,4,0,0,0,0,0,0,4,4,4,0,0,0,0,0,0,0,0,0,0,0,0,0,0
270531075001022,40,Seward,60,60,1000000US270531075001022,"Block 1022, Block Group 1, Census Tract 1075, Hennepin County, Minnesota",0,0,0,0,0,0,0,0,0,0,0,0,0,0,0,0,0,0,0,0,0,0,0,0,0
270531075001014,40,Seward,60,60,1000000US270531075001014,"Block 1014, Block Group 1, Census Tract 1075, Hennepin County, Minnesota",42,37,4,0,0,0,1,0,42,40,36,4,0,0,0,0,0,2,1,0,0,0,0,1,0
270531075001024,40,Seward,60,60,1000000US270531075001024,"Block 1024, Block Group 1, Census Tract 1075, Hennepin County, Minnesota",63,61,1,1,0,0,0,0,63,63,61,1,1,0,0,0,0,0,0,0,0,0,0,0,0
270531075001015,40,Seward,60,60,1000000US270531075001015,"Block 1015, Block Group 1, Census Tract 1075, Hennepin County, Minnesota",43,41,1,0,0,0,1,0,43,42,41,1,0,0,0,0,0,1,0,0,0,0,0,1,0
270531075001021,40,Seward,60,60,1000000US270531075001021,"Block 1021, Block Group 1, Census Tract 1075, Hennepin County, Minnesota",8,7,0,0,1,0,0,0,8,8,7,0,0,1,0,0,0,0,0,0,0,0,0,0,0
270531075001027,40,Seward,60,60,1000000US270531075001027,"Block 1027, Block Group 1, Census Tract 1075, Hennepin County, Minnesota",54,51,0,0,1,0,0,2,54,52,49,0,0,1,0,0,2,2,2,0,0,0,0,0,0
270531075001028,40,Seward,60,60,1000000US270531075001028,"Block 1028, Block Group 1, Census Tract 1075, Hennepin County, Minnesota",45,45,0,0,0,0,0,0,45,45,45,0,0,0,0,0,0,0,0,0,0,0,0,0,0
270531075001005,40,Seward,60,60,1000000US270531075001005,"Block 1005, Block Group 1, Census Tract 1075, Hennepin County, Minnesota",50,49,0,0,0,0,1,0,50,50,49,0,0,0,0,1,0,0,0,0,0,0,0,0,0
270531075001004,40,Seward,60,60,1000000US270531075001004,"Block 1004, Block Group 1, Census Tract 1075, Hennepin County, Minnesota",4,3,0,0,0,0,0,1,4,4,3,0,0,0,0,0,1,0,0,0,0,0,0,0,0
270531075001018,40,Seward,60,60,1000000US270531075001018,"Block 1018, Block Group 1, Census Tract 1075, Hennepin County, Minnesota",21,17,0,0,1,0,0,3,21,21,17,0,0,1,0,0,3,0,0,0,0,0,0,0,0
270531256001014,40,Seward,60,60,1000000US270531256001014,"Block 1014, Block Group 1, Census Tract 1256, Hennepin County, Minnesota",0,0,0,0,0,0,0,0,0,0,0,0,0,0,0,0,0,0,0,0,0,0,0,0,0
270531062001008,40,Seward,60,60,1000000US270531062001008,"Block 1008, Block Group 1, Census Tract 1062, Hennepin County, Minnesota",0,0,0,0,0,0,0,0,0,0,0,0,0,0,0,0,0,0,0,0,0,0,0,0,0
270531062001001,40,Seward,60,60,1000000US270531062001001,"Block 1001, Block Group 1, Census Tract 1062, Hennepin County, Minnesota",0,0,0,0,0,0,0,0,0,0,0,0,0,0,0,0,0,0,0,0,0,0,0,0,0
270531062002008,40,Seward,60,60,1000000US270531062002008,"Block 2008, Block Group 2, Census Tract 1062, Hennepin County, Minnesota",92,69,12,0,4,0,2,5,92,86,67,12,0,4,0,0,3,6,2,0,0,0,0,2,2
270531075002008,40,Seward,60,60,1000000US270531075002008,"Block 2008, Block Group 2, Census Tract 1075, Hennepin County, Minnesota",0,0,0,0,0,0,0,0,0,0,0,0,0,0,0,0,0,0,0,0,0,0,0,0,0
270531062001010,40,Seward,60,60,1000000US270531062001010,"Block 1010, Block Group 1, Census Tract 1062, Hennepin County, Minnesota",0,0,0,0,0,0,0,0,0,0,0,0,0,0,0,0,0,0,0,0,0,0,0,0,0
270531062003004,40,Seward,60,60,1000000US270531062003004,"Block 3004, Block Group 3, Census Tract 1062, Hennepin County, Minnesota",0,0,0,0,0,0,0,0,0,0,0,0,0,0,0,0,0,0,0,0,0,0,0,0,0
270531062003002,40,Seward,60,60,1000000US270531062003002,"Block 3002, Block Group 3, Census Tract 1062, Hennepin County, Minnesota",296,70,194,5,6,0,15,6,296,267,60,193,3,6,0,0,5,29,10,1,2,0,0,15,1
270531062001000,40,Seward,60,60,1000000US270531062001000,"Block 1000, Block Group 1, Census Tract 1062, Hennepin County, Minnesota",0,0,0,0,0,0,0,0,0,0,0,0,0,0,0,0,0,0,0,0,0,0,0,0,0
270531064002006,40,Seward,60,60,1000000US270531064002006,"Block 2006, Block Group 2, Census Tract 1064, Hennepin County, Minnesota",16,15,0,0,0,0,0,1,16,15,14,0,0,0,0,0,1,1,1,0,0,0,0,0,0
270531064002023,40,Seward,60,60,1000000US270531064002023,"Block 2023, Block Group 2, Census Tract 1064, Hennepin County, Minnesota",118,90,3,7,7,1,2,8,118,103,89,2,0,7,1,0,4,15,1,1,7,0,0,2,4
270531064001001,40,Seward,60,60,1000000US270531064001001,"Block 1001, Block Group 1, Census Tract 1064, Hennepin County, Minnesota",0,0,0,0,0,0,0,0,0,0,0,0,0,0,0,0,0,0,0,0,0,0,0,0,0
270531064002009,40,Seward,60,60,1000000US270531064002009,"Block 2009, Block Group 2, Census Tract 1064, Hennepin County, Minnesota",70,55,3,0,9,0,0,3,70,70,55,3,0,9,0,0,3,0,0,0,0,0,0,0,0
270531064001006,40,Seward,60,60,1000000US270531064001006,"Block 1006, Block Group 1, Census Tract 1064, Hennepin County, Minnesota",159,70,77,0,7,0,0,5,159,158,70,76,0,7,0,0,5,1,0,1,0,0,0,0,0
270531064001002,40,Seward,60,60,1000000US270531064001002,"Block 1002, Block Group 1, Census Tract 1064, Hennepin County, Minnesota",0,0,0,0,0,0,0,0,0,0,0,0,0,0,0,0,0,0,0,0,0,0,0,0,0
270531064002020,40,Seward,60,60,1000000US270531064002020,"Block 2020, Block Group 2, Census Tract 1064, Hennepin County, Minnesota",0,0,0,0,0,0,0,0,0,0,0,0,0,0,0,0,0,0,0,0,0,0,0,0,0
270531064002019,40,Seward,60,60,1000000US270531064002019,"Block 2019, Block Group 2, Census Tract 1064, Hennepin County, Minnesota",47,46,0,0,1,0,0,0,47,47,46,0,0,1,0,0,0,0,0,0,0,0,0,0,0
270531075001011,40,Seward,60,60,1000000US270531075001011,"Block 1011, Block Group 1, Census Tract 1075, Hennepin County, Minnesota",86,72,3,2,2,0,4,3,86,80,70,3,2,2,0,0,3,6,2,0,0,0,0,4,0
270531075001025,40,Seward,60,60,1000000US270531075001025,"Block 1025, Block Group 1, Census Tract 1075, Hennepin County, Minnesota",45,39,0,0,6,0,0,0,45,45,39,0,0,6,0,0,0,0,0,0,0,0,0,0,0
270531075001006,40,Seward,60,60,1000000US270531075001006,"Block 1006, Block Group 1, Census Tract 1075, Hennepin County, Minnesota",61,56,1,0,2,0,2,0,61,59,56,1,0,2,0,0,0,2,0,0,0,0,0,2,0
270531075001013,40,Seward,60,60,1000000US270531075001013,"Block 1013, Block Group 1, Census Tract 1075, Hennepin County, Minnesota",75,68,0,0,0,0,0,7,75,71,67,0,0,0,0,0,4,4,1,0,0,0,0,0,3
270531075002006,40,Seward,60,60,1000000US270531075002006,"Block 2006, Block Group 2, Census Tract 1075, Hennepin County, Minnesota",52,30,21,1,0,0,0,0,52,52,30,21,1,0,0,0,0,0,0,0,0,0,0,0,0
270531062001005,40,Seward,60,60,1000000US270531062001005,"Block 1005, Block Group 1, Census Tract 1062, Hennepin County, Minnesota",213,91,109,3,5,0,0,5,213,207,87,108,3,5,0,0,4,6,4,1,0,0,0,0,1
270531062001012,40,Seward,60,60,1000000US270531062001012,"Block 1012, Block Group 1, Census Tract 1062, Hennepin County, Minnesota",21,20,0,0,1,0,0,0,21,20,19,0,0,1,0,0,0,1,1,0,0,0,0,0,0
270531075002023,40,Seward,60,60,1000000US270531075002023,"Block 2023, Block Group 2, Census Tract 1075, Hennepin County, Minnesota",62,39,11,1,2,0,5,4,62,44,33,7,1,2,0,0,1,18,6,4,0,0,0,5,3
270531064002002,40,Seward,60,60,1000000US270531064002002,"Block 2002, Block Group 2, Census Tract 1064, Hennepin County, Minnesota",0,0,0,0,0,0,0,0,0,0,0,0,0,0,0,0,0,0,0,0,0,0,0,0,0
270531062001013,40,Seward,60,60,1000000US270531062001013,"Block 1013, Block Group 1, Census Tract 1062, Hennepin County, Minnesota",51,20,15,0,6,0,0,10,51,50,19,15,0,6,0,0,10,1,1,0,0,0,0,0,0
270531075001016,40,Seward,60,60,1000000US270531075001016,"Block 1016, Block Group 1, Census Tract 1075, Hennepin County, Minnesota",57,54,0,0,1,0,1,1,57,55,53,0,0,1,0,0,1,2,1,0,0,0,0,1,0
270531075001017,40,Seward,60,60,1000000US270531075001017,"Block 1017, Block Group 1, Census Tract 1075, Hennepin County, Minnesota",0,0,0,0,0,0,0,0,0,0,0,0,0,0,0,0,0,0,0,0,0,0,0,0,0
270531062001002,40,Seward,60,60,1000000US270531062001002,"Block 1002, Block Group 1, Census Tract 1062, Hennepin County, Minnesota",0,0,0,0,0,0,0,0,0,0,0,0,0,0,0,0,0,0,0,0,0,0,0,0,0
270531062003009,40,Seward,60,60,1000000US270531062003009,"Block 3009, Block Group 3, Census Tract 1062, Hennepin County, Minnesota",0,0,0,0,0,0,0,0,0,0,0,0,0,0,0,0,0,0,0,0,0,0,0,0,0
270531062001003,40,Seward,60,60,1000000US270531062001003,"Block 1003, Block Group 1, Census Tract 1062, Hennepin County, Minnesota",179,106,39,11,13,0,1,9,179,171,102,39,9,13,0,0,8,8,4,0,2,0,0,1,1
270531062003008,40,Seward,60,60,1000000US270531062003008,"Block 3008, Block Group 3, Census Tract 1062, Hennepin County, Minnesota",0,0,0,0,0,0,0,0,0,0,0,0,0,0,0,0,0,0,0,0,0,0,0,0,0
270531075002029,40,Seward,60,60,1000000US270531075002029,"Block 2029, Block Group 2, Census Tract 1075, Hennepin County, Minnesota",0,0,0,0,0,0,0,0,0,0,0,0,0,0,0,0,0,0,0,0,0,0,0,0,0
270531062002003,40,Seward,60,60,1000000US270531062002003,"Block 2003, Block Group 2, Census Tract 1062, Hennepin County, Minnesota",57,49,4,3,1,0,0,0,57,54,49,4,0,1,0,0,0,3,0,0,3,0,0,0,0
270531075002009,40,Seward,60,60,1000000US270531075002009,"Block 2009, Block Group 2, Census Tract 1075, Hennepin County, Minnesota",0,0,0,0,0,0,0,0,0,0,0,0,0,0,0,0,0,0,0,0,0,0,0,0,0
270531062003006,40,Seward,60,60,1000000US270531062003006,"Block 3006, Block Group 3, Census Tract 1062, Hennepin County, Minnesota",0,0,0,0,0,0,0,0,0,0,0,0,0,0,0,0,0,0,0,0,0,0,0,0,0
270531062002007,40,Seward,60,60,1000000US270531062002007,"Block 2007, Block Group 2, Census Tract 1062, Hennepin County, Minnesota",130,85,26,9,3,1,0,6,130,127,82,26,9,3,1,0,6,3,3,0,0,0,0,0,0
270531088004009,41,Longfellow,61,61,1000000US270531088004009,"Block 4009, Block Group 4, Census Tract 1088, Hennepin County, Minnesota",107,51,10,4,3,2,28,9,107,36,26,1,4,1,2,0,2,71,25,9,0,2,0,28,7
270531089003002,41,Longfellow,61,61,1000000US270531089003002,"Block 3002, Block Group 3, Census Tract 1089, Hennepin County, Minnesota",44,40,0,0,3,0,0,1,44,44,40,0,0,3,0,0,1,0,0,0,0,0,0,0,0
270531089003000,41,Longfellow,61,61,1000000US270531089003000,"Block 3000, Block Group 3, Census Tract 1089, Hennepin County, Minnesota",39,32,2,0,1,0,0,4,39,39,32,2,0,1,0,0,4,0,0,0,0,0,0,0,0
270531088004013,41,Longfellow,61,61,1000000US270531088004013,"Block 4013, Block Group 4, Census Tract 1088, Hennepin County, Minnesota",0,0,0,0,0,0,0,0,0,0,0,0,0,0,0,0,0,0,0,0,0,0,0,0,0
270531089003005,41,Longfellow,61,61,1000000US270531089003005,"Block 3005, Block Group 3, Census Tract 1089, Hennepin County, Minnesota",69,56,5,2,1,0,4,1,69,65,56,5,2,1,0,0,1,4,0,0,0,0,0,4,0
270531089003001,41,Longfellow,61,61,1000000US270531089003001,"Block 3001, Block Group 3, Census Tract 1089, Hennepin County, Minnesota",38,25,3,7,1,0,1,1,38,38,25,3,7,1,0,1,1,0,0,0,0,0,0,0,0
270531089003006,41,Longfellow,61,61,1000000US270531089003006,"Block 3006, Block Group 3, Census Tract 1089, Hennepin County, Minnesota",72,53,7,0,0,0,2,10,72,64,50,7,0,0,0,0,7,8,3,0,0,0,0,2,3
270531074002003,41,Longfellow,61,61,1000000US270531074002003,"Block 2003, Block Group 2, Census Tract 1074, Hennepin County, Minnesota",51,39,3,0,2,0,0,7,51,51,39,3,0,2,0,0,7,0,0,0,0,0,0,0,0
270531074002005,41,Longfellow,61,61,1000000US270531074002005,"Block 2005, Block Group 2, Census Tract 1074, Hennepin County, Minnesota",75,67,1,3,1,0,0,3,75,75,67,1,3,1,0,0,3,0,0,0,0,0,0,0,0
270531089003015,41,Longfellow,61,61,1000000US270531089003015,"Block 3015, Block Group 3, Census Tract 1089, Hennepin County, Minnesota",61,51,1,3,0,0,0,6,61,60,51,1,3,0,0,0,5,1,0,0,0,0,0,0,1
270531075002012,41,Longfellow,61,61,1000000US270531075002012,"Block 2012, Block Group 2, Census Tract 1075, Hennepin County, Minnesota",0,0,0,0,0,0,0,0,0,0,0,0,0,0,0,0,0,0,0,0,0,0,0,0,0
270531074001003,41,Longfellow,61,61,1000000US270531074001003,"Block 1003, Block Group 1, Census Tract 1074, Hennepin County, Minnesota",0,0,0,0,0,0,0,0,0,0,0,0,0,0,0,0,0,0,0,0,0,0,0,0,0
270531075002025,41,Longfellow,61,61,1000000US270531075002025,"Block 2025, Block Group 2, Census Tract 1075, Hennepin County, Minnesota",0,0,0,0,0,0,0,0,0,0,0,0,0,0,0,0,0,0,0,0,0,0,0,0,0
270531074001005,41,Longfellow,61,61,1000000US270531074001005,"Block 1005, Block Group 1, Census Tract 1074, Hennepin County, Minnesota",123,15,95,2,8,0,0,3,123,120,14,95,2,8,0,0,1,3,1,0,0,0,0,0,2
270531076002011,41,Longfellow,61,61,1000000US270531076002011,"Block 2011, Block Group 2, Census Tract 1076, Hennepin County, Minnesota",6,6,0,0,0,0,0,0,6,6,6,0,0,0,0,0,0,0,0,0,0,0,0,0,0
270531088004014,41,Longfellow,61,61,1000000US270531088004014,"Block 4014, Block Group 4, Census Tract 1088, Hennepin County, Minnesota",15,9,4,1,0,0,0,1,15,15,9,4,1,0,0,0,1,0,0,0,0,0,0,0,0
270531074001008,41,Longfellow,61,61,1000000US270531074001008,"Block 1008, Block Group 1, Census Tract 1074, Hennepin County, Minnesota",103,53,0,30,2,0,5,13,103,90,48,0,30,2,0,0,10,13,5,0,0,0,0,5,3
270531074001000,41,Longfellow,61,61,1000000US270531074001000,"Block 1000, Block Group 1, Census Tract 1074, Hennepin County, Minnesota",14,9,3,1,1,0,0,0,14,14,9,3,1,1,0,0,0,0,0,0,0,0,0,0,0
270531074001001,41,Longfellow,61,61,1000000US270531074001001,"Block 1001, Block Group 1, Census Tract 1074, Hennepin County, Minnesota",39,38,0,1,0,0,0,0,39,39,38,0,1,0,0,0,0,0,0,0,0,0,0,0,0
270531074001009,41,Longfellow,61,61,1000000US270531074001009,"Block 1009, Block Group 1, Census Tract 1074, Hennepin County, Minnesota",78,50,12,5,0,0,5,6,78,71,49,12,5,0,0,0,5,7,1,0,0,0,0,5,1
270531088004015,41,Longfellow,61,61,1000000US270531088004015,"Block 4015, Block Group 4, Census Tract 1088, Hennepin County, Minnesota",190,59,69,14,1,0,21,26,190,155,59,69,12,1,0,0,14,35,0,0,2,0,0,21,12
270531074002013,41,Longfellow,61,61,1000000US270531074002013,"Block 2013, Block Group 2, Census Tract 1074, Hennepin County, Minnesota",87,37,19,8,1,0,8,14,87,65,34,19,6,1,0,0,5,22,3,0,2,0,0,8,9
270531088004021,41,Longfellow,61,61,1000000US270531088004021,"Block 4021, Block Group 4, Census Tract 1088, Hennepin County, Minnesota",64,52,8,0,0,0,3,1,64,63,52,8,0,0,0,2,1,1,0,0,0,0,0,1,0
270531088004002,41,Longfellow,61,61,1000000US270531088004002,"Block 4002, Block Group 4, Census Tract 1088, Hennepin County, Minnesota",330,197,84,13,5,0,19,12,330,292,181,83,12,5,0,1,10,38,16,1,1,0,0,18,2
270531074001011,41,Longfellow,61,61,1000000US270531074001011,"Block 1011, Block Group 1, Census Tract 1074, Hennepin County, Minnesota",66,39,5,8,0,0,6,8,66,49,37,4,3,0,0,0,5,17,2,1,5,0,0,6,3
270531074002014,41,Longfellow,61,61,1000000US270531074002014,"Block 2014, Block Group 2, Census Tract 1074, Hennepin County, Minnesota",52,25,6,5,0,0,11,5,52,38,25,6,5,0,0,0,2,14,0,0,0,0,0,11,3
270531074001010,41,Longfellow,61,61,1000000US270531074001010,"Block 1010, Block Group 1, Census Tract 1074, Hennepin County, Minnesota",103,51,21,0,0,0,28,3,103,65,46,16,0,0,0,0,3,38,5,5,0,0,0,28,0
270531088004019,41,Longfellow,61,61,1000000US270531088004019,"Block 4019, Block Group 4, Census Tract 1088, Hennepin County, Minnesota",0,0,0,0,0,0,0,0,0,0,0,0,0,0,0,0,0,0,0,0,0,0,0,0,0
270531088003002,41,Longfellow,61,61,1000000US270531088003002,"Block 3002, Block Group 3, Census Tract 1088, Hennepin County, Minnesota",40,33,1,1,0,0,0,5,40,37,31,1,1,0,0,0,4,3,2,0,0,0,0,0,1
270531088003010,41,Longfellow,61,61,1000000US270531088003010,"Block 3010, Block Group 3, Census Tract 1088, Hennepin County, Minnesota",58,48,0,0,0,0,3,7,58,48,46,0,0,0,0,0,2,10,2,0,0,0,0,3,5
270531074001015,41,Longfellow,61,61,1000000US270531074001015,"Block 1015, Block Group 1, Census Tract 1074, Hennepin County, Minnesota",0,0,0,0,0,0,0,0,0,0,0,0,0,0,0,0,0,0,0,0,0,0,0,0,0
270531074001014,41,Longfellow,61,61,1000000US270531074001014,"Block 1014, Block Group 1, Census Tract 1074, Hennepin County, Minnesota",17,15,1,0,0,0,0,1,17,16,14,1,0,0,0,0,1,1,1,0,0,0,0,0,0
270531088004016,41,Longfellow,61,61,1000000US270531088004016,"Block 4016, Block Group 4, Census Tract 1088, Hennepin County, Minnesota",75,48,21,0,0,0,0,6,75,74,48,21,0,0,0,0,5,1,0,0,0,0,0,0,1
270531074002001,41,Longfellow,61,61,1000000US270531074002001,"Block 2001, Block Group 2, Census Tract 1074, Hennepin County, Minnesota",67,43,17,3,2,0,0,2,67,67,43,17,3,2,0,0,2,0,0,0,0,0,0,0,0
270531074002009,41,Longfellow,61,61,1000000US270531074002009,"Block 2009, Block Group 2, Census Tract 1074, Hennepin County, Minnesota",65,41,5,4,0,0,13,2,65,46,39,5,1,0,0,0,1,19,2,0,3,0,0,13,1
270531088003000,41,Longfellow,61,61,1000000US270531088003000,"Block 3000, Block Group 3, Census Tract 1088, Hennepin County, Minnesota",41,29,6,6,0,0,0,0,41,36,29,6,1,0,0,0,0,5,0,0,5,0,0,0,0
270531088003004,41,Longfellow,61,61,1000000US270531088003004,"Block 3004, Block Group 3, Census Tract 1088, Hennepin County, Minnesota",63,54,2,0,1,0,0,6,63,63,54,2,0,1,0,0,6,0,0,0,0,0,0,0,0
270531088003008,41,Longfellow,61,61,1000000US270531088003008,"Block 3008, Block Group 3, Census Tract 1088, Hennepin County, Minnesota",73,60,5,1,1,0,3,3,73,69,60,5,0,1,0,0,3,4,0,0,1,0,0,3,0
270531088003006,41,Longfellow,61,61,1000000US270531088003006,"Block 3006, Block Group 3, Census Tract 1088, Hennepin County, Minnesota",57,54,1,0,0,1,0,1,57,57,54,1,0,0,1,0,1,0,0,0,0,0,0,0,0
270531074001013,41,Longfellow,61,61,1000000US270531074001013,"Block 1013, Block Group 1, Census Tract 1074, Hennepin County, Minnesota",54,28,8,5,1,0,11,1,54,38,24,7,5,1,0,0,1,16,4,1,0,0,0,11,0
270531088004010,41,Longfellow,61,61,1000000US270531088004010,"Block 4010, Block Group 4, Census Tract 1088, Hennepin County, Minnesota",103,50,26,12,0,0,10,5,103,86,45,26,10,0,0,0,5,17,5,0,2,0,0,10,0
270531088004020,41,Longfellow,61,61,1000000US270531088004020,"Block 4020, Block Group 4, Census Tract 1088, Hennepin County, Minnesota",75,64,0,1,0,0,5,5,75,66,64,0,1,0,0,0,1,9,0,0,0,0,0,5,4
270531088003003,41,Longfellow,61,61,1000000US270531088003003,"Block 3003, Block Group 3, Census Tract 1088, Hennepin County, Minnesota",67,60,2,2,1,0,2,0,67,63,60,2,0,1,0,0,0,4,0,0,2,0,0,2,0
270531089003003,41,Longfellow,61,61,1000000US270531089003003,"Block 3003, Block Group 3, Census Tract 1089, Hennepin County, Minnesota",36,35,1,0,0,0,0,0,36,36,35,1,0,0,0,0,0,0,0,0,0,0,0,0,0
270531088004018,41,Longfellow,61,61,1000000US270531088004018,"Block 4018, Block Group 4, Census Tract 1088, Hennepin County, Minnesota",80,61,10,0,0,0,4,5,80,70,57,10,0,0,0,0,3,10,4,0,0,0,0,4,2
270531088003005,41,Longfellow,61,61,1000000US270531088003005,"Block 3005, Block Group 3, Census Tract 1088, Hennepin County, Minnesota",67,38,22,1,1,1,0,4,67,66,38,22,0,1,1,0,4,1,0,0,1,0,0,0,0
270531088003011,41,Longfellow,61,61,1000000US270531088003011,"Block 3011, Block Group 3, Census Tract 1088, Hennepin County, Minnesota",73,58,3,8,0,0,3,1,73,64,52,3,8,0,0,0,1,9,6,0,0,0,0,3,0
270531088004000,41,Longfellow,61,61,1000000US270531088004000,"Block 4000, Block Group 4, Census Tract 1088, Hennepin County, Minnesota",130,56,21,11,8,0,22,12,130,85,36,21,10,8,0,0,10,45,20,0,1,0,0,22,2
270531074002010,41,Longfellow,61,61,1000000US270531074002010,"Block 2010, Block Group 2, Census Tract 1074, Hennepin County, Minnesota",65,42,12,0,0,0,11,0,65,54,42,12,0,0,0,0,0,11,0,0,0,0,0,11,0
270531088003001,41,Longfellow,61,61,1000000US270531088003001,"Block 3001, Block Group 3, Census Tract 1088, Hennepin County, Minnesota",37,25,6,1,0,0,0,5,37,36,25,5,1,0,0,0,5,1,0,1,0,0,0,0,0
270531088003009,41,Longfellow,61,61,1000000US270531088003009,"Block 3009, Block Group 3, Census Tract 1088, Hennepin County, Minnesota",67,64,0,0,0,0,0,3,67,61,59,0,0,0,0,0,2,6,5,0,0,0,0,0,1
270531089003012,41,Longfellow,61,61,1000000US270531089003012,"Block 3012, Block Group 3, Census Tract 1089, Hennepin County, Minnesota",55,43,5,3,1,0,2,1,55,52,43,5,2,1,0,0,1,3,0,0,1,0,0,2,0
270531075002010,41,Longfellow,61,61,1000000US270531075002010,"Block 2010, Block Group 2, Census Tract 1075, Hennepin County, Minnesota",0,0,0,0,0,0,0,0,0,0,0,0,0,0,0,0,0,0,0,0,0,0,0,0,0
270531089003013,41,Longfellow,61,61,1000000US270531089003013,"Block 3013, Block Group 3, Census Tract 1089, Hennepin County, Minnesota",68,53,9,1,1,0,0,4,68,68,53,9,1,1,0,0,4,0,0,0,0,0,0,0,0
270531074002006,41,Longfellow,61,61,1000000US270531074002006,"Block 2006, Block Group 2, Census Tract 1074, Hennepin County, Minnesota",65,50,7,0,2,0,3,3,65,61,50,7,0,2,0,0,2,4,0,0,0,0,0,3,1
270531089003007,41,Longfellow,61,61,1000000US270531089003007,"Block 3007, Block Group 3, Census Tract 1089, Hennepin County, Minnesota",48,39,0,0,4,0,0,5,48,47,38,0,0,4,0,0,5,1,1,0,0,0,0,0,0
270531089003009,41,Longfellow,61,61,1000000US270531089003009,"Block 3009, Block Group 3, Census Tract 1089, Hennepin County, Minnesota",77,44,4,5,3,0,18,3,77,59,44,4,5,3,0,1,2,18,0,0,0,0,0,17,1
270531075002011,41,Longfellow,61,61,1000000US270531075002011,"Block 2011, Block Group 2, Census Tract 1075, Hennepin County, Minnesota",0,0,0,0,0,0,0,0,0,0,0,0,0,0,0,0,0,0,0,0,0,0,0,0,0
270531074001004,41,Longfellow,61,61,1000000US270531074001004,"Block 1004, Block Group 1, Census Tract 1074, Hennepin County, Minnesota",0,0,0,0,0,0,0,0,0,0,0,0,0,0,0,0,0,0,0,0,0,0,0,0,0
270531074001007,41,Longfellow,61,61,1000000US270531074001007,"Block 1007, Block Group 1, Census Tract 1074, Hennepin County, Minnesota",97,54,14,0,8,0,13,8,97,80,52,13,0,8,0,0,7,17,2,1,0,0,0,13,1
270531088004017,41,Longfellow,61,61,1000000US270531088004017,"Block 4017, Block Group 4, Census Tract 1088, Hennepin County, Minnesota",72,58,6,7,0,0,1,0,72,67,54,6,7,0,0,0,0,5,4,0,0,0,0,1,0
270531074002011,41,Longfellow,61,61,1000000US270531074002011,"Block 2011, Block Group 2, Census Tract 1074, Hennepin County, Minnesota",67,42,9,5,0,0,6,5,67,58,41,9,4,0,0,0,4,9,1,0,1,0,0,6,1
270531074002002,41,Longfellow,61,61,1000000US270531074002002,"Block 2002, Block Group 2, Census Tract 1074, Hennepin County, Minnesota",58,42,4,0,1,0,3,8,58,46,40,4,0,1,0,0,1,12,2,0,0,0,0,3,7
270531089003011,41,Longfellow,61,61,1000000US270531089003011,"Block 3011, Block Group 3, Census Tract 1089, Hennepin County, Minnesota",79,55,4,0,0,0,18,2,79,51,48,2,0,0,0,0,1,28,7,2,0,0,0,18,1
270531088004007,41,Longfellow,61,61,1000000US270531088004007,"Block 4007, Block Group 4, Census Tract 1088, Hennepin County, Minnesota",4,2,0,0,1,0,0,1,4,4,2,0,0,1,0,0,1,0,0,0,0,0,0,0,0
270531074002008,41,Longfellow,61,61,1000000US270531074002008,"Block 2008, Block Group 2, Census Tract 1074, Hennepin County, Minnesota",45,36,3,0,2,0,3,1,45,38,33,2,0,2,0,0,1,7,3,1,0,0,0,3,0
270531074002004,41,Longfellow,61,61,1000000US270531074002004,"Block 2004, Block Group 2, Census Tract 1074, Hennepin County, Minnesota",55,46,7,0,2,0,0,0,55,54,45,7,0,2,0,0,0,1,1,0,0,0,0,0,0
270531074002007,41,Longfellow,61,61,1000000US270531074002007,"Block 2007, Block Group 2, Census Tract 1074, Hennepin County, Minnesota",59,31,9,1,0,0,15,3,59,42,30,9,1,0,0,0,2,17,1,0,0,0,0,15,1
270531089003014,41,Longfellow,61,61,1000000US270531089003014,"Block 3014, Block Group 3, Census Tract 1089, Hennepin County, Minnesota",72,63,2,1,2,0,0,4,72,70,61,2,1,2,0,0,4,2,2,0,0,0,0,0,0
270531089003008,41,Longfellow,61,61,1000000US270531089003008,"Block 3008, Block Group 3, Census Tract 1089, Hennepin County, Minnesota",57,51,1,0,3,0,1,1,57,53,48,1,0,3,0,0,1,4,3,0,0,0,0,1,0
270531088004008,41,Longfellow,61,61,1000000US270531088004008,"Block 4008, Block Group 4, Census Tract 1088, Hennepin County, Minnesota",0,0,0,0,0,0,0,0,0,0,0,0,0,0,0,0,0,0,0,0,0,0,0,0,0
270531074001002,41,Longfellow,61,61,1000000US270531074001002,"Block 1002, Block Group 1, Census Tract 1074, Hennepin County, Minnesota",0,0,0,0,0,0,0,0,0,0,0,0,0,0,0,0,0,0,0,0,0,0,0,0,0
270531074002000,41,Longfellow,61,61,1000000US270531074002000,"Block 2000, Block Group 2, Census Tract 1074, Hennepin County, Minnesota",0,0,0,0,0,0,0,0,0,0,0,0,0,0,0,0,0,0,0,0,0,0,0,0,0
270531088004003,41,Longfellow,61,61,1000000US270531088004003,"Block 4003, Block Group 4, Census Tract 1088, Hennepin County, Minnesota",3,1,0,0,2,0,0,0,3,3,1,0,0,2,0,0,0,0,0,0,0,0,0,0,0
270531088004012,41,Longfellow,61,61,1000000US270531088004012,"Block 4012, Block Group 4, Census Tract 1088, Hennepin County, Minnesota",13,12,0,0,1,0,0,0,13,13,12,0,0,1,0,0,0,0,0,0,0,0,0,0,0
270531074001012,41,Longfellow,61,61,1000000US270531074001012,"Block 1012, Block Group 1, Census Tract 1074, Hennepin County, Minnesota",125,57,27,12,4,0,11,14,125,93,42,27,12,4,0,0,8,32,15,0,0,0,0,11,6
270531088004011,41,Longfellow,61,61,1000000US270531088004011,"Block 4011, Block Group 4, Census Tract 1088, Hennepin County, Minnesota",94,70,3,0,1,0,2,18,94,83,64,3,0,1,0,0,15,11,6,0,0,0,0,2,3
270531088004001,41,Longfellow,61,61,1000000US270531088004001,"Block 4001, Block Group 4, Census Tract 1088, Hennepin County, Minnesota",58,22,15,2,0,0,14,5,58,43,22,15,2,0,0,0,4,15,0,0,0,0,0,14,1
270531074002012,41,Longfellow,61,61,1000000US270531074002012,"Block 2012, Block Group 2, Census Tract 1074, Hennepin County, Minnesota",42,39,3,0,0,0,0,0,42,41,38,3,0,0,0,0,0,1,1,0,0,0,0,0,0
270531089003004,41,Longfellow,61,61,1000000US270531089003004,"Block 3004, Block Group 3, Census Tract 1089, Hennepin County, Minnesota",66,58,3,1,2,0,2,0,66,64,58,3,1,2,0,0,0,2,0,0,0,0,0,2,0
270531088003007,41,Longfellow,61,61,1000000US270531088003007,"Block 3007, Block Group 3, Census Tract 1088, Hennepin County, Minnesota",62,56,0,3,0,0,1,2,62,57,54,0,3,0,0,0,0,5,2,0,0,0,0,1,2
270531075002013,41,Longfellow,61,61,1000000US270531075002013,"Block 2013, Block Group 2, Census Tract 1075, Hennepin County, Minnesota",0,0,0,0,0,0,0,0,0,0,0,0,0,0,0,0,0,0,0,0,0,0,0,0,0
270531088004006,41,Longfellow,61,61,1000000US270531088004006,"Block 4006, Block Group 4, Census Tract 1088, Hennepin County, Minnesota",0,0,0,0,0,0,0,0,0,0,0,0,0,0,0,0,0,0,0,0,0,0,0,0,0
270531088004004,41,Longfellow,61,61,1000000US270531088004004,"Block 4004, Block Group 4, Census Tract 1088, Hennepin County, Minnesota",102,20,35,15,0,0,22,10,102,67,14,35,15,0,0,0,3,35,6,0,0,0,0,22,7
270531074001006,41,Longfellow,61,61,1000000US270531074001006,"Block 1006, Block Group 1, Census Tract 1074, Hennepin County, Minnesota",54,41,1,0,3,0,9,0,54,42,39,0,0,3,0,0,0,12,2,1,0,0,0,9,0
270531088004005,41,Longfellow,61,61,1000000US270531088004005,"Block 4005, Block Group 4, Census Tract 1088, Hennepin County, Minnesota",0,0,0,0,0,0,0,0,0,0,0,0,0,0,0,0,0,0,0,0,0,0,0,0,0
270531089003010,41,Longfellow,61,61,1000000US270531089003010,"Block 3010, Block Group 3, Census Tract 1089, Hennepin County, Minnesota",68,61,2,0,1,0,0,4,68,67,61,2,0,1,0,0,3,1,0,0,0,0,0,0,1
270531067004004,42,Lowry Hill East,45,45,1000000US270531067004004,"Block 4004, Block Group 4, Census Tract 1067, Hennepin County, Minnesota",120,106,2,0,7,0,3,2,120,117,106,2,0,7,0,0,2,3,0,0,0,0,0,3,0
270530077002004,42,Lowry Hill East,45,45,1000000US270530077002004,"Block 2004, Block Group 2, Census Tract 77, Hennepin County, Minnesota",129,110,7,1,5,0,0,6,129,128,109,7,1,5,0,0,6,1,1,0,0,0,0,0,0
270531067001005,42,Lowry Hill East,45,45,1000000US270531067001005,"Block 1005, Block Group 1, Census Tract 1067, Hennepin County, Minnesota",148,131,3,0,4,0,1,9,148,142,126,3,0,4,0,0,9,6,5,0,0,0,0,1,0
270531067002008,42,Lowry Hill East,45,45,1000000US270531067002008,"Block 2008, Block Group 2, Census Tract 1067, Hennepin County, Minnesota",120,109,1,1,2,0,5,2,120,114,108,1,1,2,0,0,2,6,1,0,0,0,0,5,0
270531067003007,42,Lowry Hill East,45,45,1000000US270531067003007,"Block 3007, Block Group 3, Census Tract 1067, Hennepin County, Minnesota",68,53,8,1,2,0,2,2,68,65,52,8,1,2,0,0,2,3,1,0,0,0,0,2,0
270530077002009,42,Lowry Hill East,45,45,1000000US270530077002009,"Block 2009, Block Group 2, Census Tract 77, Hennepin County, Minnesota",0,0,0,0,0,0,0,0,0,0,0,0,0,0,0,0,0,0,0,0,0,0,0,0,0
270530077002010,42,Lowry Hill East,45,45,1000000US270530077002010,"Block 2010, Block Group 2, Census Tract 77, Hennepin County, Minnesota",0,0,0,0,0,0,0,0,0,0,0,0,0,0,0,0,0,0,0,0,0,0,0,0,0
270530077002023,42,Lowry Hill East,45,45,1000000US270530077002023,"Block 2023, Block Group 2, Census Tract 77, Hennepin County, Minnesota",0,0,0,0,0,0,0,0,0,0,0,0,0,0,0,0,0,0,0,0,0,0,0,0,0
270530077002007,42,Lowry Hill East,45,45,1000000US270530077002007,"Block 2007, Block Group 2, Census Tract 77, Hennepin County, Minnesota",85,66,7,2,3,0,6,1,85,73,61,7,1,3,0,0,1,12,5,0,1,0,0,6,0
270531067001002,42,Lowry Hill East,45,45,1000000US270531067001002,"Block 1002, Block Group 1, Census Tract 1067, Hennepin County, Minnesota",36,27,0,0,5,0,0,4,36,35,27,0,0,5,0,0,3,1,0,0,0,0,0,0,1
270531067001001,42,Lowry Hill East,45,45,1000000US270531067001001,"Block 1001, Block Group 1, Census Tract 1067, Hennepin County, Minnesota",0,0,0,0,0,0,0,0,0,0,0,0,0,0,0,0,0,0,0,0,0,0,0,0,0
270531067001000,42,Lowry Hill East,45,45,1000000US270531067001000,"Block 1000, Block Group 1, Census Tract 1067, Hennepin County, Minnesota",0,0,0,0,0,0,0,0,0,0,0,0,0,0,0,0,0,0,0,0,0,0,0,0,0
270531067004000,42,Lowry Hill East,45,45,1000000US270531067004000,"Block 4000, Block Group 4, Census Tract 1067, Hennepin County, Minnesota",174,145,15,0,9,0,2,3,174,167,141,13,0,9,0,1,3,7,4,2,0,0,0,1,0
270531067003010,42,Lowry Hill East,45,45,1000000US270531067003010,"Block 3010, Block Group 3, Census Tract 1067, Hennepin County, Minnesota",95,88,1,0,1,0,0,5,95,95,88,1,0,1,0,0,5,0,0,0,0,0,0,0,0
270530077002003,42,Lowry Hill East,45,45,1000000US270530077002003,"Block 2003, Block Group 2, Census Tract 77, Hennepin County, Minnesota",47,46,0,0,1,0,0,0,47,46,45,0,0,1,0,0,0,1,1,0,0,0,0,0,0
270531067003008,42,Lowry Hill East,45,45,1000000US270531067003008,"Block 3008, Block Group 3, Census Tract 1067, Hennepin County, Minnesota",79,62,7,2,4,0,0,4,79,74,59,6,2,4,0,0,3,5,3,1,0,0,0,0,1
270530077002000,42,Lowry Hill East,45,45,1000000US270530077002000,"Block 2000, Block Group 2, Census Tract 77, Hennepin County, Minnesota",16,13,2,0,1,0,0,0,16,16,13,2,0,1,0,0,0,0,0,0,0,0,0,0,0
270530077002006,42,Lowry Hill East,45,45,1000000US270530077002006,"Block 2006, Block Group 2, Census Tract 77, Hennepin County, Minnesota",40,28,2,0,8,0,0,2,40,35,23,2,0,8,0,0,2,5,5,0,0,0,0,0,0
270531067001003,42,Lowry Hill East,45,45,1000000US270531067001003,"Block 1003, Block Group 1, Census Tract 1067, Hennepin County, Minnesota",107,99,1,0,5,0,0,2,107,105,97,1,0,5,0,0,2,2,2,0,0,0,0,0,0
270531067002010,42,Lowry Hill East,45,45,1000000US270531067002010,"Block 2010, Block Group 2, Census Tract 1067, Hennepin County, Minnesota",2,2,0,0,0,0,0,0,2,2,2,0,0,0,0,0,0,0,0,0,0,0,0,0,0
270531067004002,42,Lowry Hill East,45,45,1000000US270531067004002,"Block 4002, Block Group 4, Census Tract 1067, Hennepin County, Minnesota",152,127,7,1,3,0,7,7,152,141,124,6,1,3,0,0,7,11,3,1,0,0,0,7,0
270531067004006,42,Lowry Hill East,45,45,1000000US270531067004006,"Block 4006, Block Group 4, Census Tract 1067, Hennepin County, Minnesota",165,146,8,1,6,0,0,4,165,158,144,5,0,6,0,0,3,7,2,3,1,0,0,0,1
270531067002007,42,Lowry Hill East,45,45,1000000US270531067002007,"Block 2007, Block Group 2, Census Tract 1067, Hennepin County, Minnesota",115,92,6,1,4,0,2,10,115,103,88,6,1,4,0,0,4,12,4,0,0,0,0,2,6
270531067004003,42,Lowry Hill East,45,45,1000000US270531067004003,"Block 4003, Block Group 4, Census Tract 1067, Hennepin County, Minnesota",127,119,1,0,5,0,0,2,127,124,116,1,0,5,0,0,2,3,3,0,0,0,0,0,0
270531067003002,42,Lowry Hill East,45,45,1000000US270531067003002,"Block 3002, Block Group 3, Census Tract 1067, Hennepin County, Minnesota",59,55,2,0,1,0,1,0,59,58,55,2,0,1,0,0,0,1,0,0,0,0,0,1,0
270531067003005,42,Lowry Hill East,45,45,1000000US270531067003005,"Block 3005, Block Group 3, Census Tract 1067, Hennepin County, Minnesota",188,148,23,0,7,0,0,10,188,185,146,23,0,7,0,0,9,3,2,0,0,0,0,0,1
270531067001008,42,Lowry Hill East,45,45,1000000US270531067001008,"Block 1008, Block Group 1, Census Tract 1067, Hennepin County, Minnesota",54,44,6,0,1,0,0,3,54,52,43,6,0,1,0,0,2,2,1,0,0,0,0,0,1
270531067001007,42,Lowry Hill East,45,45,1000000US270531067001007,"Block 1007, Block Group 1, Census Tract 1067, Hennepin County, Minnesota",79,77,0,0,0,0,0,2,79,77,75,0,0,0,0,0,2,2,2,0,0,0,0,0,0
270530077002002,42,Lowry Hill East,45,45,1000000US270530077002002,"Block 2002, Block Group 2, Census Tract 77, Hennepin County, Minnesota",144,127,3,0,5,0,2,7,144,139,125,3,0,5,0,0,6,5,2,0,0,0,0,2,1
270531067003009,42,Lowry Hill East,45,45,1000000US270531067003009,"Block 3009, Block Group 3, Census Tract 1067, Hennepin County, Minnesota",100,86,1,0,1,1,3,8,100,97,83,1,0,1,1,3,8,3,3,0,0,0,0,0,0
270530077002021,42,Lowry Hill East,45,45,1000000US270530077002021,"Block 2021, Block Group 2, Census Tract 77, Hennepin County, Minnesota",155,135,2,2,13,0,0,3,155,150,130,2,2,13,0,0,3,5,5,0,0,0,0,0,0
270530077002011,42,Lowry Hill East,45,45,1000000US270530077002011,"Block 2011, Block Group 2, Census Tract 77, Hennepin County, Minnesota",0,0,0,0,0,0,0,0,0,0,0,0,0,0,0,0,0,0,0,0,0,0,0,0,0
270531067002003,42,Lowry Hill East,45,45,1000000US270531067002003,"Block 2003, Block Group 2, Census Tract 1067, Hennepin County, Minnesota",96,77,10,4,3,0,1,1,96,92,75,9,4,3,0,0,1,4,2,1,0,0,0,1,0
270531067002004,42,Lowry Hill East,45,45,1000000US270531067002004,"Block 2004, Block Group 2, Census Tract 1067, Hennepin County, Minnesota",12,9,0,0,0,0,0,3,12,12,9,0,0,0,0,0,3,0,0,0,0,0,0,0,0
270531067002005,42,Lowry Hill East,45,45,1000000US270531067002005,"Block 2005, Block Group 2, Census Tract 1067, Hennepin County, Minnesota",213,183,19,2,1,0,0,8,213,206,180,19,2,1,0,0,4,7,3,0,0,0,0,0,4
270531067002006,42,Lowry Hill East,45,45,1000000US270531067002006,"Block 2006, Block Group 2, Census Tract 1067, Hennepin County, Minnesota",135,111,2,0,11,0,0,11,135,133,109,2,0,11,0,0,11,2,2,0,0,0,0,0,0
270531067004001,42,Lowry Hill East,45,45,1000000US270531067004001,"Block 4001, Block Group 4, Census Tract 1067, Hennepin County, Minnesota",98,80,6,0,2,0,5,5,98,93,78,5,0,2,0,4,4,5,2,1,0,0,0,1,1
270531067004009,42,Lowry Hill East,45,45,1000000US270531067004009,"Block 4009, Block Group 4, Census Tract 1067, Hennepin County, Minnesota",120,108,3,2,4,0,1,2,120,116,106,3,2,4,0,0,1,4,2,0,0,0,0,1,1
270531067004008,42,Lowry Hill East,45,45,1000000US270531067004008,"Block 4008, Block Group 4, Census Tract 1067, Hennepin County, Minnesota",24,23,0,0,1,0,0,0,24,24,23,0,0,1,0,0,0,0,0,0,0,0,0,0,0
270531067004005,42,Lowry Hill East,45,45,1000000US270531067004005,"Block 4005, Block Group 4, Census Tract 1067, Hennepin County, Minnesota",132,112,2,2,5,3,1,7,132,129,111,2,1,5,3,0,7,3,1,0,1,0,0,1,0
270531067001004,42,Lowry Hill East,45,45,1000000US270531067001004,"Block 1004, Block Group 1, Census Tract 1067, Hennepin County, Minnesota",47,39,2,0,1,0,0,5,47,47,39,2,0,1,0,0,5,0,0,0,0,0,0,0,0
270531067002000,42,Lowry Hill East,45,45,1000000US270531067002000,"Block 2000, Block Group 2, Census Tract 1067, Hennepin County, Minnesota",151,133,6,0,4,0,3,5,151,144,129,6,0,4,0,0,5,7,4,0,0,0,0,3,0
270531067003000,42,Lowry Hill East,45,45,1000000US270531067003000,"Block 3000, Block Group 3, Census Tract 1067, Hennepin County, Minnesota",111,98,3,0,6,0,1,3,111,108,97,3,0,6,0,0,2,3,1,0,0,0,0,1,1
270530077002020,42,Lowry Hill East,45,45,1000000US270530077002020,"Block 2020, Block Group 2, Census Tract 77, Hennepin County, Minnesota",0,0,0,0,0,0,0,0,0,0,0,0,0,0,0,0,0,0,0,0,0,0,0,0,0
270530077002018,42,Lowry Hill East,45,45,1000000US270530077002018,"Block 2018, Block Group 2, Census Tract 77, Hennepin County, Minnesota",0,0,0,0,0,0,0,0,0,0,0,0,0,0,0,0,0,0,0,0,0,0,0,0,0
270530077002017,42,Lowry Hill East,45,45,1000000US270530077002017,"Block 2017, Block Group 2, Census Tract 77, Hennepin County, Minnesota",104,91,3,2,5,0,1,2,104,97,88,3,1,4,0,0,1,7,3,0,1,1,0,1,1
270531067004007,42,Lowry Hill East,45,45,1000000US270531067004007,"Block 4007, Block Group 4, Census Tract 1067, Hennepin County, Minnesota",259,227,5,0,5,0,7,15,259,243,222,4,0,5,0,0,12,16,5,1,0,0,0,7,3
270530077002005,42,Lowry Hill East,45,45,1000000US270530077002005,"Block 2005, Block Group 2, Census Tract 77, Hennepin County, Minnesota",88,67,1,0,17,0,1,2,88,84,64,1,0,17,0,0,2,4,3,0,0,0,0,1,0
270531067002009,42,Lowry Hill East,45,45,1000000US270531067002009,"Block 2009, Block Group 2, Census Tract 1067, Hennepin County, Minnesota",169,158,2,2,2,0,1,4,169,159,151,2,1,2,0,0,3,10,7,0,1,0,0,1,1
270530077002012,42,Lowry Hill East,45,45,1000000US270530077002012,"Block 2012, Block Group 2, Census Tract 77, Hennepin County, Minnesota",0,0,0,0,0,0,0,0,0,0,0,0,0,0,0,0,0,0,0,0,0,0,0,0,0
270530077002016,42,Lowry Hill East,45,45,1000000US270530077002016,"Block 2016, Block Group 2, Census Tract 77, Hennepin County, Minnesota",281,240,17,1,12,2,3,6,281,269,233,17,1,12,2,0,4,12,7,0,0,0,0,3,2
270530077002008,42,Lowry Hill East,45,45,1000000US270530077002008,"Block 2008, Block Group 2, Census Tract 77, Hennepin County, Minnesota",0,0,0,0,0,0,0,0,0,0,0,0,0,0,0,0,0,0,0,0,0,0,0,0,0
270531067003004,42,Lowry Hill East,45,45,1000000US270531067003004,"Block 3004, Block Group 3, Census Tract 1067, Hennepin County, Minnesota",131,120,6,1,0,0,0,4,131,128,118,6,1,0,0,0,3,3,2,0,0,0,0,0,1
270531067003011,42,Lowry Hill East,45,45,1000000US270531067003011,"Block 3011, Block Group 3, Census Tract 1067, Hennepin County, Minnesota",143,126,3,2,6,0,1,5,143,135,122,2,1,6,0,0,4,8,4,1,1,0,0,1,1
270531067002001,42,Lowry Hill East,45,45,1000000US270531067002001,"Block 2001, Block Group 2, Census Tract 1067, Hennepin County, Minnesota",196,166,8,0,9,0,4,9,196,188,161,8,0,9,0,1,9,8,5,0,0,0,0,3,0
270531067003001,42,Lowry Hill East,45,45,1000000US270531067003001,"Block 3001, Block Group 3, Census Tract 1067, Hennepin County, Minnesota",171,153,4,0,7,0,3,4,171,162,151,4,0,6,0,0,1,9,2,0,0,1,0,3,3
270530077002022,42,Lowry Hill East,45,45,1000000US270530077002022,"Block 2022, Block Group 2, Census Tract 77, Hennepin County, Minnesota",0,0,0,0,0,0,0,0,0,0,0,0,0,0,0,0,0,0,0,0,0,0,0,0,0
270530077002015,42,Lowry Hill East,45,45,1000000US270530077002015,"Block 2015, Block Group 2, Census Tract 77, Hennepin County, Minnesota",95,83,1,1,5,0,1,4,95,91,80,1,1,5,0,0,4,4,3,0,0,0,0,1,0
270530077002019,42,Lowry Hill East,45,45,1000000US270530077002019,"Block 2019, Block Group 2, Census Tract 77, Hennepin County, Minnesota",0,0,0,0,0,0,0,0,0,0,0,0,0,0,0,0,0,0,0,0,0,0,0,0,0
270531067002002,42,Lowry Hill East,45,45,1000000US270531067002002,"Block 2002, Block Group 2, Census Tract 1067, Hennepin County, Minnesota",210,176,13,1,10,0,6,4,210,203,176,13,1,10,0,0,3,7,0,0,0,0,0,6,1
270531067001006,42,Lowry Hill East,45,45,1000000US270531067001006,"Block 1006, Block Group 1, Census Tract 1067, Hennepin County, Minnesota",263,200,33,3,15,0,5,7,263,253,195,32,3,15,0,2,6,10,5,1,0,0,0,3,1
270531067003006,42,Lowry Hill East,45,45,1000000US270531067003006,"Block 3006, Block Group 3, Census Tract 1067, Hennepin County, Minnesota",112,92,8,5,5,0,0,2,112,112,92,8,5,5,0,0,2,0,0,0,0,0,0,0,0
270530077002001,42,Lowry Hill East,45,45,1000000US270530077002001,"Block 2001, Block Group 2, Census Tract 77, Hennepin County, Minnesota",53,42,4,0,6,0,0,1,53,50,39,4,0,6,0,0,1,3,3,0,0,0,0,0,0
270530077002013,42,Lowry Hill East,45,45,1000000US270530077002013,"Block 2013, Block Group 2, Census Tract 77, Hennepin County, Minnesota",0,0,0,0,0,0,0,0,0,0,0,0,0,0,0,0,0,0,0,0,0,0,0,0,0
270530077002014,42,Lowry Hill East,45,45,1000000US270530077002014,"Block 2014, Block Group 2, Census Tract 77, Hennepin County, Minnesota",0,0,0,0,0,0,0,0,0,0,0,0,0,0,0,0,0,0,0,0,0,0,0,0,0
270531067003003,42,Lowry Hill East,45,45,1000000US270531067003003,"Block 3003, Block Group 3, Census Tract 1067, Hennepin County, Minnesota",132,108,6,3,7,0,2,6,132,124,102,6,3,7,0,0,6,8,6,0,0,0,0,2,0
270531080002002,43,ECCO,46,46,1000000US270531080002002,"Block 2002, Block Group 2, Census Tract 1080, Hennepin County, Minnesota",75,70,0,0,3,0,2,0,75,71,68,0,0,3,0,0,0,4,2,0,0,0,0,2,0
270531080003000,43,ECCO,46,46,1000000US270531080003000,"Block 3000, Block Group 3, Census Tract 1080, Hennepin County, Minnesota",84,75,3,0,2,0,1,3,84,82,74,3,0,2,0,0,3,2,1,0,0,0,0,1,0
270531080004000,43,ECCO,46,46,1000000US270531080004000,"Block 4000, Block Group 4, Census Tract 1080, Hennepin County, Minnesota",84,77,1,3,2,0,0,1,84,84,77,1,3,2,0,0,1,0,0,0,0,0,0,0,0
270531080004006,43,ECCO,46,46,1000000US270531080004006,"Block 4006, Block Group 4, Census Tract 1080, Hennepin County, Minnesota",164,146,2,0,7,0,0,9,164,160,143,2,0,7,0,0,8,4,3,0,0,0,0,0,1
270531091001000,43,ECCO,46,46,1000000US270531091001000,"Block 1000, Block Group 1, Census Tract 1091, Hennepin County, Minnesota",0,0,0,0,0,0,0,0,0,0,0,0,0,0,0,0,0,0,0,0,0,0,0,0,0
270531080003002,43,ECCO,46,46,1000000US270531080003002,"Block 3002, Block Group 3, Census Tract 1080, Hennepin County, Minnesota",80,79,0,0,1,0,0,0,80,76,75,0,0,1,0,0,0,4,4,0,0,0,0,0,0
270531080002003,43,ECCO,46,46,1000000US270531080002003,"Block 2003, Block Group 2, Census Tract 1080, Hennepin County, Minnesota",122,112,5,0,3,0,0,2,122,120,111,5,0,3,0,0,1,2,1,0,0,0,0,0,1
270531080004002,43,ECCO,46,46,1000000US270531080004002,"Block 4002, Block Group 4, Census Tract 1080, Hennepin County, Minnesota",74,62,5,1,2,0,0,4,74,73,61,5,1,2,0,0,4,1,1,0,0,0,0,0,0
270531080004005,43,ECCO,46,46,1000000US270531080004005,"Block 4005, Block Group 4, Census Tract 1080, Hennepin County, Minnesota",68,60,5,0,1,0,0,2,68,68,60,5,0,1,0,0,2,0,0,0,0,0,0,0,0
270531080002007,43,ECCO,46,46,1000000US270531080002007,"Block 2007, Block Group 2, Census Tract 1080, Hennepin County, Minnesota",88,78,1,2,5,0,0,2,88,85,77,1,2,5,0,0,0,3,1,0,0,0,0,0,2
270531080002008,43,ECCO,46,46,1000000US270531080002008,"Block 2008, Block Group 2, Census Tract 1080, Hennepin County, Minnesota",77,68,0,0,7,0,0,2,77,77,68,0,0,7,0,0,2,0,0,0,0,0,0,0,0
270531080003005,43,ECCO,46,46,1000000US270531080003005,"Block 3005, Block Group 3, Census Tract 1080, Hennepin County, Minnesota",103,99,0,0,3,0,0,1,103,102,98,0,0,3,0,0,1,1,1,0,0,0,0,0,0
270531080002006,43,ECCO,46,46,1000000US270531080002006,"Block 2006, Block Group 2, Census Tract 1080, Hennepin County, Minnesota",134,123,0,0,4,0,5,2,134,126,121,0,0,4,0,0,1,8,2,0,0,0,0,5,1
270531080002001,43,ECCO,46,46,1000000US270531080002001,"Block 2001, Block Group 2, Census Tract 1080, Hennepin County, Minnesota",26,22,1,0,1,0,0,2,26,25,21,1,0,1,0,0,2,1,1,0,0,0,0,0,0
270531080002000,43,ECCO,46,46,1000000US270531080002000,"Block 2000, Block Group 2, Census Tract 1080, Hennepin County, Minnesota",115,104,4,0,3,0,2,2,115,105,98,4,0,3,0,0,0,10,6,0,0,0,0,2,2
270531080002010,43,ECCO,46,46,1000000US270531080002010,"Block 2010, Block Group 2, Census Tract 1080, Hennepin County, Minnesota",180,149,10,0,12,0,1,8,180,176,147,10,0,12,0,0,7,4,2,0,0,0,0,1,1
270531080003007,43,ECCO,46,46,1000000US270531080003007,"Block 3007, Block Group 3, Census Tract 1080, Hennepin County, Minnesota",87,72,1,0,3,0,5,6,87,75,69,0,0,3,0,0,3,12,3,1,0,0,0,5,3
270531080002005,43,ECCO,46,46,1000000US270531080002005,"Block 2005, Block Group 2, Census Tract 1080, Hennepin County, Minnesota",103,98,2,0,2,0,0,1,103,103,98,2,0,2,0,0,1,0,0,0,0,0,0,0,0
270531080002009,43,ECCO,46,46,1000000US270531080002009,"Block 2009, Block Group 2, Census Tract 1080, Hennepin County, Minnesota",77,71,0,1,3,0,2,0,77,75,70,0,1,3,0,1,0,2,1,0,0,0,0,1,0
270531080003004,43,ECCO,46,46,1000000US270531080003004,"Block 3004, Block Group 3, Census Tract 1080, Hennepin County, Minnesota",69,66,1,0,1,0,0,1,69,69,66,1,0,1,0,0,1,0,0,0,0,0,0,0,0
270531080004003,43,ECCO,46,46,1000000US270531080004003,"Block 4003, Block Group 4, Census Tract 1080, Hennepin County, Minnesota",46,46,0,0,0,0,0,0,46,46,46,0,0,0,0,0,0,0,0,0,0,0,0,0,0
270531080004004,43,ECCO,46,46,1000000US270531080004004,"Block 4004, Block Group 4, Census Tract 1080, Hennepin County, Minnesota",83,77,4,1,1,0,0,0,83,83,77,4,1,1,0,0,0,0,0,0,0,0,0,0,0
270531080004007,43,ECCO,46,46,1000000US270531080004007,"Block 4007, Block Group 4, Census Tract 1080, Hennepin County, Minnesota",17,13,1,0,3,0,0,0,17,16,13,0,0,3,0,0,0,1,0,1,0,0,0,0,0
270531080002004,43,ECCO,46,46,1000000US270531080002004,"Block 2004, Block Group 2, Census Tract 1080, Hennepin County, Minnesota",152,148,1,0,3,0,0,0,152,150,146,1,0,3,0,0,0,2,2,0,0,0,0,0,0
270531080003006,43,ECCO,46,46,1000000US270531080003006,"Block 3006, Block Group 3, Census Tract 1080, Hennepin County, Minnesota",106,102,0,0,1,0,0,3,106,100,97,0,0,1,0,0,2,6,5,0,0,0,0,0,1
270531091001003,43,ECCO,46,46,1000000US270531091001003,"Block 1003, Block Group 1, Census Tract 1091, Hennepin County, Minnesota",0,0,0,0,0,0,0,0,0,0,0,0,0,0,0,0,0,0,0,0,0,0,0,0,0
270531080003003,43,ECCO,46,46,1000000US270531080003003,"Block 3003, Block Group 3, Census Tract 1080, Hennepin County, Minnesota",78,75,2,0,0,0,0,1,78,78,75,2,0,0,0,0,1,0,0,0,0,0,0,0,0
270531080003001,43,ECCO,46,46,1000000US270531080003001,"Block 3001, Block Group 3, Census Tract 1080, Hennepin County, Minnesota",85,66,1,0,18,0,0,0,85,85,66,1,0,18,0,0,0,0,0,0,0,0,0,0,0
270531080004001,43,ECCO,46,46,1000000US270531080004001,"Block 4001, Block Group 4, Census Tract 1080, Hennepin County, Minnesota",80,70,7,0,1,0,0,2,80,75,68,6,0,1,0,0,0,5,2,1,0,0,0,0,2
270530081004006,44,South Uptown,47,47,1000000US270530081004006,"Block 4006, Block Group 4, Census Tract 81, Hennepin County, Minnesota",116,109,2,0,2,0,0,3,116,115,108,2,0,2,0,0,3,1,1,0,0,0,0,0,0
270531092001002,44,South Uptown,47,47,1000000US270531092001002,"Block 1002, Block Group 1, Census Tract 1092, Hennepin County, Minnesota",90,87,0,0,1,0,1,1,90,84,82,0,0,1,0,0,1,6,5,0,0,0,0,1,0
270530081003004,44,South Uptown,47,47,1000000US270530081003004,"Block 3004, Block Group 3, Census Tract 81, Hennepin County, Minnesota",88,80,0,0,3,0,0,5,88,87,79,0,0,3,0,0,5,1,1,0,0,0,0,0,0
270531092001001,44,South Uptown,47,47,1000000US270531092001001,"Block 1001, Block Group 1, Census Tract 1092, Hennepin County, Minnesota",156,140,0,1,3,0,2,10,156,149,137,0,1,3,0,0,8,7,3,0,0,0,0,2,2
270530081003002,44,South Uptown,47,47,1000000US270530081003002,"Block 3002, Block Group 3, Census Tract 81, Hennepin County, Minnesota",81,75,4,0,2,0,0,0,81,81,75,4,0,2,0,0,0,0,0,0,0,0,0,0,0
270530081002007,44,South Uptown,47,47,1000000US270530081002007,"Block 2007, Block Group 2, Census Tract 81, Hennepin County, Minnesota",136,123,3,0,7,0,0,3,136,136,123,3,0,7,0,0,3,0,0,0,0,0,0,0,0
270530081003005,44,South Uptown,47,47,1000000US270530081003005,"Block 3005, Block Group 3, Census Tract 81, Hennepin County, Minnesota",91,77,5,0,8,0,1,0,91,89,76,5,0,8,0,0,0,2,1,0,0,0,0,1,0
270530081001005,44,South Uptown,47,47,1000000US270530081001005,"Block 1005, Block Group 1, Census Tract 81, Hennepin County, Minnesota",117,103,3,8,0,0,1,2,117,111,99,3,7,0,0,0,2,6,4,0,1,0,0,1,0
270531092003005,44,South Uptown,47,47,1000000US270531092003005,"Block 3005, Block Group 3, Census Tract 1092, Hennepin County, Minnesota",187,136,23,4,2,0,7,15,187,158,122,23,2,2,0,1,8,29,14,0,2,0,0,6,7
270530081001007,44,South Uptown,47,47,1000000US270530081001007,"Block 1007, Block Group 1, Census Tract 81, Hennepin County, Minnesota",84,74,3,0,1,0,0,6,84,75,67,2,0,1,0,0,5,9,7,1,0,0,0,0,1
270531092003007,44,South Uptown,47,47,1000000US270531092003007,"Block 3007, Block Group 3, Census Tract 1092, Hennepin County, Minnesota",62,60,0,1,1,0,0,0,62,61,59,0,1,1,0,0,0,1,1,0,0,0,0,0,0
270531092001003,44,South Uptown,47,47,1000000US270531092001003,"Block 1003, Block Group 1, Census Tract 1092, Hennepin County, Minnesota",136,121,1,4,6,0,0,4,136,131,116,1,4,6,0,0,4,5,5,0,0,0,0,0,0
270530081004000,44,South Uptown,47,47,1000000US270530081004000,"Block 4000, Block Group 4, Census Tract 81, Hennepin County, Minnesota",21,16,0,0,3,0,1,1,21,19,16,0,0,3,0,0,0,2,0,0,0,0,0,1,1
270530081004004,44,South Uptown,47,47,1000000US270530081004004,"Block 4004, Block Group 4, Census Tract 81, Hennepin County, Minnesota",192,180,4,0,4,0,1,3,192,187,176,4,0,4,0,1,2,5,4,0,0,0,0,0,1
270530081004001,44,South Uptown,47,47,1000000US270530081004001,"Block 4001, Block Group 4, Census Tract 81, Hennepin County, Minnesota",146,125,3,0,16,0,0,2,146,140,120,3,0,15,0,0,2,6,5,0,0,1,0,0,0
270530081003006,44,South Uptown,47,47,1000000US270530081003006,"Block 3006, Block Group 3, Census Tract 81, Hennepin County, Minnesota",116,98,2,2,9,0,0,5,116,116,98,2,2,9,0,0,5,0,0,0,0,0,0,0,0
270531092001000,44,South Uptown,47,47,1000000US270531092001000,"Block 1000, Block Group 1, Census Tract 1092, Hennepin County, Minnesota",132,115,9,1,3,0,2,2,132,126,111,9,1,3,0,0,2,6,4,0,0,0,0,2,0
270530081002004,44,South Uptown,47,47,1000000US270530081002004,"Block 2004, Block Group 2, Census Tract 81, Hennepin County, Minnesota",159,149,2,0,3,0,0,5,159,156,146,2,0,3,0,0,5,3,3,0,0,0,0,0,0
270531092003003,44,South Uptown,47,47,1000000US270531092003003,"Block 3003, Block Group 3, Census Tract 1092, Hennepin County, Minnesota",188,151,22,0,7,0,4,4,188,183,149,22,0,7,0,1,4,5,2,0,0,0,0,3,0
270530081001002,44,South Uptown,47,47,1000000US270530081001002,"Block 1002, Block Group 1, Census Tract 81, Hennepin County, Minnesota",0,0,0,0,0,0,0,0,0,0,0,0,0,0,0,0,0,0,0,0,0,0,0,0,0
270530081001003,44,South Uptown,47,47,1000000US270530081001003,"Block 1003, Block Group 1, Census Tract 81, Hennepin County, Minnesota",277,223,15,17,9,0,1,12,277,264,219,15,12,8,0,0,10,13,4,0,5,1,0,1,2
270530081002003,44,South Uptown,47,47,1000000US270530081002003,"Block 2003, Block Group 2, Census Tract 81, Hennepin County, Minnesota",63,53,8,0,0,0,0,2,63,63,53,8,0,0,0,0,2,0,0,0,0,0,0,0,0
270530081002000,44,South Uptown,47,47,1000000US270530081002000,"Block 2000, Block Group 2, Census Tract 81, Hennepin County, Minnesota",73,65,6,0,2,0,0,0,73,71,64,5,0,2,0,0,0,2,1,1,0,0,0,0,0
270530081003007,44,South Uptown,47,47,1000000US270530081003007,"Block 3007, Block Group 3, Census Tract 81, Hennepin County, Minnesota",76,73,0,0,2,1,0,0,76,72,69,0,0,2,1,0,0,4,4,0,0,0,0,0,0
270530081001000,44,South Uptown,47,47,1000000US270530081001000,"Block 1000, Block Group 1, Census Tract 81, Hennepin County, Minnesota",67,54,4,1,2,0,2,4,67,59,51,4,1,2,0,0,1,8,3,0,0,0,0,2,3
270531092003006,44,South Uptown,47,47,1000000US270531092003006,"Block 3006, Block Group 3, Census Tract 1092, Hennepin County, Minnesota",151,127,9,0,4,0,4,7,151,145,126,9,0,4,0,0,6,6,1,0,0,0,0,4,1
270531092001007,44,South Uptown,47,47,1000000US270531092001007,"Block 1007, Block Group 1, Census Tract 1092, Hennepin County, Minnesota",230,200,11,0,5,0,5,9,230,213,190,11,0,5,0,0,7,17,10,0,0,0,0,5,2
270531092003004,44,South Uptown,47,47,1000000US270531092003004,"Block 3004, Block Group 3, Census Tract 1092, Hennepin County, Minnesota",185,150,18,3,10,0,2,2,185,176,144,17,3,10,0,0,2,9,6,1,0,0,0,2,0
270531092003000,44,South Uptown,47,47,1000000US270531092003000,"Block 3000, Block Group 3, Census Tract 1092, Hennepin County, Minnesota",91,59,16,0,4,0,1,11,91,88,58,14,0,4,0,1,11,3,1,2,0,0,0,0,0
270530081002002,44,South Uptown,47,47,1000000US270530081002002,"Block 2002, Block Group 2, Census Tract 81, Hennepin County, Minnesota",91,62,23,0,2,0,0,4,91,83,56,23,0,2,0,0,2,8,6,0,0,0,0,0,2
270530081002005,44,South Uptown,47,47,1000000US270530081002005,"Block 2005, Block Group 2, Census Tract 81, Hennepin County, Minnesota",83,64,0,4,12,0,3,0,83,79,63,0,4,12,0,0,0,4,1,0,0,0,0,3,0
270530081004003,44,South Uptown,47,47,1000000US270530081004003,"Block 4003, Block Group 4, Census Tract 81, Hennepin County, Minnesota",185,167,1,3,6,0,2,6,185,179,163,1,3,6,0,1,5,6,4,0,0,0,0,1,1
270530081003003,44,South Uptown,47,47,1000000US270530081003003,"Block 3003, Block Group 3, Census Tract 81, Hennepin County, Minnesota",121,100,6,0,6,0,3,6,121,114,96,6,0,6,0,1,5,7,4,0,0,0,0,2,1
270531092001005,44,South Uptown,47,47,1000000US270531092001005,"Block 1005, Block Group 1, Census Tract 1092, Hennepin County, Minnesota",81,76,4,0,0,0,0,1,81,78,73,4,0,0,0,0,1,3,3,0,0,0,0,0,0
270530081003000,44,South Uptown,47,47,1000000US270530081003000,"Block 3000, Block Group 3, Census Tract 81, Hennepin County, Minnesota",126,84,9,6,6,0,11,10,126,113,82,9,6,6,0,0,10,13,2,0,0,0,0,11,0
270530081002006,44,South Uptown,47,47,1000000US270530081002006,"Block 2006, Block Group 2, Census Tract 81, Hennepin County, Minnesota",127,85,18,6,4,0,8,6,127,117,83,18,6,4,0,0,6,10,2,0,0,0,0,8,0
270531092001006,44,South Uptown,47,47,1000000US270531092001006,"Block 1006, Block Group 1, Census Tract 1092, Hennepin County, Minnesota",161,142,6,0,2,0,5,6,161,152,138,6,0,2,0,1,5,9,4,0,0,0,0,4,1
270531092003001,44,South Uptown,47,47,1000000US270531092003001,"Block 3001, Block Group 3, Census Tract 1092, Hennepin County, Minnesota",130,107,14,1,3,0,2,3,130,125,104,14,1,3,0,0,3,5,3,0,0,0,0,2,0
270530081004005,44,South Uptown,47,47,1000000US270530081004005,"Block 4005, Block Group 4, Census Tract 81, Hennepin County, Minnesota",143,127,6,0,5,0,1,4,143,139,124,6,0,5,0,1,3,4,3,0,0,0,0,0,1
270531092001004,44,South Uptown,47,47,1000000US270531092001004,"Block 1004, Block Group 1, Census Tract 1092, Hennepin County, Minnesota",66,59,3,1,0,0,1,2,66,58,55,1,0,0,0,1,1,8,4,2,1,0,0,0,1
270530081004002,44,South Uptown,47,47,1000000US270530081004002,"Block 4002, Block Group 4, Census Tract 81, Hennepin County, Minnesota",154,142,0,0,8,0,0,4,154,149,137,0,0,8,0,0,4,5,5,0,0,0,0,0,0
270530081001006,44,South Uptown,47,47,1000000US270530081001006,"Block 1006, Block Group 1, Census Tract 81, Hennepin County, Minnesota",96,72,13,1,5,0,3,2,96,93,72,13,1,5,0,0,2,3,0,0,0,0,0,3,0
270530081002001,44,South Uptown,47,47,1000000US270530081002001,"Block 2001, Block Group 2, Census Tract 81, Hennepin County, Minnesota",60,53,1,0,3,0,0,3,60,59,53,1,0,3,0,0,2,1,0,0,0,0,0,0,1
270530081003001,44,South Uptown,47,47,1000000US270530081003001,"Block 3001, Block Group 3, Census Tract 81, Hennepin County, Minnesota",94,90,0,0,1,0,0,3,94,90,87,0,0,1,0,0,2,4,3,0,0,0,0,0,1
270531092003002,44,South Uptown,47,47,1000000US270531092003002,"Block 3002, Block Group 3, Census Tract 1092, Hennepin County, Minnesota",207,148,45,0,4,0,5,5,207,194,137,45,0,4,0,3,5,13,11,0,0,0,0,2,0
270530081001001,44,South Uptown,47,47,1000000US270530081001001,"Block 1001, Block Group 1, Census Tract 81, Hennepin County, Minnesota",111,99,4,0,4,0,0,4,111,104,93,4,0,4,0,0,3,7,6,0,0,0,0,0,1
270530081001004,44,South Uptown,47,47,1000000US270530081001004,"Block 1004, Block Group 1, Census Tract 81, Hennepin County, Minnesota",100,81,2,4,0,0,4,9,100,96,81,2,4,0,0,0,9,4,0,0,0,0,0,4,0
270531259001007,45,East Phillips,92,92,1000000US270531259001007,"Block 1007, Block Group 1, Census Tract 1259, Hennepin County, Minnesota",0,0,0,0,0,0,0,0,0,0,0,0,0,0,0,0,0,0,0,0,0,0,0,0,0
270531259001015,45,East Phillips,92,92,1000000US270531259001015,"Block 1015, Block Group 1, Census Tract 1259, Hennepin County, Minnesota",56,45,2,1,3,0,0,5,56,55,45,2,0,3,0,0,5,1,0,0,1,0,0,0,0
270531259001000,45,East Phillips,92,92,1000000US270531259001000,"Block 1000, Block Group 1, Census Tract 1259, Hennepin County, Minnesota",0,0,0,0,0,0,0,0,0,0,0,0,0,0,0,0,0,0,0,0,0,0,0,0,0
270531259001008,45,East Phillips,92,92,1000000US270531259001008,"Block 1008, Block Group 1, Census Tract 1259, Hennepin County, Minnesota",0,0,0,0,0,0,0,0,0,0,0,0,0,0,0,0,0,0,0,0,0,0,0,0,0
270531259001002,45,East Phillips,92,92,1000000US270531259001002,"Block 1002, Block Group 1, Census Tract 1259, Hennepin County, Minnesota",54,2,46,2,0,0,0,4,54,54,2,46,2,0,0,0,4,0,0,0,0,0,0,0,0
270531259002002,45,East Phillips,92,92,1000000US270531259002002,"Block 2002, Block Group 2, Census Tract 1259, Hennepin County, Minnesota",547,11,4,489,1,0,1,41,547,476,10,4,426,1,0,0,35,71,1,0,63,0,0,1,6
270531259001009,45,East Phillips,92,92,1000000US270531259001009,"Block 1009, Block Group 1, Census Tract 1259, Hennepin County, Minnesota",90,58,4,0,7,0,14,7,90,31,17,3,0,7,0,0,4,59,41,1,0,0,0,14,3
270531259001011,45,East Phillips,92,92,1000000US270531259001011,"Block 1011, Block Group 1, Census Tract 1259, Hennepin County, Minnesota",157,53,5,4,0,0,68,27,157,28,15,5,1,0,0,4,3,129,38,0,3,0,0,64,24
270531259001013,45,East Phillips,92,92,1000000US270531259001013,"Block 1013, Block Group 1, Census Tract 1259, Hennepin County, Minnesota",28,27,0,0,1,0,0,0,28,28,27,0,0,1,0,0,0,0,0,0,0,0,0,0,0
270531259003007,45,East Phillips,92,92,1000000US270531259003007,"Block 3007, Block Group 3, Census Tract 1259, Hennepin County, Minnesota",122,27,57,9,0,0,25,4,122,75,11,56,3,0,0,2,3,47,16,1,6,0,0,23,1
270531259002006,45,East Phillips,92,92,1000000US270531259002006,"Block 2006, Block Group 2, Census Tract 1259, Hennepin County, Minnesota",77,19,38,0,2,0,14,4,77,47,7,38,0,2,0,0,0,30,12,0,0,0,0,14,4
270531259001010,45,East Phillips,92,92,1000000US270531259001010,"Block 1010, Block Group 1, Census Tract 1259, Hennepin County, Minnesota",240,26,134,6,0,0,59,15,240,146,5,133,5,0,0,0,3,94,21,1,1,0,0,59,12
270531259001016,45,East Phillips,92,92,1000000US270531259001016,"Block 1016, Block Group 1, Census Tract 1259, Hennepin County, Minnesota",0,0,0,0,0,0,0,0,0,0,0,0,0,0,0,0,0,0,0,0,0,0,0,0,0
270531259002000,45,East Phillips,92,92,1000000US270531259002000,"Block 2000, Block Group 2, Census Tract 1259, Hennepin County, Minnesota",0,0,0,0,0,0,0,0,0,0,0,0,0,0,0,0,0,0,0,0,0,0,0,0,0
270531259002010,45,East Phillips,92,92,1000000US270531259002010,"Block 2010, Block Group 2, Census Tract 1259, Hennepin County, Minnesota",147,49,30,21,6,1,39,1,147,82,29,30,15,6,0,1,1,65,20,0,6,0,1,38,0
270531259003010,45,East Phillips,92,92,1000000US270531259003010,"Block 3010, Block Group 3, Census Tract 1259, Hennepin County, Minnesota",125,50,51,2,3,0,18,1,125,95,37,51,2,3,0,1,1,30,13,0,0,0,0,17,0
270531259001001,45,East Phillips,92,92,1000000US270531259001001,"Block 1001, Block Group 1, Census Tract 1259, Hennepin County, Minnesota",0,0,0,0,0,0,0,0,0,0,0,0,0,0,0,0,0,0,0,0,0,0,0,0,0
270531259002003,45,East Phillips,92,92,1000000US270531259002003,"Block 2003, Block Group 2, Census Tract 1259, Hennepin County, Minnesota",240,21,30,170,1,0,4,14,240,187,17,29,134,1,0,0,6,53,4,1,36,0,0,4,8
270531259003002,45,East Phillips,92,92,1000000US270531259003002,"Block 3002, Block Group 3, Census Tract 1259, Hennepin County, Minnesota",185,54,62,27,0,3,20,19,185,124,21,61,25,0,3,0,14,61,33,1,2,0,0,20,5
270531259001005,45,East Phillips,92,92,1000000US270531259001005,"Block 1005, Block Group 1, Census Tract 1259, Hennepin County, Minnesota",70,12,11,14,0,0,28,5,70,38,11,11,11,0,0,0,5,32,1,0,3,0,0,28,0
270531259001004,45,East Phillips,92,92,1000000US270531259001004,"Block 1004, Block Group 1, Census Tract 1259, Hennepin County, Minnesota",106,56,17,11,6,0,10,6,106,55,30,13,5,6,0,0,1,51,26,4,6,0,0,10,5
270531259001006,45,East Phillips,92,92,1000000US270531259001006,"Block 1006, Block Group 1, Census Tract 1259, Hennepin County, Minnesota",124,51,10,0,4,0,55,4,124,29,16,5,0,4,0,0,4,95,35,5,0,0,0,55,0
270531259002007,45,East Phillips,92,92,1000000US270531259002007,"Block 2007, Block Group 2, Census Tract 1259, Hennepin County, Minnesota",67,26,22,5,7,0,6,1,67,58,23,22,5,7,0,0,1,9,3,0,0,0,0,6,0
270531259002009,45,East Phillips,92,92,1000000US270531259002009,"Block 2009, Block Group 2, Census Tract 1259, Hennepin County, Minnesota",171,61,29,7,15,0,49,10,171,95,42,29,5,15,0,0,4,76,19,0,2,0,0,49,6
270531259003008,45,East Phillips,92,92,1000000US270531259003008,"Block 3008, Block Group 3, Census Tract 1259, Hennepin County, Minnesota",177,43,34,15,21,0,59,5,177,111,36,34,15,21,0,0,5,66,7,0,0,0,0,59,0
270531259003009,45,East Phillips,92,92,1000000US270531259003009,"Block 3009, Block Group 3, Census Tract 1259, Hennepin County, Minnesota",127,73,8,9,7,0,19,11,127,72,47,8,9,2,0,0,6,55,26,0,0,5,0,19,5
270531259003005,45,East Phillips,92,92,1000000US270531259003005,"Block 3005, Block Group 3, Census Tract 1259, Hennepin County, Minnesota",85,31,42,0,0,0,10,2,85,72,28,42,0,0,0,0,2,13,3,0,0,0,0,10,0
270531259002005,45,East Phillips,92,92,1000000US270531259002005,"Block 2005, Block Group 2, Census Tract 1259, Hennepin County, Minnesota",147,32,68,13,10,0,17,7,147,115,27,68,5,10,0,0,5,32,5,0,8,0,0,17,2
270531259002004,45,East Phillips,92,92,1000000US270531259002004,"Block 2004, Block Group 2, Census Tract 1259, Hennepin County, Minnesota",167,38,26,78,7,0,11,7,167,141,33,24,72,7,0,0,5,26,5,2,6,0,0,11,2
270531259003003,45,East Phillips,92,92,1000000US270531259003003,"Block 3003, Block Group 3, Census Tract 1259, Hennepin County, Minnesota",121,33,21,5,0,0,49,13,121,52,20,21,3,0,0,0,8,69,13,0,2,0,0,49,5
270531259001003,45,East Phillips,92,92,1000000US270531259001003,"Block 1003, Block Group 1, Census Tract 1259, Hennepin County, Minnesota",47,18,11,3,0,0,14,1,47,26,11,11,3,0,0,0,1,21,7,0,0,0,0,14,0
270531259003006,45,East Phillips,92,92,1000000US270531259003006,"Block 3006, Block Group 3, Census Tract 1259, Hennepin County, Minnesota",157,69,14,9,0,0,56,9,157,61,31,14,8,0,0,0,8,96,38,0,1,0,0,56,1
270531259001012,45,East Phillips,92,92,1000000US270531259001012,"Block 1012, Block Group 1, Census Tract 1259, Hennepin County, Minnesota",106,40,2,9,7,0,40,8,106,36,15,2,7,7,0,0,5,70,25,0,2,0,0,40,3
270531259002001,45,East Phillips,92,92,1000000US270531259002001,"Block 2001, Block Group 2, Census Tract 1259, Hennepin County, Minnesota",0,0,0,0,0,0,0,0,0,0,0,0,0,0,0,0,0,0,0,0,0,0,0,0,0
270531259003001,45,East Phillips,92,92,1000000US270531259003001,"Block 3001, Block Group 3, Census Tract 1259, Hennepin County, Minnesota",124,43,23,9,4,0,38,7,124,77,39,23,8,4,0,0,3,47,4,0,1,0,0,38,4
270531259003000,45,East Phillips,92,92,1000000US270531259003000,"Block 3000, Block Group 3, Census Tract 1259, Hennepin County, Minnesota",67,29,14,7,3,0,10,4,67,32,13,14,0,3,0,0,2,35,16,0,7,0,0,10,2
270531259002008,45,East Phillips,92,92,1000000US270531259002008,"Block 2008, Block Group 2, Census Tract 1259, Hennepin County, Minnesota",155,64,40,4,16,0,26,5,155,88,31,36,4,16,0,1,0,67,33,4,0,0,0,25,5
270531259003004,45,East Phillips,92,92,1000000US270531259003004,"Block 3004, Block Group 3, Census Tract 1259, Hennepin County, Minnesota",183,32,34,9,0,0,90,18,183,62,13,34,4,0,0,0,11,121,19,0,5,0,0,90,7
270531259001014,45,East Phillips,92,92,1000000US270531259001014,"Block 1014, Block Group 1, Census Tract 1259, Hennepin County, Minnesota",0,0,0,0,0,0,0,0,0,0,0,0,0,0,0,0,0,0,0,0,0,0,0,0,0
270531007002003,46,Cleveland,5,5,1000000US270531007002003,"Block 2003, Block Group 2, Census Tract 1007, Hennepin County, Minnesota",55,51,0,0,0,0,4,0,55,50,50,0,0,0,0,0,0,5,1,0,0,0,0,4,0
270531007002004,46,Cleveland,5,5,1000000US270531007002004,"Block 2004, Block Group 2, Census Tract 1007, Hennepin County, Minnesota",54,38,11,0,0,0,5,0,54,48,37,11,0,0,0,0,0,6,1,0,0,0,0,5,0
270531007002002,46,Cleveland,5,5,1000000US270531007002002,"Block 2002, Block Group 2, Census Tract 1007, Hennepin County, Minnesota",59,42,14,0,0,1,1,1,59,58,42,14,0,0,1,0,1,1,0,0,0,0,0,1,0
270531007002005,46,Cleveland,5,5,1000000US270531007002005,"Block 2005, Block Group 2, Census Tract 1007, Hennepin County, Minnesota",67,62,3,0,2,0,0,0,67,57,52,3,0,2,0,0,0,10,10,0,0,0,0,0,0
270531007002009,46,Cleveland,5,5,1000000US270531007002009,"Block 2009, Block Group 2, Census Tract 1007, Hennepin County, Minnesota",62,34,19,0,5,0,0,4,62,61,33,19,0,5,0,0,4,1,1,0,0,0,0,0,0
270531007003000,46,Cleveland,5,5,1000000US270531007003000,"Block 3000, Block Group 3, Census Tract 1007, Hennepin County, Minnesota",71,40,24,4,0,0,0,3,71,68,37,24,4,0,0,0,3,3,3,0,0,0,0,0,0
270531007004004,46,Cleveland,5,5,1000000US270531007004004,"Block 4004, Block Group 4, Census Tract 1007, Hennepin County, Minnesota",85,21,35,0,12,0,16,1,85,65,19,32,0,12,0,1,1,20,2,3,0,0,0,15,0
270531007003008,46,Cleveland,5,5,1000000US270531007003008,"Block 3008, Block Group 3, Census Tract 1007, Hennepin County, Minnesota",66,13,35,0,13,0,1,4,66,62,13,35,0,13,0,0,1,4,0,0,0,0,0,1,3
270531007001003,46,Cleveland,5,5,1000000US270531007001003,"Block 1003, Block Group 1, Census Tract 1007, Hennepin County, Minnesota",61,40,10,0,1,0,8,2,61,53,40,10,0,1,0,0,2,8,0,0,0,0,0,8,0
270531007001005,46,Cleveland,5,5,1000000US270531007001005,"Block 1005, Block Group 1, Census Tract 1007, Hennepin County, Minnesota",55,37,10,0,0,0,0,8,55,53,36,10,0,0,0,0,7,2,1,0,0,0,0,0,1
270531007003004,46,Cleveland,5,5,1000000US270531007003004,"Block 3004, Block Group 3, Census Tract 1007, Hennepin County, Minnesota",61,34,24,0,1,0,0,2,61,61,34,24,0,1,0,0,2,0,0,0,0,0,0,0,0
270531007002006,46,Cleveland,5,5,1000000US270531007002006,"Block 2006, Block Group 2, Census Tract 1007, Hennepin County, Minnesota",66,45,12,1,1,0,0,7,66,66,45,12,1,1,0,0,7,0,0,0,0,0,0,0,0
270531007001002,46,Cleveland,5,5,1000000US270531007001002,"Block 1002, Block Group 1, Census Tract 1007, Hennepin County, Minnesota",74,40,23,0,2,0,8,1,74,66,40,23,0,2,0,0,1,8,0,0,0,0,0,8,0
270531007002010,46,Cleveland,5,5,1000000US270531007002010,"Block 2010, Block Group 2, Census Tract 1007, Hennepin County, Minnesota",55,43,4,1,0,0,0,7,55,52,42,2,1,0,0,0,7,3,1,2,0,0,0,0,0
270531007003011,46,Cleveland,5,5,1000000US270531007003011,"Block 3011, Block Group 3, Census Tract 1007, Hennepin County, Minnesota",40,34,0,0,0,0,0,6,40,36,30,0,0,0,0,0,6,4,4,0,0,0,0,0,0
270531007003009,46,Cleveland,5,5,1000000US270531007003009,"Block 3009, Block Group 3, Census Tract 1007, Hennepin County, Minnesota",50,35,3,1,8,0,0,3,50,49,34,3,1,8,0,0,3,1,1,0,0,0,0,0,0
270531007002011,46,Cleveland,5,5,1000000US270531007002011,"Block 2011, Block Group 2, Census Tract 1007, Hennepin County, Minnesota",51,44,6,0,0,0,1,0,51,48,42,6,0,0,0,0,0,3,2,0,0,0,0,1,0
270531007001004,46,Cleveland,5,5,1000000US270531007001004,"Block 1004, Block Group 1, Census Tract 1007, Hennepin County, Minnesota",58,38,17,2,0,0,0,1,58,51,32,16,2,0,0,0,1,7,6,1,0,0,0,0,0
270531007003003,46,Cleveland,5,5,1000000US270531007003003,"Block 3003, Block Group 3, Census Tract 1007, Hennepin County, Minnesota",64,49,9,0,0,0,1,5,64,63,49,9,0,0,0,0,5,1,0,0,0,0,0,1,0
270531007004003,46,Cleveland,5,5,1000000US270531007004003,"Block 4003, Block Group 4, Census Tract 1007, Hennepin County, Minnesota",57,22,24,0,8,0,0,3,57,54,20,23,0,8,0,0,3,3,2,1,0,0,0,0,0
270531007003007,46,Cleveland,5,5,1000000US270531007003007,"Block 3007, Block Group 3, Census Tract 1007, Hennepin County, Minnesota",85,41,29,0,9,0,4,2,85,79,41,28,0,9,0,0,1,6,0,1,0,0,0,4,1
270531007002001,46,Cleveland,5,5,1000000US270531007002001,"Block 2001, Block Group 2, Census Tract 1007, Hennepin County, Minnesota",55,42,11,1,0,0,1,0,55,54,41,11,1,0,0,1,0,1,1,0,0,0,0,0,0
270531007003002,46,Cleveland,5,5,1000000US270531007003002,"Block 3002, Block Group 3, Census Tract 1007, Hennepin County, Minnesota",55,37,5,0,6,0,1,6,55,55,37,5,0,6,0,1,6,0,0,0,0,0,0,0,0
270531007001011,46,Cleveland,5,5,1000000US270531007001011,"Block 1011, Block Group 1, Census Tract 1007, Hennepin County, Minnesota",58,42,13,0,3,0,0,0,58,56,40,13,0,3,0,0,0,2,2,0,0,0,0,0,0
270531007001010,46,Cleveland,5,5,1000000US270531007001010,"Block 1010, Block Group 1, Census Tract 1007, Hennepin County, Minnesota",76,41,27,1,0,0,0,7,76,70,40,26,1,0,0,0,3,6,1,1,0,0,0,0,4
270531007004001,46,Cleveland,5,5,1000000US270531007004001,"Block 4001, Block Group 4, Census Tract 1007, Hennepin County, Minnesota",60,40,15,1,0,0,1,3,60,57,38,15,1,0,0,0,3,3,2,0,0,0,0,1,0
270531007004000,46,Cleveland,5,5,1000000US270531007004000,"Block 4000, Block Group 4, Census Tract 1007, Hennepin County, Minnesota",105,29,36,1,27,0,6,6,105,96,27,35,1,27,0,0,6,9,2,1,0,0,0,6,0
270531007004007,46,Cleveland,5,5,1000000US270531007004007,"Block 4007, Block Group 4, Census Tract 1007, Hennepin County, Minnesota",71,30,21,0,15,0,2,3,71,67,28,21,0,15,0,0,3,4,2,0,0,0,0,2,0
270531007004008,46,Cleveland,5,5,1000000US270531007004008,"Block 4008, Block Group 4, Census Tract 1007, Hennepin County, Minnesota",96,24,52,0,17,0,0,3,96,96,24,52,0,17,0,0,3,0,0,0,0,0,0,0,0
270531007004005,46,Cleveland,5,5,1000000US270531007004005,"Block 4005, Block Group 4, Census Tract 1007, Hennepin County, Minnesota",66,26,14,0,16,0,5,5,66,63,25,14,0,16,0,3,5,3,1,0,0,0,0,2,0
270531007001000,46,Cleveland,5,5,1000000US270531007001000,"Block 1000, Block Group 1, Census Tract 1007, Hennepin County, Minnesota",59,18,24,12,1,0,0,4,59,58,18,24,11,1,0,0,4,1,0,0,1,0,0,0,0
270531007002000,46,Cleveland,5,5,1000000US270531007002000,"Block 2000, Block Group 2, Census Tract 1007, Hennepin County, Minnesota",58,48,7,0,3,0,0,0,58,56,46,7,0,3,0,0,0,2,2,0,0,0,0,0,0
270531007002007,46,Cleveland,5,5,1000000US270531007002007,"Block 2007, Block Group 2, Census Tract 1007, Hennepin County, Minnesota",65,31,32,0,0,0,0,2,65,65,31,32,0,0,0,0,2,0,0,0,0,0,0,0,0
270531007002008,46,Cleveland,5,5,1000000US270531007002008,"Block 2008, Block Group 2, Census Tract 1007, Hennepin County, Minnesota",68,37,19,1,4,0,5,2,68,58,33,19,0,4,0,0,2,10,4,0,1,0,0,5,0
270531007003010,46,Cleveland,5,5,1000000US270531007003010,"Block 3010, Block Group 3, Census Tract 1007, Hennepin County, Minnesota",89,48,17,0,7,0,5,12,89,86,47,17,0,7,0,3,12,3,1,0,0,0,0,2,0
270531007001007,46,Cleveland,5,5,1000000US270531007001007,"Block 1007, Block Group 1, Census Tract 1007, Hennepin County, Minnesota",81,21,49,0,6,0,5,0,81,77,21,49,0,6,0,1,0,4,0,0,0,0,0,4,0
270531007001001,46,Cleveland,5,5,1000000US270531007001001,"Block 1001, Block Group 1, Census Tract 1007, Hennepin County, Minnesota",71,45,14,0,12,0,0,0,71,68,42,14,0,12,0,0,0,3,3,0,0,0,0,0,0
270531007003001,46,Cleveland,5,5,1000000US270531007003001,"Block 3001, Block Group 3, Census Tract 1007, Hennepin County, Minnesota",48,28,11,0,6,0,0,3,48,48,28,11,0,6,0,0,3,0,0,0,0,0,0,0,0
270531007003005,46,Cleveland,5,5,1000000US270531007003005,"Block 3005, Block Group 3, Census Tract 1007, Hennepin County, Minnesota",80,44,19,0,0,0,9,8,80,64,37,19,0,0,0,0,8,16,7,0,0,0,0,9,0
270531007003006,46,Cleveland,5,5,1000000US270531007003006,"Block 3006, Block Group 3, Census Tract 1007, Hennepin County, Minnesota",67,34,22,2,6,0,0,3,67,67,34,22,2,6,0,0,3,0,0,0,0,0,0,0,0
270531007004002,46,Cleveland,5,5,1000000US270531007004002,"Block 4002, Block Group 4, Census Tract 1007, Hennepin County, Minnesota",43,21,10,0,2,0,9,1,43,34,21,10,0,2,0,0,1,9,0,0,0,0,0,9,0
270531007001008,46,Cleveland,5,5,1000000US270531007001008,"Block 1008, Block Group 1, Census Tract 1007, Hennepin County, Minnesota",98,21,31,10,17,0,16,3,98,81,21,30,10,17,0,0,3,17,0,1,0,0,0,16,0
270531007004006,46,Cleveland,5,5,1000000US270531007004006,"Block 4006, Block Group 4, Census Tract 1007, Hennepin County, Minnesota",99,12,65,0,9,0,8,5,99,90,12,64,0,9,0,0,5,9,0,1,0,0,0,8,0
270531007001006,46,Cleveland,5,5,1000000US270531007001006,"Block 1006, Block Group 1, Census Tract 1007, Hennepin County, Minnesota",93,32,44,0,6,0,0,11,93,93,32,44,0,6,0,0,11,0,0,0,0,0,0,0,0
270531007001009,46,Cleveland,5,5,1000000US270531007001009,"Block 1009, Block Group 1, Census Tract 1007, Hennepin County, Minnesota",68,45,20,0,1,0,0,2,68,60,37,20,0,1,0,0,2,8,8,0,0,0,0,0,0
270530121013001,47,Wenonah,83,83,1000000US270530121013001,"Block 3001, Block Group 3, Census Tract 121.01, Hennepin County, Minnesota",79,51,20,0,7,0,1,0,79,75,49,19,0,7,0,0,0,4,2,1,0,0,0,1,0
270530121013021,47,Wenonah,83,83,1000000US270530121013021,"Block 3021, Block Group 3, Census Tract 121.01, Hennepin County, Minnesota",23,22,0,0,1,0,0,0,23,23,22,0,0,1,0,0,0,0,0,0,0,0,0,0,0
270530121013022,47,Wenonah,83,83,1000000US270530121013022,"Block 3022, Block Group 3, Census Tract 121.01, Hennepin County, Minnesota",28,17,2,0,1,0,5,3,28,22,17,2,0,1,0,0,2,6,0,0,0,0,0,5,1
270530121012005,47,Wenonah,83,83,1000000US270530121012005,"Block 2005, Block Group 2, Census Tract 121.01, Hennepin County, Minnesota",0,0,0,0,0,0,0,0,0,0,0,0,0,0,0,0,0,0,0,0,0,0,0,0,0
270530121013011,47,Wenonah,83,83,1000000US270530121013011,"Block 3011, Block Group 3, Census Tract 121.01, Hennepin County, Minnesota",32,32,0,0,0,0,0,0,32,27,27,0,0,0,0,0,0,5,5,0,0,0,0,0,0
270530121013012,47,Wenonah,83,83,1000000US270530121013012,"Block 3012, Block Group 3, Census Tract 121.01, Hennepin County, Minnesota",31,26,0,1,0,0,0,4,31,27,23,0,0,0,0,0,4,4,3,0,1,0,0,0,0
270530121013016,47,Wenonah,83,83,1000000US270530121013016,"Block 3016, Block Group 3, Census Tract 121.01, Hennepin County, Minnesota",0,0,0,0,0,0,0,0,0,0,0,0,0,0,0,0,0,0,0,0,0,0,0,0,0
270530121013007,47,Wenonah,83,83,1000000US270530121013007,"Block 3007, Block Group 3, Census Tract 121.01, Hennepin County, Minnesota",74,54,9,0,0,0,3,8,74,63,46,9,0,0,0,0,8,11,8,0,0,0,0,3,0
270530118005003,47,Wenonah,83,83,1000000US270530118005003,"Block 5003, Block Group 5, Census Tract 118, Hennepin County, Minnesota",64,63,0,0,0,0,0,1,64,59,59,0,0,0,0,0,0,5,4,0,0,0,0,0,1
270530118005025,47,Wenonah,83,83,1000000US270530118005025,"Block 5025, Block Group 5, Census Tract 118, Hennepin County, Minnesota",24,20,0,0,0,0,3,1,24,21,20,0,0,0,0,0,1,3,0,0,0,0,0,3,0
270530118005024,47,Wenonah,83,83,1000000US270530118005024,"Block 5024, Block Group 5, Census Tract 118, Hennepin County, Minnesota",32,32,0,0,0,0,0,0,32,32,32,0,0,0,0,0,0,0,0,0,0,0,0,0,0
270530121013008,47,Wenonah,83,83,1000000US270530121013008,"Block 3008, Block Group 3, Census Tract 121.01, Hennepin County, Minnesota",55,50,2,0,1,0,0,2,55,52,47,2,0,1,0,0,2,3,3,0,0,0,0,0,0
270530118005021,47,Wenonah,83,83,1000000US270530118005021,"Block 5021, Block Group 5, Census Tract 118, Hennepin County, Minnesota",62,52,0,0,4,0,0,6,62,62,52,0,0,4,0,0,6,0,0,0,0,0,0,0,0
270530118005009,47,Wenonah,83,83,1000000US270530118005009,"Block 5009, Block Group 5, Census Tract 118, Hennepin County, Minnesota",62,58,2,0,1,0,0,1,62,59,55,2,0,1,0,0,1,3,3,0,0,0,0,0,0
270530118005023,47,Wenonah,83,83,1000000US270530118005023,"Block 5023, Block Group 5, Census Tract 118, Hennepin County, Minnesota",21,21,0,0,0,0,0,0,21,21,21,0,0,0,0,0,0,0,0,0,0,0,0,0,0
270530121013015,47,Wenonah,83,83,1000000US270530121013015,"Block 3015, Block Group 3, Census Tract 121.01, Hennepin County, Minnesota",10,5,1,0,1,0,0,3,10,10,5,1,0,1,0,0,3,0,0,0,0,0,0,0,0
270530118005017,47,Wenonah,83,83,1000000US270530118005017,"Block 5017, Block Group 5, Census Tract 118, Hennepin County, Minnesota",55,43,1,0,1,0,9,1,55,45,42,1,0,1,0,1,0,10,1,0,0,0,0,8,1
270530118005007,47,Wenonah,83,83,1000000US270530118005007,"Block 5007, Block Group 5, Census Tract 118, Hennepin County, Minnesota",68,59,5,0,3,0,0,1,68,68,59,5,0,3,0,0,1,0,0,0,0,0,0,0,0
270530118005008,47,Wenonah,83,83,1000000US270530118005008,"Block 5008, Block Group 5, Census Tract 118, Hennepin County, Minnesota",16,16,0,0,0,0,0,0,16,16,16,0,0,0,0,0,0,0,0,0,0,0,0,0,0
270530118005019,47,Wenonah,83,83,1000000US270530118005019,"Block 5019, Block Group 5, Census Tract 118, Hennepin County, Minnesota",72,49,14,4,0,0,4,1,72,68,49,14,4,0,0,0,1,4,0,0,0,0,0,4,0
270530118005002,47,Wenonah,83,83,1000000US270530118005002,"Block 5002, Block Group 5, Census Tract 118, Hennepin County, Minnesota",69,51,13,0,2,0,0,3,69,66,49,13,0,2,0,0,2,3,2,0,0,0,0,0,1
270530118005016,47,Wenonah,83,83,1000000US270530118005016,"Block 5016, Block Group 5, Census Tract 118, Hennepin County, Minnesota",61,51,4,1,1,0,0,4,61,58,49,4,1,1,0,0,3,3,2,0,0,0,0,0,1
270530118004026,47,Wenonah,83,83,1000000US270530118004026,"Block 4026, Block Group 4, Census Tract 118, Hennepin County, Minnesota",0,0,0,0,0,0,0,0,0,0,0,0,0,0,0,0,0,0,0,0,0,0,0,0,0
270530121013010,47,Wenonah,83,83,1000000US270530121013010,"Block 3010, Block Group 3, Census Tract 121.01, Hennepin County, Minnesota",71,65,1,0,0,0,0,5,71,69,63,1,0,0,0,0,5,2,2,0,0,0,0,0,0
270530121013002,47,Wenonah,83,83,1000000US270530121013002,"Block 3002, Block Group 3, Census Tract 121.01, Hennepin County, Minnesota",66,56,1,1,0,1,5,2,66,60,56,1,1,0,0,0,2,6,0,0,0,0,1,5,0
270530121011006,47,Wenonah,83,83,1000000US270530121011006,"Block 1006, Block Group 1, Census Tract 121.01, Hennepin County, Minnesota",55,45,0,0,0,0,10,0,55,43,43,0,0,0,0,0,0,12,2,0,0,0,0,10,0
270530121011008,47,Wenonah,83,83,1000000US270530121011008,"Block 1008, Block Group 1, Census Tract 121.01, Hennepin County, Minnesota",51,25,5,0,0,0,11,10,51,30,24,5,0,0,0,0,1,21,1,0,0,0,0,11,9
270530121011009,47,Wenonah,83,83,1000000US270530121011009,"Block 1009, Block Group 1, Census Tract 121.01, Hennepin County, Minnesota",56,52,0,0,0,0,4,0,56,52,52,0,0,0,0,0,0,4,0,0,0,0,0,4,0
270530121011010,47,Wenonah,83,83,1000000US270530121011010,"Block 1010, Block Group 1, Census Tract 121.01, Hennepin County, Minnesota",51,43,4,0,0,0,0,4,51,44,36,4,0,0,0,0,4,7,7,0,0,0,0,0,0
270530121011001,47,Wenonah,83,83,1000000US270530121011001,"Block 1001, Block Group 1, Census Tract 121.01, Hennepin County, Minnesota",61,47,10,0,1,0,3,0,61,53,44,8,0,1,0,0,0,8,3,2,0,0,0,3,0
270530121011000,47,Wenonah,83,83,1000000US270530121011000,"Block 1000, Block Group 1, Census Tract 121.01, Hennepin County, Minnesota",111,83,13,1,4,0,7,3,111,98,78,13,1,4,0,0,2,13,5,0,0,0,0,7,1
270530121011012,47,Wenonah,83,83,1000000US270530121011012,"Block 1012, Block Group 1, Census Tract 121.01, Hennepin County, Minnesota",64,53,5,0,2,0,0,4,64,64,53,5,0,2,0,0,4,0,0,0,0,0,0,0,0
270530121013005,47,Wenonah,83,83,1000000US270530121013005,"Block 3005, Block Group 3, Census Tract 121.01, Hennepin County, Minnesota",77,59,12,0,0,0,6,0,77,56,44,12,0,0,0,0,0,21,15,0,0,0,0,6,0
270530121012006,47,Wenonah,83,83,1000000US270530121012006,"Block 2006, Block Group 2, Census Tract 121.01, Hennepin County, Minnesota",10,4,0,0,6,0,0,0,10,10,4,0,0,6,0,0,0,0,0,0,0,0,0,0,0
270530118005000,47,Wenonah,83,83,1000000US270530118005000,"Block 5000, Block Group 5, Census Tract 118, Hennepin County, Minnesota",73,57,1,2,1,1,10,1,73,62,56,1,2,1,1,0,1,11,1,0,0,0,0,10,0
270530121012004,47,Wenonah,83,83,1000000US270530121012004,"Block 2004, Block Group 2, Census Tract 121.01, Hennepin County, Minnesota",0,0,0,0,0,0,0,0,0,0,0,0,0,0,0,0,0,0,0,0,0,0,0,0,0
270530121011013,47,Wenonah,83,83,1000000US270530121011013,"Block 1013, Block Group 1, Census Tract 121.01, Hennepin County, Minnesota",59,37,19,0,0,0,1,2,59,58,37,19,0,0,0,0,2,1,0,0,0,0,0,1,0
270530121012002,47,Wenonah,83,83,1000000US270530121012002,"Block 2002, Block Group 2, Census Tract 121.01, Hennepin County, Minnesota",524,124,41,14,13,0,288,44,524,118,56,37,9,10,0,0,6,406,68,4,5,3,0,288,38
270530121011002,47,Wenonah,83,83,1000000US270530121011002,"Block 1002, Block Group 1, Census Tract 121.01, Hennepin County, Minnesota",66,52,4,0,0,0,1,9,66,54,48,4,0,0,0,0,2,12,4,0,0,0,0,1,7
270530121011011,47,Wenonah,83,83,1000000US270530121011011,"Block 1011, Block Group 1, Census Tract 121.01, Hennepin County, Minnesota",57,43,7,1,3,0,0,3,57,57,43,7,1,3,0,0,3,0,0,0,0,0,0,0,0
270530121013006,47,Wenonah,83,83,1000000US270530121013006,"Block 3006, Block Group 3, Census Tract 121.01, Hennepin County, Minnesota",72,71,0,0,0,0,1,0,72,66,66,0,0,0,0,0,0,6,5,0,0,0,0,1,0
270530121013003,47,Wenonah,83,83,1000000US270530121013003,"Block 3003, Block Group 3, Census Tract 121.01, Hennepin County, Minnesota",74,43,9,1,1,0,11,9,74,70,43,8,0,1,0,9,9,4,0,1,1,0,0,2,0
270530118005015,47,Wenonah,83,83,1000000US270530118005015,"Block 5015, Block Group 5, Census Tract 118, Hennepin County, Minnesota",80,56,6,0,1,0,7,10,80,65,56,5,0,1,0,2,1,15,0,1,0,0,0,5,9
270530121011007,47,Wenonah,83,83,1000000US270530121011007,"Block 1007, Block Group 1, Census Tract 121.01, Hennepin County, Minnesota",72,34,6,2,0,0,23,7,72,56,30,6,2,0,0,12,6,16,4,0,0,0,0,11,1
270530121011004,47,Wenonah,83,83,1000000US270530121011004,"Block 1004, Block Group 1, Census Tract 121.01, Hennepin County, Minnesota",62,60,0,1,0,0,0,1,62,61,59,0,1,0,0,0,1,1,1,0,0,0,0,0,0
270530121013014,47,Wenonah,83,83,1000000US270530121013014,"Block 3014, Block Group 3, Census Tract 121.01, Hennepin County, Minnesota",15,14,1,0,0,0,0,0,15,15,14,1,0,0,0,0,0,0,0,0,0,0,0,0,0
270530121011005,47,Wenonah,83,83,1000000US270530121011005,"Block 1005, Block Group 1, Census Tract 121.01, Hennepin County, Minnesota",80,65,6,0,6,0,0,3,80,77,62,6,0,6,0,0,3,3,3,0,0,0,0,0,0
270530118004009,47,Wenonah,83,83,1000000US270530118004009,"Block 4009, Block Group 4, Census Tract 118, Hennepin County, Minnesota",0,0,0,0,0,0,0,0,0,0,0,0,0,0,0,0,0,0,0,0,0,0,0,0,0
270530121013013,47,Wenonah,83,83,1000000US270530121013013,"Block 3013, Block Group 3, Census Tract 121.01, Hennepin County, Minnesota",24,21,0,2,1,0,0,0,24,24,21,0,2,1,0,0,0,0,0,0,0,0,0,0,0
270530121013000,47,Wenonah,83,83,1000000US270530121013000,"Block 3000, Block Group 3, Census Tract 121.01, Hennepin County, Minnesota",93,58,17,8,8,0,0,2,93,93,58,17,8,8,0,0,2,0,0,0,0,0,0,0,0
270530118005010,47,Wenonah,83,83,1000000US270530118005010,"Block 5010, Block Group 5, Census Tract 118, Hennepin County, Minnesota",59,50,6,0,0,0,0,3,59,59,50,6,0,0,0,0,3,0,0,0,0,0,0,0,0
270530118005011,47,Wenonah,83,83,1000000US270530118005011,"Block 5011, Block Group 5, Census Tract 118, Hennepin County, Minnesota",60,54,0,0,0,0,5,1,60,53,52,0,0,0,0,0,1,7,2,0,0,0,0,5,0
270530118005022,47,Wenonah,83,83,1000000US270530118005022,"Block 5022, Block Group 5, Census Tract 118, Hennepin County, Minnesota",51,50,1,0,0,0,0,0,51,51,50,1,0,0,0,0,0,0,0,0,0,0,0,0,0
270530121013009,47,Wenonah,83,83,1000000US270530121013009,"Block 3009, Block Group 3, Census Tract 121.01, Hennepin County, Minnesota",49,45,1,0,2,0,0,1,49,49,45,1,0,2,0,0,1,0,0,0,0,0,0,0,0
270530121013004,47,Wenonah,83,83,1000000US270530121013004,"Block 3004, Block Group 3, Census Tract 121.01, Hennepin County, Minnesota",82,66,11,1,0,0,0,4,82,77,64,10,1,0,0,0,2,5,2,1,0,0,0,0,2
270530118005001,47,Wenonah,83,83,1000000US270530118005001,"Block 5001, Block Group 5, Census Tract 118, Hennepin County, Minnesota",66,45,12,1,5,0,0,3,66,66,45,12,1,5,0,0,3,0,0,0,0,0,0,0,0
270530118005012,47,Wenonah,83,83,1000000US270530118005012,"Block 5012, Block Group 5, Census Tract 118, Hennepin County, Minnesota",57,56,0,0,1,0,0,0,57,57,56,0,0,1,0,0,0,0,0,0,0,0,0,0,0
270530118005013,47,Wenonah,83,83,1000000US270530118005013,"Block 5013, Block Group 5, Census Tract 118, Hennepin County, Minnesota",77,49,9,8,1,0,3,7,77,66,43,9,6,1,0,0,7,11,6,0,2,0,0,3,0
270530118005014,47,Wenonah,83,83,1000000US270530118005014,"Block 5014, Block Group 5, Census Tract 118, Hennepin County, Minnesota",107,47,18,4,9,0,26,3,107,78,45,18,4,9,0,0,2,29,2,0,0,0,0,26,1
270530121012000,47,Wenonah,83,83,1000000US270530121012000,"Block 2000, Block Group 2, Census Tract 121.01, Hennepin County, Minnesota",624,96,347,44,34,0,62,41,624,516,69,344,42,34,0,0,27,108,27,3,2,0,0,62,14
270530121012001,47,Wenonah,83,83,1000000US270530121012001,"Block 2001, Block Group 2, Census Tract 121.01, Hennepin County, Minnesota",99,21,71,4,1,0,0,2,99,99,21,71,4,1,0,0,2,0,0,0,0,0,0,0,0
270530118005004,47,Wenonah,83,83,1000000US270530118005004,"Block 5004, Block Group 5, Census Tract 118, Hennepin County, Minnesota",56,54,0,0,1,0,0,1,56,56,54,0,0,1,0,0,1,0,0,0,0,0,0,0,0
270530118005020,47,Wenonah,83,83,1000000US270530118005020,"Block 5020, Block Group 5, Census Tract 118, Hennepin County, Minnesota",62,52,0,1,4,0,0,5,62,62,52,0,1,4,0,0,5,0,0,0,0,0,0,0,0
270530118005018,47,Wenonah,83,83,1000000US270530118005018,"Block 5018, Block Group 5, Census Tract 118, Hennepin County, Minnesota",0,0,0,0,0,0,0,0,0,0,0,0,0,0,0,0,0,0,0,0,0,0,0,0,0
270530121011003,47,Wenonah,83,83,1000000US270530121011003,"Block 1003, Block Group 1, Census Tract 121.01, Hennepin County, Minnesota",55,51,1,1,0,0,2,0,55,53,51,1,1,0,0,0,0,2,0,0,0,0,0,2,0
270530121012003,47,Wenonah,83,83,1000000US270530121012003,"Block 2003, Block Group 2, Census Tract 121.01, Hennepin County, Minnesota",38,33,0,0,0,0,1,4,38,32,32,0,0,0,0,0,0,6,1,0,0,0,0,1,4
270530118005005,47,Wenonah,83,83,1000000US270530118005005,"Block 5005, Block Group 5, Census Tract 118, Hennepin County, Minnesota",0,0,0,0,0,0,0,0,0,0,0,0,0,0,0,0,0,0,0,0,0,0,0,0,0
270530118005006,47,Wenonah,83,83,1000000US270530118005006,"Block 5006, Block Group 5, Census Tract 118, Hennepin County, Minnesota",10,9,0,0,1,0,0,0,10,8,7,0,0,1,0,0,0,2,2,0,0,0,0,0,0
270530121012008,47,Wenonah,83,83,1000000US270530121012008,"Block 2008, Block Group 2, Census Tract 121.01, Hennepin County, Minnesota",7,7,0,0,0,0,0,0,7,6,6,0,0,0,0,0,0,1,1,0,0,0,0,0,0
270531018001010,48,Holland,15,15,1000000US270531018001010,"Block 1010, Block Group 1, Census Tract 1018, Hennepin County, Minnesota",24,16,6,0,1,0,0,1,24,24,16,6,0,1,0,0,1,0,0,0,0,0,0,0,0
270531018003000,48,Holland,15,15,1000000US270531018003000,"Block 3000, Block Group 3, Census Tract 1018, Hennepin County, Minnesota",28,9,18,0,0,0,0,1,28,28,9,18,0,0,0,0,1,0,0,0,0,0,0,0,0
270531018001000,48,Holland,15,15,1000000US270531018001000,"Block 1000, Block Group 1, Census Tract 1018, Hennepin County, Minnesota",61,39,0,0,2,0,14,6,61,39,36,0,0,2,0,1,0,22,3,0,0,0,0,13,6
270531018001009,48,Holland,15,15,1000000US270531018001009,"Block 1009, Block Group 1, Census Tract 1018, Hennepin County, Minnesota",8,1,0,0,0,0,7,0,8,1,1,0,0,0,0,0,0,7,0,0,0,0,0,7,0
270530017001013,48,Holland,15,15,1000000US270530017001013,"Block 1013, Block Group 1, Census Tract 17, Hennepin County, Minnesota",41,26,4,0,4,0,0,7,41,41,26,4,0,4,0,0,7,0,0,0,0,0,0,0,0
270531018003001,48,Holland,15,15,1000000US270531018003001,"Block 3001, Block Group 3, Census Tract 1018, Hennepin County, Minnesota",70,35,5,4,0,0,19,7,70,41,24,5,4,0,0,2,6,29,11,0,0,0,0,17,1
270531018002008,48,Holland,15,15,1000000US270531018002008,"Block 2008, Block Group 2, Census Tract 1018, Hennepin County, Minnesota",28,17,0,0,0,0,11,0,28,16,16,0,0,0,0,0,0,12,1,0,0,0,0,11,0
270531018003006,48,Holland,15,15,1000000US270531018003006,"Block 3006, Block Group 3, Census Tract 1018, Hennepin County, Minnesota",28,27,1,0,0,0,0,0,28,24,23,1,0,0,0,0,0,4,4,0,0,0,0,0,0
270531018001019,48,Holland,15,15,1000000US270531018001019,"Block 1019, Block Group 1, Census Tract 1018, Hennepin County, Minnesota",71,55,3,2,0,0,8,3,71,59,55,2,2,0,0,0,0,12,0,1,0,0,0,8,3
270531018002006,48,Holland,15,15,1000000US270531018002006,"Block 2006, Block Group 2, Census Tract 1018, Hennepin County, Minnesota",22,7,5,1,0,0,5,4,22,14,7,5,1,0,0,0,1,8,0,0,0,0,0,5,3
270531018002010,48,Holland,15,15,1000000US270531018002010,"Block 2010, Block Group 2, Census Tract 1018, Hennepin County, Minnesota",72,39,14,6,0,0,8,5,72,51,32,14,5,0,0,0,0,21,7,0,1,0,0,8,5
270531018003009,48,Holland,15,15,1000000US270531018003009,"Block 3009, Block Group 3, Census Tract 1018, Hennepin County, Minnesota",71,50,15,6,0,0,0,0,71,69,50,15,4,0,0,0,0,2,0,0,2,0,0,0,0
270530017001001,48,Holland,15,15,1000000US270530017001001,"Block 1001, Block Group 1, Census Tract 17, Hennepin County, Minnesota",56,14,15,0,0,0,23,4,56,31,12,15,0,0,0,0,4,25,2,0,0,0,0,23,0
270531018001011,48,Holland,15,15,1000000US270531018001011,"Block 1011, Block Group 1, Census Tract 1018, Hennepin County, Minnesota",97,29,19,3,8,0,25,13,97,64,29,19,2,8,0,0,6,33,0,0,1,0,0,25,7
270530017001007,48,Holland,15,15,1000000US270530017001007,"Block 1007, Block Group 1, Census Tract 17, Hennepin County, Minnesota",75,32,29,0,1,0,8,5,75,65,32,28,0,1,0,0,4,10,0,1,0,0,0,8,1
270531018003008,48,Holland,15,15,1000000US270531018003008,"Block 3008, Block Group 3, Census Tract 1018, Hennepin County, Minnesota",36,30,5,0,1,0,0,0,36,36,30,5,0,1,0,0,0,0,0,0,0,0,0,0,0
270530017001008,48,Holland,15,15,1000000US270530017001008,"Block 1008, Block Group 1, Census Tract 17, Hennepin County, Minnesota",52,46,3,3,0,0,0,0,52,50,44,3,3,0,0,0,0,2,2,0,0,0,0,0,0
270531018003003,48,Holland,15,15,1000000US270531018003003,"Block 3003, Block Group 3, Census Tract 1018, Hennepin County, Minnesota",26,19,0,0,5,0,1,1,26,25,19,0,0,5,0,0,1,1,0,0,0,0,0,1,0
270531018001015,48,Holland,15,15,1000000US270531018001015,"Block 1015, Block Group 1, Census Tract 1018, Hennepin County, Minnesota",105,60,8,0,0,0,26,11,105,67,54,8,0,0,0,3,2,38,6,0,0,0,0,23,9
270531018001012,48,Holland,15,15,1000000US270531018001012,"Block 1012, Block Group 1, Census Tract 1018, Hennepin County, Minnesota",80,50,8,3,3,0,0,16,80,67,49,8,3,3,0,0,4,13,1,0,0,0,0,0,12
270531018003018,48,Holland,15,15,1000000US270531018003018,"Block 3018, Block Group 3, Census Tract 1018, Hennepin County, Minnesota",21,16,3,0,1,0,0,1,21,17,15,0,0,1,0,0,1,4,1,3,0,0,0,0,0
270530017001002,48,Holland,15,15,1000000US270530017001002,"Block 1002, Block Group 1, Census Tract 17, Hennepin County, Minnesota",59,41,3,0,0,1,10,4,59,39,32,3,0,0,1,0,3,20,9,0,0,0,0,10,1
270530017001011,48,Holland,15,15,1000000US270530017001011,"Block 1011, Block Group 1, Census Tract 17, Hennepin County, Minnesota",33,31,1,0,0,0,0,1,33,33,31,1,0,0,0,0,1,0,0,0,0,0,0,0,0
270530017001012,48,Holland,15,15,1000000US270530017001012,"Block 1012, Block Group 1, Census Tract 17, Hennepin County, Minnesota",41,28,0,8,0,0,0,5,41,41,28,0,8,0,0,0,5,0,0,0,0,0,0,0,0
270531018002007,48,Holland,15,15,1000000US270531018002007,"Block 2007, Block Group 2, Census Tract 1018, Hennepin County, Minnesota",0,0,0,0,0,0,0,0,0,0,0,0,0,0,0,0,0,0,0,0,0,0,0,0,0
270531018001006,48,Holland,15,15,1000000US270531018001006,"Block 1006, Block Group 1, Census Tract 1018, Hennepin County, Minnesota",64,43,6,6,7,0,1,1,64,58,41,5,4,7,0,0,1,6,2,1,2,0,0,1,0
270531018001018,48,Holland,15,15,1000000US270531018001018,"Block 1018, Block Group 1, Census Tract 1018, Hennepin County, Minnesota",55,39,2,7,0,0,7,0,55,48,39,2,7,0,0,0,0,7,0,0,0,0,0,7,0
270531018001004,48,Holland,15,15,1000000US270531018001004,"Block 1004, Block Group 1, Census Tract 1018, Hennepin County, Minnesota",48,33,0,0,3,0,8,4,48,39,33,0,0,3,0,0,3,9,0,0,0,0,0,8,1
270530017001000,48,Holland,15,15,1000000US270530017001000,"Block 1000, Block Group 1, Census Tract 17, Hennepin County, Minnesota",31,18,1,0,0,0,12,0,31,14,13,1,0,0,0,0,0,17,5,0,0,0,0,12,0
270530017001003,48,Holland,15,15,1000000US270530017001003,"Block 1003, Block Group 1, Census Tract 17, Hennepin County, Minnesota",41,29,6,1,0,0,0,5,41,31,24,6,1,0,0,0,0,10,5,0,0,0,0,0,5
270530017001004,48,Holland,15,15,1000000US270530017001004,"Block 1004, Block Group 1, Census Tract 17, Hennepin County, Minnesota",66,27,10,2,0,0,20,7,66,42,26,10,2,0,0,0,4,24,1,0,0,0,0,20,3
270530017001009,48,Holland,15,15,1000000US270530017001009,"Block 1009, Block Group 1, Census Tract 17, Hennepin County, Minnesota",43,28,7,0,0,0,6,2,43,34,25,7,0,0,0,0,2,9,3,0,0,0,0,6,0
270531018003005,48,Holland,15,15,1000000US270531018003005,"Block 3005, Block Group 3, Census Tract 1018, Hennepin County, Minnesota",45,16,15,0,0,0,14,0,45,23,8,15,0,0,0,0,0,22,8,0,0,0,0,14,0
270531018002005,48,Holland,15,15,1000000US270531018002005,"Block 2005, Block Group 2, Census Tract 1018, Hennepin County, Minnesota",35,20,2,0,0,0,4,9,35,22,20,2,0,0,0,0,0,13,0,0,0,0,0,4,9
270531018002011,48,Holland,15,15,1000000US270531018002011,"Block 2011, Block Group 2, Census Tract 1018, Hennepin County, Minnesota",50,24,18,1,0,0,1,6,50,49,24,18,1,0,0,0,6,1,0,0,0,0,0,1,0
270531018002004,48,Holland,15,15,1000000US270531018002004,"Block 2004, Block Group 2, Census Tract 1018, Hennepin County, Minnesota",32,16,1,0,0,0,13,2,32,19,16,1,0,0,0,0,2,13,0,0,0,0,0,13,0
270531018003012,48,Holland,15,15,1000000US270531018003012,"Block 3012, Block Group 3, Census Tract 1018, Hennepin County, Minnesota",53,33,18,1,0,0,0,1,53,50,33,15,1,0,0,0,1,3,0,3,0,0,0,0,0
270531018001017,48,Holland,15,15,1000000US270531018001017,"Block 1017, Block Group 1, Census Tract 1018, Hennepin County, Minnesota",86,49,17,10,1,0,0,9,86,73,45,17,7,1,0,0,3,13,4,0,3,0,0,0,6
270531018003002,48,Holland,15,15,1000000US270531018003002,"Block 3002, Block Group 3, Census Tract 1018, Hennepin County, Minnesota",38,27,8,2,0,0,0,1,38,37,26,8,2,0,0,0,1,1,1,0,0,0,0,0,0
270531018001007,48,Holland,15,15,1000000US270531018001007,"Block 1007, Block Group 1, Census Tract 1018, Hennepin County, Minnesota",72,45,3,2,0,0,11,11,72,52,42,3,0,0,0,0,7,20,3,0,2,0,0,11,4
270531018001020,48,Holland,15,15,1000000US270531018001020,"Block 1020, Block Group 1, Census Tract 1018, Hennepin County, Minnesota",66,38,0,0,9,0,12,7,66,45,33,0,0,9,0,0,3,21,5,0,0,0,0,12,4
270531018003007,48,Holland,15,15,1000000US270531018003007,"Block 3007, Block Group 3, Census Tract 1018, Hennepin County, Minnesota",67,37,2,0,0,0,26,2,67,43,37,1,0,0,0,3,2,24,0,1,0,0,0,23,0
270531018001005,48,Holland,15,15,1000000US270531018001005,"Block 1005, Block Group 1, Census Tract 1018, Hennepin County, Minnesota",62,28,15,3,0,0,13,3,62,45,28,14,3,0,0,0,0,17,0,1,0,0,0,13,3
270531018002009,48,Holland,15,15,1000000US270531018002009,"Block 2009, Block Group 2, Census Tract 1018, Hennepin County, Minnesota",45,25,4,0,1,0,0,15,45,33,25,4,0,1,0,0,3,12,0,0,0,0,0,0,12
270531018001003,48,Holland,15,15,1000000US270531018001003,"Block 1003, Block Group 1, Census Tract 1018, Hennepin County, Minnesota",36,18,11,0,0,0,2,5,36,30,16,11,0,0,0,0,3,6,2,0,0,0,0,2,2
270531018002003,48,Holland,15,15,1000000US270531018002003,"Block 2003, Block Group 2, Census Tract 1018, Hennepin County, Minnesota",27,9,5,1,0,0,5,7,27,14,9,3,1,0,0,0,1,13,0,2,0,0,0,5,6
270531018002013,48,Holland,15,15,1000000US270531018002013,"Block 2013, Block Group 2, Census Tract 1018, Hennepin County, Minnesota",89,37,5,9,2,0,21,15,89,57,35,5,6,2,0,0,9,32,2,0,3,0,0,21,6
270531018002018,48,Holland,15,15,1000000US270531018002018,"Block 2018, Block Group 2, Census Tract 1018, Hennepin County, Minnesota",50,28,0,6,7,1,3,5,50,39,24,0,6,7,1,0,1,11,4,0,0,0,0,3,4
270531018002021,48,Holland,15,15,1000000US270531018002021,"Block 2021, Block Group 2, Census Tract 1018, Hennepin County, Minnesota",0,0,0,0,0,0,0,0,0,0,0,0,0,0,0,0,0,0,0,0,0,0,0,0,0
270531018002002,48,Holland,15,15,1000000US270531018002002,"Block 2002, Block Group 2, Census Tract 1018, Hennepin County, Minnesota",47,22,10,0,4,0,6,5,47,32,21,10,0,0,0,0,1,15,1,0,0,4,0,6,4
270531018002026,48,Holland,15,15,1000000US270531018002026,"Block 2026, Block Group 2, Census Tract 1018, Hennepin County, Minnesota",56,38,10,0,1,0,6,1,56,44,32,10,0,1,0,0,1,12,6,0,0,0,0,6,0
270531018002023,48,Holland,15,15,1000000US270531018002023,"Block 2023, Block Group 2, Census Tract 1018, Hennepin County, Minnesota",79,36,14,1,0,0,24,4,79,45,26,14,1,0,0,0,4,34,10,0,0,0,0,24,0
270531018002015,48,Holland,15,15,1000000US270531018002015,"Block 2015, Block Group 2, Census Tract 1018, Hennepin County, Minnesota",307,22,251,2,0,0,28,4,307,275,17,251,2,0,0,4,1,32,5,0,0,0,0,24,3
270531018002000,48,Holland,15,15,1000000US270531018002000,"Block 2000, Block Group 2, Census Tract 1018, Hennepin County, Minnesota",20,9,2,0,0,0,9,0,20,11,9,2,0,0,0,0,0,9,0,0,0,0,0,9,0
270531018002014,48,Holland,15,15,1000000US270531018002014,"Block 2014, Block Group 2, Census Tract 1018, Hennepin County, Minnesota",54,41,4,0,4,0,3,2,54,49,41,3,0,4,0,0,1,5,0,1,0,0,0,3,1
270531018002001,48,Holland,15,15,1000000US270531018002001,"Block 2001, Block Group 2, Census Tract 1018, Hennepin County, Minnesota",44,32,2,0,0,0,3,7,44,35,26,2,0,0,0,0,7,9,6,0,0,0,0,3,0
270531018001014,48,Holland,15,15,1000000US270531018001014,"Block 1014, Block Group 1, Census Tract 1018, Hennepin County, Minnesota",163,98,16,2,0,0,8,39,163,108,72,15,2,0,0,0,19,55,26,1,0,0,0,8,20
270531018001013,48,Holland,15,15,1000000US270531018001013,"Block 1013, Block Group 1, Census Tract 1018, Hennepin County, Minnesota",93,68,12,8,0,0,0,5,93,89,65,12,8,0,0,0,4,4,3,0,0,0,0,0,1
270531018002017,48,Holland,15,15,1000000US270531018002017,"Block 2017, Block Group 2, Census Tract 1018, Hennepin County, Minnesota",0,0,0,0,0,0,0,0,0,0,0,0,0,0,0,0,0,0,0,0,0,0,0,0,0
270531018002025,48,Holland,15,15,1000000US270531018002025,"Block 2025, Block Group 2, Census Tract 1018, Hennepin County, Minnesota",31,26,0,5,0,0,0,0,31,31,26,0,5,0,0,0,0,0,0,0,0,0,0,0,0
270531018003014,48,Holland,15,15,1000000US270531018003014,"Block 3014, Block Group 3, Census Tract 1018, Hennepin County, Minnesota",56,43,2,2,0,0,8,1,56,41,35,2,2,0,0,1,1,15,8,0,0,0,0,7,0
270531018003015,48,Holland,15,15,1000000US270531018003015,"Block 3015, Block Group 3, Census Tract 1018, Hennepin County, Minnesota",43,31,0,4,0,0,5,3,43,37,31,0,4,0,0,0,2,6,0,0,0,0,0,5,1
270531018003017,48,Holland,15,15,1000000US270531018003017,"Block 3017, Block Group 3, Census Tract 1018, Hennepin County, Minnesota",64,55,1,0,0,0,0,8,64,62,54,1,0,0,0,0,7,2,1,0,0,0,0,0,1
270531018002016,48,Holland,15,15,1000000US270531018002016,"Block 2016, Block Group 2, Census Tract 1018, Hennepin County, Minnesota",38,34,2,0,1,0,0,1,38,38,34,2,0,1,0,0,1,0,0,0,0,0,0,0,0
270531018002024,48,Holland,15,15,1000000US270531018002024,"Block 2024, Block Group 2, Census Tract 1018, Hennepin County, Minnesota",88,73,7,1,5,0,2,0,88,82,71,5,1,5,0,0,0,6,2,2,0,0,0,2,0
270531018002022,48,Holland,15,15,1000000US270531018002022,"Block 2022, Block Group 2, Census Tract 1018, Hennepin County, Minnesota",39,26,6,0,0,0,3,4,39,28,18,6,0,0,0,0,4,11,8,0,0,0,0,3,0
270531018001016,48,Holland,15,15,1000000US270531018001016,"Block 1016, Block Group 1, Census Tract 1018, Hennepin County, Minnesota",32,18,6,1,0,0,1,6,32,28,18,6,1,0,0,0,3,4,0,0,0,0,0,1,3
270531018002019,48,Holland,15,15,1000000US270531018002019,"Block 2019, Block Group 2, Census Tract 1018, Hennepin County, Minnesota",21,21,0,0,0,0,0,0,21,10,10,0,0,0,0,0,0,11,11,0,0,0,0,0,0
270531018001001,48,Holland,15,15,1000000US270531018001001,"Block 1001, Block Group 1, Census Tract 1018, Hennepin County, Minnesota",124,64,15,2,2,0,13,28,124,83,57,15,2,2,0,0,7,41,7,0,0,0,0,13,21
270530017001005,48,Holland,15,15,1000000US270530017001005,"Block 1005, Block Group 1, Census Tract 17, Hennepin County, Minnesota",34,33,0,0,0,0,1,0,34,33,32,0,0,0,0,1,0,1,1,0,0,0,0,0,0
270531018002020,48,Holland,15,15,1000000US270531018002020,"Block 2020, Block Group 2, Census Tract 1018, Hennepin County, Minnesota",0,0,0,0,0,0,0,0,0,0,0,0,0,0,0,0,0,0,0,0,0,0,0,0,0
270531018003011,48,Holland,15,15,1000000US270531018003011,"Block 3011, Block Group 3, Census Tract 1018, Hennepin County, Minnesota",173,11,161,0,0,0,1,0,173,172,11,161,0,0,0,0,0,1,0,0,0,0,0,1,0
270531018003010,48,Holland,15,15,1000000US270531018003010,"Block 3010, Block Group 3, Census Tract 1018, Hennepin County, Minnesota",47,34,6,3,0,0,4,0,47,42,33,6,3,0,0,0,0,5,1,0,0,0,0,4,0
270531018003016,48,Holland,15,15,1000000US270531018003016,"Block 3016, Block Group 3, Census Tract 1018, Hennepin County, Minnesota",58,25,26,2,0,0,2,3,58,55,25,26,2,0,0,0,2,3,0,0,0,0,0,2,1
270531018002012,48,Holland,15,15,1000000US270531018002012,"Block 2012, Block Group 2, Census Tract 1018, Hennepin County, Minnesota",21,15,3,0,0,0,0,3,21,21,15,3,0,0,0,0,3,0,0,0,0,0,0,0,0
270530017001006,48,Holland,15,15,1000000US270530017001006,"Block 1006, Block Group 1, Census Tract 17, Hennepin County, Minnesota",59,35,12,3,5,0,4,0,59,54,35,12,2,5,0,0,0,5,0,0,1,0,0,4,0
270530017001010,48,Holland,15,15,1000000US270530017001010,"Block 1010, Block Group 1, Census Tract 17, Hennepin County, Minnesota",48,28,1,2,0,0,14,3,48,20,17,1,0,0,0,0,2,28,11,0,2,0,0,14,1
270531018003004,48,Holland,15,15,1000000US270531018003004,"Block 3004, Block Group 3, Census Tract 1018, Hennepin County, Minnesota",74,24,7,1,0,0,36,6,74,18,10,7,0,0,0,0,1,56,14,0,1,0,0,36,5
270531018001008,48,Holland,15,15,1000000US270531018001008,"Block 1008, Block Group 1, Census Tract 1018, Hennepin County, Minnesota",40,33,0,2,2,0,0,3,40,39,33,0,1,2,0,0,3,1,0,0,1,0,0,0,0
270531018003013,48,Holland,15,15,1000000US270531018003013,"Block 3013, Block Group 3, Census Tract 1018, Hennepin County, Minnesota",66,49,0,5,6,0,0,6,66,53,41,0,5,6,0,0,1,13,8,0,0,0,0,0,5
270531018001002,48,Holland,15,15,1000000US270531018001002,"Block 1002, Block Group 1, Census Tract 1018, Hennepin County, Minnesota",82,52,5,0,0,0,25,0,82,57,50,5,0,0,0,2,0,25,2,0,0,0,0,23,0
270531012001005,49,Audubon Park,16,16,1000000US270531012001005,"Block 1005, Block Group 1, Census Tract 1012, Hennepin County, Minnesota",0,0,0,0,0,0,0,0,0,0,0,0,0,0,0,0,0,0,0,0,0,0,0,0,0
270531012001007,49,Audubon Park,16,16,1000000US270531012001007,"Block 1007, Block Group 1, Census Tract 1012, Hennepin County, Minnesota",55,55,0,0,0,0,0,0,55,52,52,0,0,0,0,0,0,3,3,0,0,0,0,0,0
270531012002001,49,Audubon Park,16,16,1000000US270531012002001,"Block 2001, Block Group 2, Census Tract 1012, Hennepin County, Minnesota",39,36,0,0,1,0,0,2,39,38,36,0,0,1,0,0,1,1,0,0,0,0,0,0,1
270531012002013,49,Audubon Park,16,16,1000000US270531012002013,"Block 2013, Block Group 2, Census Tract 1012, Hennepin County, Minnesota",15,14,1,0,0,0,0,0,15,14,14,0,0,0,0,0,0,1,0,1,0,0,0,0,0
270531012001014,49,Audubon Park,16,16,1000000US270531012001014,"Block 1014, Block Group 1, Census Tract 1012, Hennepin County, Minnesota",76,66,1,0,1,0,2,6,76,74,64,1,0,1,0,2,6,2,2,0,0,0,0,0,0
270531012001017,49,Audubon Park,16,16,1000000US270531012001017,"Block 1017, Block Group 1, Census Tract 1012, Hennepin County, Minnesota",0,0,0,0,0,0,0,0,0,0,0,0,0,0,0,0,0,0,0,0,0,0,0,0,0
270531012002002,49,Audubon Park,16,16,1000000US270531012002002,"Block 2002, Block Group 2, Census Tract 1012, Hennepin County, Minnesota",68,60,4,0,0,0,0,4,68,68,60,4,0,0,0,0,4,0,0,0,0,0,0,0,0
270531012002015,49,Audubon Park,16,16,1000000US270531012002015,"Block 2015, Block Group 2, Census Tract 1012, Hennepin County, Minnesota",50,49,0,0,1,0,0,0,50,48,47,0,0,1,0,0,0,2,2,0,0,0,0,0,0
270531012001019,49,Audubon Park,16,16,1000000US270531012001019,"Block 1019, Block Group 1, Census Tract 1012, Hennepin County, Minnesota",13,12,0,0,0,0,0,1,13,13,12,0,0,0,0,0,1,0,0,0,0,0,0,0,0
270531012002016,49,Audubon Park,16,16,1000000US270531012002016,"Block 2016, Block Group 2, Census Tract 1012, Hennepin County, Minnesota",31,28,2,0,1,0,0,0,31,31,28,2,0,1,0,0,0,0,0,0,0,0,0,0,0
270531012001008,49,Audubon Park,16,16,1000000US270531012001008,"Block 1008, Block Group 1, Census Tract 1012, Hennepin County, Minnesota",59,55,0,0,2,0,0,2,59,58,54,0,0,2,0,0,2,1,1,0,0,0,0,0,0
270531012002006,49,Audubon Park,16,16,1000000US270531012002006,"Block 2006, Block Group 2, Census Tract 1012, Hennepin County, Minnesota",32,27,1,0,0,0,0,4,32,31,26,1,0,0,0,0,4,1,1,0,0,0,0,0,0
270531012002004,49,Audubon Park,16,16,1000000US270531012002004,"Block 2004, Block Group 2, Census Tract 1012, Hennepin County, Minnesota",0,0,0,0,0,0,0,0,0,0,0,0,0,0,0,0,0,0,0,0,0,0,0,0,0
270531012001016,49,Audubon Park,16,16,1000000US270531012001016,"Block 1016, Block Group 1, Census Tract 1012, Hennepin County, Minnesota",9,9,0,0,0,0,0,0,9,8,8,0,0,0,0,0,0,1,1,0,0,0,0,0,0
270531012001021,49,Audubon Park,16,16,1000000US270531012001021,"Block 1021, Block Group 1, Census Tract 1012, Hennepin County, Minnesota",66,64,1,0,1,0,0,0,66,63,61,1,0,1,0,0,0,3,3,0,0,0,0,0,0
270531012002000,49,Audubon Park,16,16,1000000US270531012002000,"Block 2000, Block Group 2, Census Tract 1012, Hennepin County, Minnesota",62,57,0,0,2,0,0,3,62,61,57,0,0,2,0,0,2,1,0,0,0,0,0,0,1
270531012001015,49,Audubon Park,16,16,1000000US270531012001015,"Block 1015, Block Group 1, Census Tract 1012, Hennepin County, Minnesota",41,39,0,0,0,0,0,2,41,41,39,0,0,0,0,0,2,0,0,0,0,0,0,0,0
270531012002003,49,Audubon Park,16,16,1000000US270531012002003,"Block 2003, Block Group 2, Census Tract 1012, Hennepin County, Minnesota",75,68,0,1,0,1,3,2,75,71,68,0,1,0,1,0,1,4,0,0,0,0,0,3,1
270531012002018,49,Audubon Park,16,16,1000000US270531012002018,"Block 2018, Block Group 2, Census Tract 1012, Hennepin County, Minnesota",12,11,0,0,0,0,0,1,12,12,11,0,0,0,0,0,1,0,0,0,0,0,0,0,0
270531012002005,49,Audubon Park,16,16,1000000US270531012002005,"Block 2005, Block Group 2, Census Tract 1012, Hennepin County, Minnesota",14,14,0,0,0,0,0,0,14,14,14,0,0,0,0,0,0,0,0,0,0,0,0,0,0
270531012002010,49,Audubon Park,16,16,1000000US270531012002010,"Block 2010, Block Group 2, Census Tract 1012, Hennepin County, Minnesota",24,24,0,0,0,0,0,0,24,24,24,0,0,0,0,0,0,0,0,0,0,0,0,0,0
270530011002012,49,Audubon Park,16,16,1000000US270530011002012,"Block 2012, Block Group 2, Census Tract 11, Hennepin County, Minnesota",61,53,0,0,1,0,0,7,61,61,53,0,0,1,0,0,7,0,0,0,0,0,0,0,0
270531012002011,49,Audubon Park,16,16,1000000US270531012002011,"Block 2011, Block Group 2, Census Tract 1012, Hennepin County, Minnesota",121,111,0,0,6,0,0,4,121,119,110,0,0,6,0,0,3,2,1,0,0,0,0,0,1
270530011002013,49,Audubon Park,16,16,1000000US270530011002013,"Block 2013, Block Group 2, Census Tract 11, Hennepin County, Minnesota",88,76,3,4,2,0,0,3,88,85,73,3,4,2,0,0,3,3,3,0,0,0,0,0,0
270530011002010,49,Audubon Park,16,16,1000000US270530011002010,"Block 2010, Block Group 2, Census Tract 11, Hennepin County, Minnesota",101,74,16,0,0,0,11,0,101,90,74,16,0,0,0,0,0,11,0,0,0,0,0,11,0
270530011001006,49,Audubon Park,16,16,1000000US270530011001006,"Block 1006, Block Group 1, Census Tract 11, Hennepin County, Minnesota",101,65,18,6,0,0,11,1,101,75,55,13,6,0,0,0,1,26,10,5,0,0,0,11,0
270530006013005,49,Audubon Park,16,16,1000000US270530006013005,"Block 3005, Block Group 3, Census Tract 6.01, Hennepin County, Minnesota",51,50,1,0,0,0,0,0,51,51,50,1,0,0,0,0,0,0,0,0,0,0,0,0,0
270531012001013,49,Audubon Park,16,16,1000000US270531012001013,"Block 1013, Block Group 1, Census Tract 1012, Hennepin County, Minnesota",56,50,1,0,0,0,0,5,56,52,50,0,0,0,0,0,2,4,0,1,0,0,0,0,3
270531012001006,49,Audubon Park,16,16,1000000US270531012001006,"Block 1006, Block Group 1, Census Tract 1012, Hennepin County, Minnesota",44,38,1,0,0,0,5,0,44,39,38,1,0,0,0,0,0,5,0,0,0,0,0,5,0
270531012001020,49,Audubon Park,16,16,1000000US270531012001020,"Block 1020, Block Group 1, Census Tract 1012, Hennepin County, Minnesota",73,71,0,0,2,0,0,0,73,72,70,0,0,2,0,0,0,1,1,0,0,0,0,0,0
270531012002017,49,Audubon Park,16,16,1000000US270531012002017,"Block 2017, Block Group 2, Census Tract 1012, Hennepin County, Minnesota",60,47,4,2,1,0,4,2,60,55,46,4,2,1,0,0,2,5,1,0,0,0,0,4,0
270530006013007,49,Audubon Park,16,16,1000000US270530006013007,"Block 3007, Block Group 3, Census Tract 6.01, Hennepin County, Minnesota",75,34,24,0,3,0,12,2,75,60,31,24,0,3,0,0,2,15,3,0,0,0,0,12,0
270530006013008,49,Audubon Park,16,16,1000000US270530006013008,"Block 3008, Block Group 3, Census Tract 6.01, Hennepin County, Minnesota",41,32,2,0,7,0,0,0,41,41,32,2,0,7,0,0,0,0,0,0,0,0,0,0,0
270530006013004,49,Audubon Park,16,16,1000000US270530006013004,"Block 3004, Block Group 3, Census Tract 6.01, Hennepin County, Minnesota",44,27,12,0,4,0,0,1,44,43,26,12,0,4,0,0,1,1,1,0,0,0,0,0,0
270530011002006,49,Audubon Park,16,16,1000000US270530011002006,"Block 2006, Block Group 2, Census Tract 11, Hennepin County, Minnesota",88,61,13,0,5,0,0,9,88,85,58,13,0,5,0,0,9,3,3,0,0,0,0,0,0
270530006013002,49,Audubon Park,16,16,1000000US270530006013002,"Block 3002, Block Group 3, Census Tract 6.01, Hennepin County, Minnesota",0,0,0,0,0,0,0,0,0,0,0,0,0,0,0,0,0,0,0,0,0,0,0,0,0
270530006013001,49,Audubon Park,16,16,1000000US270530006013001,"Block 3001, Block Group 3, Census Tract 6.01, Hennepin County, Minnesota",0,0,0,0,0,0,0,0,0,0,0,0,0,0,0,0,0,0,0,0,0,0,0,0,0
270531012001000,49,Audubon Park,16,16,1000000US270531012001000,"Block 1000, Block Group 1, Census Tract 1012, Hennepin County, Minnesota",32,32,0,0,0,0,0,0,32,32,32,0,0,0,0,0,0,0,0,0,0,0,0,0,0
270530006013017,49,Audubon Park,16,16,1000000US270530006013017,"Block 3017, Block Group 3, Census Tract 6.01, Hennepin County, Minnesota",55,53,0,0,2,0,0,0,55,51,49,0,0,2,0,0,0,4,4,0,0,0,0,0,0
270530011002002,49,Audubon Park,16,16,1000000US270530011002002,"Block 2002, Block Group 2, Census Tract 11, Hennepin County, Minnesota",63,56,3,0,0,0,0,4,63,61,54,3,0,0,0,0,4,2,2,0,0,0,0,0,0
270530011001011,49,Audubon Park,16,16,1000000US270530011001011,"Block 1011, Block Group 1, Census Tract 11, Hennepin County, Minnesota",41,37,0,0,1,0,0,3,41,41,37,0,0,1,0,0,3,0,0,0,0,0,0,0,0
270530011002011,49,Audubon Park,16,16,1000000US270530011002011,"Block 2011, Block Group 2, Census Tract 11, Hennepin County, Minnesota",112,68,8,7,2,0,12,15,112,95,67,8,7,2,0,0,11,17,1,0,0,0,0,12,4
270530006013010,49,Audubon Park,16,16,1000000US270530006013010,"Block 3010, Block Group 3, Census Tract 6.01, Hennepin County, Minnesota",120,49,33,2,2,0,24,10,120,77,39,33,1,2,0,0,2,43,10,0,1,0,0,24,8
270530011001005,49,Audubon Park,16,16,1000000US270530011001005,"Block 1005, Block Group 1, Census Tract 11, Hennepin County, Minnesota",88,64,4,1,9,0,2,8,88,84,62,4,1,9,0,1,7,4,2,0,0,0,0,1,1
270530011001003,49,Audubon Park,16,16,1000000US270530011001003,"Block 1003, Block Group 1, Census Tract 11, Hennepin County, Minnesota",97,65,15,7,0,0,8,2,97,86,62,15,7,0,0,0,2,11,3,0,0,0,0,8,0
270530006013014,49,Audubon Park,16,16,1000000US270530006013014,"Block 3014, Block Group 3, Census Tract 6.01, Hennepin County, Minnesota",40,38,1,0,1,0,0,0,40,40,38,1,0,1,0,0,0,0,0,0,0,0,0,0,0
270530006013015,49,Audubon Park,16,16,1000000US270530006013015,"Block 3015, Block Group 3, Census Tract 6.01, Hennepin County, Minnesota",65,49,7,1,0,0,0,8,65,64,48,7,1,0,0,0,8,1,1,0,0,0,0,0,0
270530011001007,49,Audubon Park,16,16,1000000US270530011001007,"Block 1007, Block Group 1, Census Tract 11, Hennepin County, Minnesota",92,84,1,0,1,0,0,6,92,91,83,1,0,1,0,0,6,1,1,0,0,0,0,0,0
270530011002004,49,Audubon Park,16,16,1000000US270530011002004,"Block 2004, Block Group 2, Census Tract 11, Hennepin County, Minnesota",100,82,11,0,0,0,0,7,100,83,69,11,0,0,0,0,3,17,13,0,0,0,0,0,4
270530006013006,49,Audubon Park,16,16,1000000US270530006013006,"Block 3006, Block Group 3, Census Tract 6.01, Hennepin County, Minnesota",42,35,1,0,0,0,0,6,42,38,35,1,0,0,0,0,2,4,0,0,0,0,0,0,4
270530011001000,49,Audubon Park,16,16,1000000US270530011001000,"Block 1000, Block Group 1, Census Tract 11, Hennepin County, Minnesota",51,32,6,0,4,0,0,9,51,46,30,6,0,4,0,0,6,5,2,0,0,0,0,0,3
270530011002008,49,Audubon Park,16,16,1000000US270530011002008,"Block 2008, Block Group 2, Census Tract 11, Hennepin County, Minnesota",134,59,33,0,10,0,16,16,134,108,55,30,0,10,0,0,13,26,4,3,0,0,0,16,3
270530011001004,49,Audubon Park,16,16,1000000US270530011001004,"Block 1004, Block Group 1, Census Tract 11, Hennepin County, Minnesota",67,52,0,0,1,0,11,3,67,47,44,0,0,1,0,0,2,20,8,0,0,0,0,11,1
270530011001008,49,Audubon Park,16,16,1000000US270530011001008,"Block 1008, Block Group 1, Census Tract 11, Hennepin County, Minnesota",67,63,0,0,0,0,4,0,67,57,53,0,0,0,0,4,0,10,10,0,0,0,0,0,0
270530011002003,49,Audubon Park,16,16,1000000US270530011002003,"Block 2003, Block Group 2, Census Tract 11, Hennepin County, Minnesota",80,73,3,1,1,0,0,2,80,75,69,3,0,1,0,0,2,5,4,0,1,0,0,0,0
270530006013020,49,Audubon Park,16,16,1000000US270530006013020,"Block 3020, Block Group 3, Census Tract 6.01, Hennepin County, Minnesota",59,54,0,0,1,0,4,0,59,55,54,0,0,1,0,0,0,4,0,0,0,0,0,4,0
270531012001002,49,Audubon Park,16,16,1000000US270531012001002,"Block 1002, Block Group 1, Census Tract 1012, Hennepin County, Minnesota",56,50,6,0,0,0,0,0,56,56,50,6,0,0,0,0,0,0,0,0,0,0,0,0,0
270531012001010,49,Audubon Park,16,16,1000000US270531012001010,"Block 1010, Block Group 1, Census Tract 1012, Hennepin County, Minnesota",48,44,2,1,1,0,0,0,48,48,44,2,1,1,0,0,0,0,0,0,0,0,0,0,0
270531012001003,49,Audubon Park,16,16,1000000US270531012001003,"Block 1003, Block Group 1, Census Tract 1012, Hennepin County, Minnesota",67,62,0,0,2,0,0,3,67,63,59,0,0,2,0,0,2,4,3,0,0,0,0,0,1
270531012001009,49,Audubon Park,16,16,1000000US270531012001009,"Block 1009, Block Group 1, Census Tract 1012, Hennepin County, Minnesota",57,54,2,0,1,0,0,0,57,57,54,2,0,1,0,0,0,0,0,0,0,0,0,0,0
270530011002009,49,Audubon Park,16,16,1000000US270530011002009,"Block 2009, Block Group 2, Census Tract 11, Hennepin County, Minnesota",61,47,9,1,0,0,3,1,61,55,47,6,1,0,0,0,1,6,0,3,0,0,0,3,0
270530006013009,49,Audubon Park,16,16,1000000US270530006013009,"Block 3009, Block Group 3, Census Tract 6.01, Hennepin County, Minnesota",58,47,0,4,0,2,0,5,58,57,47,0,4,0,2,0,4,1,0,0,0,0,0,0,1
270530011002005,49,Audubon Park,16,16,1000000US270530011002005,"Block 2005, Block Group 2, Census Tract 11, Hennepin County, Minnesota",86,63,4,1,2,0,7,9,86,68,58,4,1,2,0,0,3,18,5,0,0,0,0,7,6
270531012001001,49,Audubon Park,16,16,1000000US270531012001001,"Block 1001, Block Group 1, Census Tract 1012, Hennepin County, Minnesota",54,41,0,0,10,0,0,3,54,53,40,0,0,10,0,0,3,1,1,0,0,0,0,0,0
270530006013019,49,Audubon Park,16,16,1000000US270530006013019,"Block 3019, Block Group 3, Census Tract 6.01, Hennepin County, Minnesota",58,53,1,0,2,0,0,2,58,56,51,1,0,2,0,0,2,2,2,0,0,0,0,0,0
270530011001009,49,Audubon Park,16,16,1000000US270530011001009,"Block 1009, Block Group 1, Census Tract 11, Hennepin County, Minnesota",63,48,9,0,0,0,1,5,63,60,47,8,0,0,0,0,5,3,1,1,0,0,0,1,0
270531012001012,49,Audubon Park,16,16,1000000US270531012001012,"Block 1012, Block Group 1, Census Tract 1012, Hennepin County, Minnesota",49,45,1,0,1,0,0,2,49,45,43,0,0,1,0,0,1,4,2,1,0,0,0,0,1
270530011002007,49,Audubon Park,16,16,1000000US270530011002007,"Block 2007, Block Group 2, Census Tract 11, Hennepin County, Minnesota",63,43,1,0,0,0,19,0,63,44,43,1,0,0,0,0,0,19,0,0,0,0,0,19,0
270530006013018,49,Audubon Park,16,16,1000000US270530006013018,"Block 3018, Block Group 3, Census Tract 6.01, Hennepin County, Minnesota",61,52,1,5,1,0,0,2,61,61,52,1,5,1,0,0,2,0,0,0,0,0,0,0,0
270530011001010,49,Audubon Park,16,16,1000000US270530011001010,"Block 1010, Block Group 1, Census Tract 11, Hennepin County, Minnesota",65,44,5,0,8,0,8,0,65,56,39,5,0,8,0,4,0,9,5,0,0,0,0,4,0
270530011002001,49,Audubon Park,16,16,1000000US270530011002001,"Block 2001, Block Group 2, Census Tract 11, Hennepin County, Minnesota",85,74,0,0,0,0,3,8,85,74,67,0,0,0,0,0,7,11,7,0,0,0,0,3,1
270531012001011,49,Audubon Park,16,16,1000000US270531012001011,"Block 1011, Block Group 1, Census Tract 1012, Hennepin County, Minnesota",54,47,0,0,1,0,6,0,54,48,47,0,0,1,0,0,0,6,0,0,0,0,0,6,0
270531012002008,49,Audubon Park,16,16,1000000US270531012002008,"Block 2008, Block Group 2, Census Tract 1012, Hennepin County, Minnesota",69,59,0,2,0,0,7,1,69,62,59,0,2,0,0,0,1,7,0,0,0,0,0,7,0
270530006013003,49,Audubon Park,16,16,1000000US270530006013003,"Block 3003, Block Group 3, Census Tract 6.01, Hennepin County, Minnesota",0,0,0,0,0,0,0,0,0,0,0,0,0,0,0,0,0,0,0,0,0,0,0,0,0
270530006013011,49,Audubon Park,16,16,1000000US270530006013011,"Block 3011, Block Group 3, Census Tract 6.01, Hennepin County, Minnesota",78,69,3,1,0,0,2,3,78,73,68,3,1,0,0,0,1,5,1,0,0,0,0,2,2
270530006013012,49,Audubon Park,16,16,1000000US270530006013012,"Block 3012, Block Group 3, Census Tract 6.01, Hennepin County, Minnesota",91,73,4,1,0,0,3,10,91,82,69,4,1,0,0,0,8,9,4,0,0,0,0,3,2
270530011001002,49,Audubon Park,16,16,1000000US270530011001002,"Block 1002, Block Group 1, Census Tract 11, Hennepin County, Minnesota",66,54,5,0,0,0,5,2,66,59,52,5,0,0,0,0,2,7,2,0,0,0,0,5,0
270530006013013,49,Audubon Park,16,16,1000000US270530006013013,"Block 3013, Block Group 3, Census Tract 6.01, Hennepin County, Minnesota",69,62,2,0,0,0,4,1,69,65,62,2,0,0,0,0,1,4,0,0,0,0,0,4,0
270530011002000,49,Audubon Park,16,16,1000000US270530011002000,"Block 2000, Block Group 2, Census Tract 11, Hennepin County, Minnesota",40,39,0,0,0,0,1,0,40,39,39,0,0,0,0,0,0,1,0,0,0,0,0,1,0
270531012002009,49,Audubon Park,16,16,1000000US270531012002009,"Block 2009, Block Group 2, Census Tract 1012, Hennepin County, Minnesota",49,49,0,0,0,0,0,0,49,43,43,0,0,0,0,0,0,6,6,0,0,0,0,0,0
270531012002007,49,Audubon Park,16,16,1000000US270531012002007,"Block 2007, Block Group 2, Census Tract 1012, Hennepin County, Minnesota",42,35,1,3,1,0,0,2,42,42,35,1,3,1,0,0,2,0,0,0,0,0,0,0,0
270531012001018,49,Audubon Park,16,16,1000000US270531012001018,"Block 1018, Block Group 1, Census Tract 1012, Hennepin County, Minnesota",45,43,0,0,2,0,0,0,45,45,43,0,0,2,0,0,0,0,0,0,0,0,0,0,0
270531012002014,49,Audubon Park,16,16,1000000US270531012002014,"Block 2014, Block Group 2, Census Tract 1012, Hennepin County, Minnesota",66,54,1,0,6,0,0,5,66,66,54,1,0,6,0,0,5,0,0,0,0,0,0,0,0
270531012002012,49,Audubon Park,16,16,1000000US270531012002012,"Block 2012, Block Group 2, Census Tract 1012, Hennepin County, Minnesota",13,13,0,0,0,0,0,0,13,13,13,0,0,0,0,0,0,0,0,0,0,0,0,0,0
270530006013021,49,Audubon Park,16,16,1000000US270530006013021,"Block 3021, Block Group 3, Census Tract 6.01, Hennepin County, Minnesota",53,42,5,0,0,0,4,2,53,46,42,4,0,0,0,0,0,7,0,1,0,0,0,4,2
270530011001001,49,Audubon Park,16,16,1000000US270530011001001,"Block 1001, Block Group 1, Census Tract 11, Hennepin County, Minnesota",67,56,2,0,4,0,0,5,67,67,56,2,0,4,0,0,5,0,0,0,0,0,0,0,0
270530006013000,49,Audubon Park,16,16,1000000US270530006013000,"Block 3000, Block Group 3, Census Tract 6.01, Hennepin County, Minnesota",0,0,0,0,0,0,0,0,0,0,0,0,0,0,0,0,0,0,0,0,0,0,0,0,0
270530006013016,49,Audubon Park,16,16,1000000US270530006013016,"Block 3016, Block Group 3, Census Tract 6.01, Hennepin County, Minnesota",63,61,0,0,0,0,0,2,63,63,61,0,0,0,0,0,2,0,0,0,0,0,0,0,0
270531012001004,49,Audubon Park,16,16,1000000US270531012001004,"Block 1004, Block Group 1, Census Tract 1012, Hennepin County, Minnesota",16,14,0,0,0,0,0,2,16,16,14,0,0,0,0,0,2,0,0,0,0,0,0,0,0
270531109002007,50,Regina,74,74,1000000US270531109002007,"Block 2007, Block Group 2, Census Tract 1109, Hennepin County, Minnesota",0,0,0,0,0,0,0,0,0,0,0,0,0,0,0,0,0,0,0,0,0,0,0,0,0
270531109002005,50,Regina,74,74,1000000US270531109002005,"Block 2005, Block Group 2, Census Tract 1109, Hennepin County, Minnesota",40,15,18,0,0,0,7,0,40,32,14,18,0,0,0,0,0,8,1,0,0,0,0,7,0
270531109002011,50,Regina,74,74,1000000US270531109002011,"Block 2011, Block Group 2, Census Tract 1109, Hennepin County, Minnesota",79,27,25,8,1,0,10,8,79,59,27,25,2,1,0,0,4,20,0,0,6,0,0,10,4
270531109003001,50,Regina,74,74,1000000US270531109003001,"Block 3001, Block Group 3, Census Tract 1109, Hennepin County, Minnesota",46,38,4,0,1,0,3,0,46,43,38,4,0,1,0,0,0,3,0,0,0,0,0,3,0
270531109002002,50,Regina,74,74,1000000US270531109002002,"Block 2002, Block Group 2, Census Tract 1109, Hennepin County, Minnesota",87,44,17,0,0,0,23,3,87,64,44,17,0,0,0,0,3,23,0,0,0,0,0,23,0
270531109002009,50,Regina,74,74,1000000US270531109002009,"Block 2009, Block Group 2, Census Tract 1109, Hennepin County, Minnesota",59,17,22,0,9,0,7,4,59,53,16,22,0,9,0,2,4,6,1,0,0,0,0,5,0
270531109002010,50,Regina,74,74,1000000US270531109002010,"Block 2010, Block Group 2, Census Tract 1109, Hennepin County, Minnesota",225,99,96,0,6,0,4,20,225,217,97,94,0,6,0,2,18,8,2,2,0,0,0,2,2
270531109003015,50,Regina,74,74,1000000US270531109003015,"Block 3015, Block Group 3, Census Tract 1109, Hennepin County, Minnesota",58,44,10,0,0,0,0,4,58,54,41,10,0,0,0,0,3,4,3,0,0,0,0,0,1
270531109003000,50,Regina,74,74,1000000US270531109003000,"Block 3000, Block Group 3, Census Tract 1109, Hennepin County, Minnesota",33,21,11,0,1,0,0,0,33,33,21,11,0,1,0,0,0,0,0,0,0,0,0,0,0
270531109002012,50,Regina,74,74,1000000US270531109002012,"Block 2012, Block Group 2, Census Tract 1109, Hennepin County, Minnesota",41,13,17,0,0,0,8,3,41,31,11,17,0,0,0,0,3,10,2,0,0,0,0,8,0
270531109003018,50,Regina,74,74,1000000US270531109003018,"Block 3018, Block Group 3, Census Tract 1109, Hennepin County, Minnesota",48,9,22,0,0,0,17,0,48,26,4,22,0,0,0,0,0,22,5,0,0,0,0,17,0
270531109002017,50,Regina,74,74,1000000US270531109002017,"Block 2017, Block Group 2, Census Tract 1109, Hennepin County, Minnesota",85,32,31,1,6,0,15,0,85,69,31,31,1,6,0,0,0,16,1,0,0,0,0,15,0
270531109003007,50,Regina,74,74,1000000US270531109003007,"Block 3007, Block Group 3, Census Tract 1109, Hennepin County, Minnesota",81,22,23,0,3,0,30,3,81,48,20,22,0,3,0,1,2,33,2,1,0,0,0,29,1
270531109003016,50,Regina,74,74,1000000US270531109003016,"Block 3016, Block Group 3, Census Tract 1109, Hennepin County, Minnesota",58,31,19,0,2,0,1,5,58,57,31,19,0,2,0,0,5,1,0,0,0,0,0,1,0
270531109003004,50,Regina,74,74,1000000US270531109003004,"Block 3004, Block Group 3, Census Tract 1109, Hennepin County, Minnesota",39,12,18,3,0,0,6,0,39,34,12,18,3,0,0,1,0,5,0,0,0,0,0,5,0
270531109002013,50,Regina,74,74,1000000US270531109002013,"Block 2013, Block Group 2, Census Tract 1109, Hennepin County, Minnesota",42,21,11,0,7,0,0,3,42,41,20,11,0,7,0,0,3,1,1,0,0,0,0,0,0
270531109002004,50,Regina,74,74,1000000US270531109002004,"Block 2004, Block Group 2, Census Tract 1109, Hennepin County, Minnesota",33,21,6,0,0,0,0,6,33,29,17,6,0,0,0,0,6,4,4,0,0,0,0,0,0
270531109002006,50,Regina,74,74,1000000US270531109002006,"Block 2006, Block Group 2, Census Tract 1109, Hennepin County, Minnesota",65,18,29,1,2,0,12,3,65,49,14,29,1,2,0,0,3,16,4,0,0,0,0,12,0
270531109003005,50,Regina,74,74,1000000US270531109003005,"Block 3005, Block Group 3, Census Tract 1109, Hennepin County, Minnesota",33,14,19,0,0,0,0,0,33,33,14,19,0,0,0,0,0,0,0,0,0,0,0,0,0
270531109002008,50,Regina,74,74,1000000US270531109002008,"Block 2008, Block Group 2, Census Tract 1109, Hennepin County, Minnesota",64,42,19,0,0,0,0,3,64,57,35,19,0,0,0,0,3,7,7,0,0,0,0,0,0
270531109003013,50,Regina,74,74,1000000US270531109003013,"Block 3013, Block Group 3, Census Tract 1109, Hennepin County, Minnesota",31,17,8,0,6,0,0,0,31,31,17,8,0,6,0,0,0,0,0,0,0,0,0,0,0
270531109003011,50,Regina,74,74,1000000US270531109003011,"Block 3011, Block Group 3, Census Tract 1109, Hennepin County, Minnesota",0,0,0,0,0,0,0,0,0,0,0,0,0,0,0,0,0,0,0,0,0,0,0,0,0
270531109003022,50,Regina,74,74,1000000US270531109003022,"Block 3022, Block Group 3, Census Tract 1109, Hennepin County, Minnesota",73,44,7,0,3,0,14,5,73,54,39,7,0,3,0,0,5,19,5,0,0,0,0,14,0
270531109003009,50,Regina,74,74,1000000US270531109003009,"Block 3009, Block Group 3, Census Tract 1109, Hennepin County, Minnesota",80,34,28,5,3,0,1,9,80,80,34,28,5,3,0,1,9,0,0,0,0,0,0,0,0
270531109002003,50,Regina,74,74,1000000US270531109002003,"Block 2003, Block Group 2, Census Tract 1109, Hennepin County, Minnesota",66,49,9,1,0,0,0,7,66,65,49,9,1,0,0,0,6,1,0,0,0,0,0,0,1
270531109002001,50,Regina,74,74,1000000US270531109002001,"Block 2001, Block Group 2, Census Tract 1109, Hennepin County, Minnesota",74,57,13,4,0,0,0,0,74,70,53,13,4,0,0,0,0,4,4,0,0,0,0,0,0
270531109003020,50,Regina,74,74,1000000US270531109003020,"Block 3020, Block Group 3, Census Tract 1109, Hennepin County, Minnesota",53,22,21,0,0,0,6,4,53,47,22,21,0,0,0,0,4,6,0,0,0,0,0,6,0
270531109003006,50,Regina,74,74,1000000US270531109003006,"Block 3006, Block Group 3, Census Tract 1109, Hennepin County, Minnesota",81,35,29,0,6,0,11,0,81,69,34,29,0,6,0,0,0,12,1,0,0,0,0,11,0
270531109002014,50,Regina,74,74,1000000US270531109002014,"Block 2014, Block Group 2, Census Tract 1109, Hennepin County, Minnesota",70,40,17,6,0,0,6,1,70,57,39,17,0,0,0,0,1,13,1,0,6,0,0,6,0
270531109002015,50,Regina,74,74,1000000US270531109002015,"Block 2015, Block Group 2, Census Tract 1109, Hennepin County, Minnesota",20,14,6,0,0,0,0,0,20,20,14,6,0,0,0,0,0,0,0,0,0,0,0,0,0
270531109003012,50,Regina,74,74,1000000US270531109003012,"Block 3012, Block Group 3, Census Tract 1109, Hennepin County, Minnesota",69,39,21,0,7,0,0,2,69,69,39,21,0,7,0,0,2,0,0,0,0,0,0,0,0
270531109003014,50,Regina,74,74,1000000US270531109003014,"Block 3014, Block Group 3, Census Tract 1109, Hennepin County, Minnesota",57,37,2,2,3,0,13,0,57,44,37,2,2,3,0,0,0,13,0,0,0,0,0,13,0
270531109003017,50,Regina,74,74,1000000US270531109003017,"Block 3017, Block Group 3, Census Tract 1109, Hennepin County, Minnesota",55,19,11,0,0,0,17,8,55,26,9,11,0,0,0,0,6,29,10,0,0,0,0,17,2
270531109003008,50,Regina,74,74,1000000US270531109003008,"Block 3008, Block Group 3, Census Tract 1109, Hennepin County, Minnesota",51,22,16,0,2,0,6,5,51,43,22,16,0,2,0,0,3,8,0,0,0,0,0,6,2
270531109003021,50,Regina,74,74,1000000US270531109003021,"Block 3021, Block Group 3, Census Tract 1109, Hennepin County, Minnesota",28,3,11,0,0,0,14,0,28,14,3,11,0,0,0,0,0,14,0,0,0,0,0,14,0
270531109003003,50,Regina,74,74,1000000US270531109003003,"Block 3003, Block Group 3, Census Tract 1109, Hennepin County, Minnesota",62,43,16,0,0,0,1,2,62,59,41,16,0,0,0,0,2,3,2,0,0,0,0,1,0
270531109003019,50,Regina,74,74,1000000US270531109003019,"Block 3019, Block Group 3, Census Tract 1109, Hennepin County, Minnesota",77,13,33,0,8,0,18,5,77,56,13,33,0,8,0,0,2,21,0,0,0,0,0,18,3
270531109003002,50,Regina,74,74,1000000US270531109003002,"Block 3002, Block Group 3, Census Tract 1109, Hennepin County, Minnesota",46,27,7,1,0,1,10,0,46,35,27,7,0,0,1,0,0,11,0,0,1,0,0,10,0
270531109002016,50,Regina,74,74,1000000US270531109002016,"Block 2016, Block Group 2, Census Tract 1109, Hennepin County, Minnesota",20,12,7,0,0,0,0,1,20,20,12,7,0,0,0,0,1,0,0,0,0,0,0,0,0
270531109002000,50,Regina,74,74,1000000US270531109002000,"Block 2000, Block Group 2, Census Tract 1109, Hennepin County, Minnesota",63,50,3,0,6,0,1,3,63,63,50,3,0,6,0,1,3,0,0,0,0,0,0,0,0
270531109003010,50,Regina,74,74,1000000US270531109003010,"Block 3010, Block Group 3, Census Tract 1109, Hennepin County, Minnesota",0,0,0,0,0,0,0,0,0,0,0,0,0,0,0,0,0,0,0,0,0,0,0,0,0
270530110001010,51,Northrop,75,75,1000000US270530110001010,"Block 1010, Block Group 1, Census Tract 110, Hennepin County, Minnesota",61,52,7,0,0,0,0,2,61,61,52,7,0,0,0,0,2,0,0,0,0,0,0,0,0
270530110002009,51,Northrop,75,75,1000000US270530110002009,"Block 2009, Block Group 2, Census Tract 110, Hennepin County, Minnesota",50,44,0,0,2,0,3,1,50,45,44,0,0,1,0,0,0,5,0,0,0,1,0,3,1
270530110002002,51,Northrop,75,75,1000000US270530110002002,"Block 2002, Block Group 2, Census Tract 110, Hennepin County, Minnesota",80,59,8,13,0,0,0,0,80,69,48,8,13,0,0,0,0,11,11,0,0,0,0,0,0
270530110002010,51,Northrop,75,75,1000000US270530110002010,"Block 2010, Block Group 2, Census Tract 110, Hennepin County, Minnesota",48,47,0,0,1,0,0,0,48,47,46,0,0,1,0,0,0,1,1,0,0,0,0,0,0
270530110001011,51,Northrop,75,75,1000000US270530110001011,"Block 1011, Block Group 1, Census Tract 110, Hennepin County, Minnesota",95,53,16,11,4,0,0,11,95,90,53,16,6,4,0,0,11,5,0,0,5,0,0,0,0
270530110003007,51,Northrop,75,75,1000000US270530110003007,"Block 3007, Block Group 3, Census Tract 110, Hennepin County, Minnesota",64,48,7,3,0,0,0,6,64,62,47,7,2,0,0,0,6,2,1,0,1,0,0,0,0
270530110001009,51,Northrop,75,75,1000000US270530110001009,"Block 1009, Block Group 1, Census Tract 110, Hennepin County, Minnesota",43,38,0,4,0,0,1,0,43,42,38,0,4,0,0,0,0,1,0,0,0,0,0,1,0
270530110002011,51,Northrop,75,75,1000000US270530110002011,"Block 2011, Block Group 2, Census Tract 110, Hennepin County, Minnesota",70,63,0,0,0,0,1,6,70,66,61,0,0,0,0,0,5,4,2,0,0,0,0,1,1
270530110003012,51,Northrop,75,75,1000000US270530110003012,"Block 3012, Block Group 3, Census Tract 110, Hennepin County, Minnesota",0,0,0,0,0,0,0,0,0,0,0,0,0,0,0,0,0,0,0,0,0,0,0,0,0
270530110004007,51,Northrop,75,75,1000000US270530110004007,"Block 4007, Block Group 4, Census Tract 110, Hennepin County, Minnesota",66,17,43,3,0,0,0,3,66,65,16,43,3,0,0,0,3,1,1,0,0,0,0,0,0
270530110004013,51,Northrop,75,75,1000000US270530110004013,"Block 4013, Block Group 4, Census Tract 110, Hennepin County, Minnesota",93,85,0,0,3,0,0,5,93,91,83,0,0,3,0,0,5,2,2,0,0,0,0,0,0
270530110004014,51,Northrop,75,75,1000000US270530110004014,"Block 4014, Block Group 4, Census Tract 110, Hennepin County, Minnesota",52,50,1,0,1,0,0,0,52,50,48,1,0,1,0,0,0,2,2,0,0,0,0,0,0
270530110004015,51,Northrop,75,75,1000000US270530110004015,"Block 4015, Block Group 4, Census Tract 110, Hennepin County, Minnesota",28,24,0,0,1,0,1,2,28,25,22,0,0,1,0,0,2,3,2,0,0,0,0,1,0
270530110004016,51,Northrop,75,75,1000000US270530110004016,"Block 4016, Block Group 4, Census Tract 110, Hennepin County, Minnesota",0,0,0,0,0,0,0,0,0,0,0,0,0,0,0,0,0,0,0,0,0,0,0,0,0
270530117035000,51,Northrop,75,75,1000000US270530117035000,"Block 5000, Block Group 5, Census Tract 117.03, Hennepin County, Minnesota",0,0,0,0,0,0,0,0,0,0,0,0,0,0,0,0,0,0,0,0,0,0,0,0,0
270530110001000,51,Northrop,75,75,1000000US270530110001000,"Block 1000, Block Group 1, Census Tract 110, Hennepin County, Minnesota",70,56,3,0,1,0,0,10,70,68,56,3,0,1,0,0,8,2,0,0,0,0,0,0,2
270530110003009,51,Northrop,75,75,1000000US270530110003009,"Block 3009, Block Group 3, Census Tract 110, Hennepin County, Minnesota",61,60,0,0,0,0,1,0,61,61,60,0,0,0,0,1,0,0,0,0,0,0,0,0,0
270530110001006,51,Northrop,75,75,1000000US270530110001006,"Block 1006, Block Group 1, Census Tract 110, Hennepin County, Minnesota",67,43,14,0,7,0,2,1,67,66,43,14,0,7,0,2,0,1,0,0,0,0,0,0,1
270530110002006,51,Northrop,75,75,1000000US270530110002006,"Block 2006, Block Group 2, Census Tract 110, Hennepin County, Minnesota",57,46,9,0,0,0,0,2,57,57,46,9,0,0,0,0,2,0,0,0,0,0,0,0,0
270530110001001,51,Northrop,75,75,1000000US270530110001001,"Block 1001, Block Group 1, Census Tract 110, Hennepin County, Minnesota",71,62,6,0,1,0,1,1,71,69,62,6,0,1,0,0,0,2,0,0,0,0,0,1,1
270530117035011,51,Northrop,75,75,1000000US270530117035011,"Block 5011, Block Group 5, Census Tract 117.03, Hennepin County, Minnesota",72,68,2,0,0,0,0,2,72,70,68,2,0,0,0,0,0,2,0,0,0,0,0,0,2
270530117035009,51,Northrop,75,75,1000000US270530117035009,"Block 5009, Block Group 5, Census Tract 117.03, Hennepin County, Minnesota",63,59,0,0,2,0,0,2,63,59,56,0,0,2,0,0,1,4,3,0,0,0,0,0,1
270530117035010,51,Northrop,75,75,1000000US270530117035010,"Block 5010, Block Group 5, Census Tract 117.03, Hennepin County, Minnesota",101,87,6,1,0,0,2,5,101,90,84,2,0,0,0,0,4,11,3,4,1,0,0,2,1
270530110004010,51,Northrop,75,75,1000000US270530110004010,"Block 4010, Block Group 4, Census Tract 110, Hennepin County, Minnesota",60,44,5,0,5,0,6,0,60,54,44,5,0,5,0,0,0,6,0,0,0,0,0,6,0
270530110004009,51,Northrop,75,75,1000000US270530110004009,"Block 4009, Block Group 4, Census Tract 110, Hennepin County, Minnesota",61,61,0,0,0,0,0,0,61,61,61,0,0,0,0,0,0,0,0,0,0,0,0,0,0
270530117035007,51,Northrop,75,75,1000000US270530117035007,"Block 5007, Block Group 5, Census Tract 117.03, Hennepin County, Minnesota",58,52,1,0,3,0,0,2,58,57,51,1,0,3,0,0,2,1,1,0,0,0,0,0,0
270530110004018,51,Northrop,75,75,1000000US270530110004018,"Block 4018, Block Group 4, Census Tract 110, Hennepin County, Minnesota",55,53,2,0,0,0,0,0,55,54,52,2,0,0,0,0,0,1,1,0,0,0,0,0,0
270530117035003,51,Northrop,75,75,1000000US270530117035003,"Block 5003, Block Group 5, Census Tract 117.03, Hennepin County, Minnesota",94,88,4,0,1,0,0,1,94,89,83,4,0,1,0,0,1,5,5,0,0,0,0,0,0
270530110002003,51,Northrop,75,75,1000000US270530110002003,"Block 2003, Block Group 2, Census Tract 110, Hennepin County, Minnesota",66,41,7,5,4,0,5,4,66,59,41,7,5,2,0,0,4,7,0,0,0,2,0,5,0
270530117035001,51,Northrop,75,75,1000000US270530117035001,"Block 5001, Block Group 5, Census Tract 117.03, Hennepin County, Minnesota",36,26,1,0,9,0,0,0,36,36,26,1,0,9,0,0,0,0,0,0,0,0,0,0,0
270530110002000,51,Northrop,75,75,1000000US270530110002000,"Block 2000, Block Group 2, Census Tract 110, Hennepin County, Minnesota",74,54,16,0,2,0,0,2,74,74,54,16,0,2,0,0,2,0,0,0,0,0,0,0,0
270530110004002,51,Northrop,75,75,1000000US270530110004002,"Block 4002, Block Group 4, Census Tract 110, Hennepin County, Minnesota",0,0,0,0,0,0,0,0,0,0,0,0,0,0,0,0,0,0,0,0,0,0,0,0,0
270530110004001,51,Northrop,75,75,1000000US270530110004001,"Block 4001, Block Group 4, Census Tract 110, Hennepin County, Minnesota",53,44,2,1,0,0,4,2,53,47,44,2,0,0,0,0,1,6,0,0,1,0,0,4,1
270530110003000,51,Northrop,75,75,1000000US270530110003000,"Block 3000, Block Group 3, Census Tract 110, Hennepin County, Minnesota",60,41,4,1,0,0,8,6,60,47,37,4,1,0,0,0,5,13,4,0,0,0,0,8,1
270530110001005,51,Northrop,75,75,1000000US270530110001005,"Block 1005, Block Group 1, Census Tract 110, Hennepin County, Minnesota",58,27,5,4,4,0,18,0,58,31,18,5,4,4,0,0,0,27,9,0,0,0,0,18,0
270530110002007,51,Northrop,75,75,1000000US270530110002007,"Block 2007, Block Group 2, Census Tract 110, Hennepin County, Minnesota",64,55,1,0,3,0,0,5,64,63,54,1,0,3,0,0,5,1,1,0,0,0,0,0,0
270530110004017,51,Northrop,75,75,1000000US270530110004017,"Block 4017, Block Group 4, Census Tract 110, Hennepin County, Minnesota",64,59,3,0,0,0,0,2,64,64,59,3,0,0,0,0,2,0,0,0,0,0,0,0,0
270530110004020,51,Northrop,75,75,1000000US270530110004020,"Block 4020, Block Group 4, Census Tract 110, Hennepin County, Minnesota",61,57,0,0,2,0,1,1,61,61,57,0,0,2,0,1,1,0,0,0,0,0,0,0,0
270530110004003,51,Northrop,75,75,1000000US270530110004003,"Block 4003, Block Group 4, Census Tract 110, Hennepin County, Minnesota",75,53,3,9,0,0,5,5,75,69,52,3,9,0,0,0,5,6,1,0,0,0,0,5,0
270530117035002,51,Northrop,75,75,1000000US270530117035002,"Block 5002, Block Group 5, Census Tract 117.03, Hennepin County, Minnesota",75,71,3,0,0,0,0,1,75,71,67,3,0,0,0,0,1,4,4,0,0,0,0,0,0
270530110003001,51,Northrop,75,75,1000000US270530110003001,"Block 3001, Block Group 3, Census Tract 110, Hennepin County, Minnesota",61,42,2,1,3,0,13,0,61,50,40,2,1,3,0,4,0,11,2,0,0,0,0,9,0
270530110001004,51,Northrop,75,75,1000000US270530110001004,"Block 1004, Block Group 1, Census Tract 110, Hennepin County, Minnesota",65,39,13,8,1,0,0,4,65,62,36,13,8,1,0,0,4,3,3,0,0,0,0,0,0
270530110002005,51,Northrop,75,75,1000000US270530110002005,"Block 2005, Block Group 2, Census Tract 110, Hennepin County, Minnesota",70,48,4,1,1,0,8,8,70,60,47,4,1,1,0,0,7,10,1,0,0,0,0,8,1
270530110001007,51,Northrop,75,75,1000000US270530110001007,"Block 1007, Block Group 1, Census Tract 110, Hennepin County, Minnesota",72,53,9,2,5,0,0,3,72,72,53,9,2,5,0,0,3,0,0,0,0,0,0,0,0
270530110004008,51,Northrop,75,75,1000000US270530110004008,"Block 4008, Block Group 4, Census Tract 110, Hennepin County, Minnesota",62,62,0,0,0,0,0,0,62,62,62,0,0,0,0,0,0,0,0,0,0,0,0,0,0
270530117035013,51,Northrop,75,75,1000000US270530117035013,"Block 5013, Block Group 5, Census Tract 117.03, Hennepin County, Minnesota",32,31,1,0,0,0,0,0,32,32,31,1,0,0,0,0,0,0,0,0,0,0,0,0,0
270530110004019,51,Northrop,75,75,1000000US270530110004019,"Block 4019, Block Group 4, Census Tract 110, Hennepin County, Minnesota",55,52,0,0,0,0,1,2,55,52,52,0,0,0,0,0,0,3,0,0,0,0,0,1,2
270530117035005,51,Northrop,75,75,1000000US270530117035005,"Block 5005, Block Group 5, Census Tract 117.03, Hennepin County, Minnesota",62,59,1,0,2,0,0,0,62,62,59,1,0,2,0,0,0,0,0,0,0,0,0,0,0
270530117035004,51,Northrop,75,75,1000000US270530117035004,"Block 5004, Block Group 5, Census Tract 117.03, Hennepin County, Minnesota",69,64,1,0,1,0,0,3,69,68,63,1,0,1,0,0,3,1,1,0,0,0,0,0,0
270530110001008,51,Northrop,75,75,1000000US270530110001008,"Block 1008, Block Group 1, Census Tract 110, Hennepin County, Minnesota",74,41,23,0,2,2,0,6,74,72,40,23,0,2,2,0,5,2,1,0,0,0,0,0,1
270530110001003,51,Northrop,75,75,1000000US270530110001003,"Block 1003, Block Group 1, Census Tract 110, Hennepin County, Minnesota",51,27,15,0,2,0,1,6,51,42,21,15,0,2,0,0,4,9,6,0,0,0,0,1,2
270530110002004,51,Northrop,75,75,1000000US270530110002004,"Block 2004, Block Group 2, Census Tract 110, Hennepin County, Minnesota",75,55,8,0,3,0,0,9,75,69,55,8,0,3,0,0,3,6,0,0,0,0,0,0,6
270530110004006,51,Northrop,75,75,1000000US270530110004006,"Block 4006, Block Group 4, Census Tract 110, Hennepin County, Minnesota",61,59,0,0,1,0,0,1,61,61,59,0,0,1,0,0,1,0,0,0,0,0,0,0,0
270530117035014,51,Northrop,75,75,1000000US270530117035014,"Block 5014, Block Group 5, Census Tract 117.03, Hennepin County, Minnesota",23,23,0,0,0,0,0,0,23,23,23,0,0,0,0,0,0,0,0,0,0,0,0,0,0
270530117035015,51,Northrop,75,75,1000000US270530117035015,"Block 5015, Block Group 5, Census Tract 117.03, Hennepin County, Minnesota",0,0,0,0,0,0,0,0,0,0,0,0,0,0,0,0,0,0,0,0,0,0,0,0,0
270530110003010,51,Northrop,75,75,1000000US270530110003010,"Block 3010, Block Group 3, Census Tract 110, Hennepin County, Minnesota",67,55,6,0,5,0,0,1,67,66,54,6,0,5,0,0,1,1,1,0,0,0,0,0,0
270530110004011,51,Northrop,75,75,1000000US270530110004011,"Block 4011, Block Group 4, Census Tract 110, Hennepin County, Minnesota",66,61,0,1,0,0,2,2,66,63,60,0,1,0,0,0,2,3,1,0,0,0,0,2,0
270530110001002,51,Northrop,75,75,1000000US270530110001002,"Block 1002, Block Group 1, Census Tract 110, Hennepin County, Minnesota",63,40,5,0,8,0,7,3,63,51,37,4,0,8,0,0,2,12,3,1,0,0,0,7,1
270530110003004,51,Northrop,75,75,1000000US270530110003004,"Block 3004, Block Group 3, Census Tract 110, Hennepin County, Minnesota",75,57,6,0,7,0,0,5,75,75,57,6,0,7,0,0,5,0,0,0,0,0,0,0,0
270530110003011,51,Northrop,75,75,1000000US270530110003011,"Block 3011, Block Group 3, Census Tract 110, Hennepin County, Minnesota",77,55,1,5,10,0,6,0,77,69,53,1,5,10,0,0,0,8,2,0,0,0,0,6,0
270530110004005,51,Northrop,75,75,1000000US270530110004005,"Block 4005, Block Group 4, Census Tract 110, Hennepin County, Minnesota",70,65,3,0,0,0,0,2,70,70,65,3,0,0,0,0,2,0,0,0,0,0,0,0,0
270530117035012,51,Northrop,75,75,1000000US270530117035012,"Block 5012, Block Group 5, Census Tract 117.03, Hennepin County, Minnesota",50,49,0,0,1,0,0,0,50,50,49,0,0,1,0,0,0,0,0,0,0,0,0,0,0
270530117035006,51,Northrop,75,75,1000000US270530117035006,"Block 5006, Block Group 5, Census Tract 117.03, Hennepin County, Minnesota",50,50,0,0,0,0,0,0,50,50,50,0,0,0,0,0,0,0,0,0,0,0,0,0,0
270530110004004,51,Northrop,75,75,1000000US270530110004004,"Block 4004, Block Group 4, Census Tract 110, Hennepin County, Minnesota",74,53,11,0,4,0,2,4,74,67,49,11,0,4,0,0,3,7,4,0,0,0,0,2,1
270530110004012,51,Northrop,75,75,1000000US270530110004012,"Block 4012, Block Group 4, Census Tract 110, Hennepin County, Minnesota",64,64,0,0,0,0,0,0,64,62,62,0,0,0,0,0,0,2,2,0,0,0,0,0,0
270530110002001,51,Northrop,75,75,1000000US270530110002001,"Block 2001, Block Group 2, Census Tract 110, Hennepin County, Minnesota",75,62,1,9,0,0,2,1,75,62,61,1,0,0,0,0,0,13,1,0,9,0,0,2,1
270530110004000,51,Northrop,75,75,1000000US270530110004000,"Block 4000, Block Group 4, Census Tract 110, Hennepin County, Minnesota",69,63,4,0,0,0,2,0,69,68,63,4,0,0,0,1,0,1,0,0,0,0,0,1,0
270530110003005,51,Northrop,75,75,1000000US270530110003005,"Block 3005, Block Group 3, Census Tract 110, Hennepin County, Minnesota",65,46,11,0,1,0,0,7,65,65,46,11,0,1,0,0,7,0,0,0,0,0,0,0,0
270530117035008,51,Northrop,75,75,1000000US270530117035008,"Block 5008, Block Group 5, Census Tract 117.03, Hennepin County, Minnesota",65,56,3,1,4,0,1,0,65,65,56,3,1,4,0,1,0,0,0,0,0,0,0,0,0
270530110003008,51,Northrop,75,75,1000000US270530110003008,"Block 3008, Block Group 3, Census Tract 110, Hennepin County, Minnesota",54,49,4,0,1,0,0,0,54,54,49,4,0,1,0,0,0,0,0,0,0,0,0,0,0
270530110003003,51,Northrop,75,75,1000000US270530110003003,"Block 3003, Block Group 3, Census Tract 110, Hennepin County, Minnesota",61,54,2,0,1,0,2,2,61,53,50,2,0,1,0,0,0,8,4,0,0,0,0,2,2
270530110003006,51,Northrop,75,75,1000000US270530110003006,"Block 3006, Block Group 3, Census Tract 110, Hennepin County, Minnesota",44,28,6,0,4,0,6,0,44,29,19,6,0,4,0,0,0,15,9,0,0,0,0,6,0
270530110003002,51,Northrop,75,75,1000000US270530110003002,"Block 3002, Block Group 3, Census Tract 110, Hennepin County, Minnesota",61,44,14,0,0,0,0,3,61,61,44,14,0,0,0,0,3,0,0,0,0,0,0,0,0
270530117035016,51,Northrop,75,75,1000000US270530117035016,"Block 5016, Block Group 5, Census Tract 117.03, Hennepin County, Minnesota",15,15,0,0,0,0,0,0,15,15,15,0,0,0,0,0,0,0,0,0,0,0,0,0,0
270530110002008,51,Northrop,75,75,1000000US270530110002008,"Block 2008, Block Group 2, Census Tract 110, Hennepin County, Minnesota",46,33,0,0,2,0,2,9,46,39,32,0,0,2,0,0,5,7,1,0,0,0,0,2,4
270530117035017,51,Northrop,75,75,1000000US270530117035017,"Block 5017, Block Group 5, Census Tract 117.03, Hennepin County, Minnesota",0,0,0,0,0,0,0,0,0,0,0,0,0,0,0,0,0,0,0,0,0,0,0,0,0
270530024001014,52,Sheridan,17,17,1000000US270530024001014,"Block 1014, Block Group 1, Census Tract 24, Hennepin County, Minnesota",0,0,0,0,0,0,0,0,0,0,0,0,0,0,0,0,0,0,0,0,0,0,0,0,0
270530024001017,52,Sheridan,17,17,1000000US270530024001017,"Block 1017, Block Group 1, Census Tract 24, Hennepin County, Minnesota",31,26,1,1,0,0,3,0,31,27,25,1,1,0,0,0,0,4,1,0,0,0,0,3,0
270530024002011,52,Sheridan,17,17,1000000US270530024002011,"Block 2011, Block Group 2, Census Tract 24, Hennepin County, Minnesota",47,41,0,0,1,0,3,2,47,40,37,0,0,1,0,0,2,7,4,0,0,0,0,3,0
270530024002026,52,Sheridan,17,17,1000000US270530024002026,"Block 2026, Block Group 2, Census Tract 24, Hennepin County, Minnesota",114,82,20,0,2,0,1,9,114,100,71,19,0,2,0,0,8,14,11,1,0,0,0,1,1
270530024002021,52,Sheridan,17,17,1000000US270530024002021,"Block 2021, Block Group 2, Census Tract 24, Hennepin County, Minnesota",0,0,0,0,0,0,0,0,0,0,0,0,0,0,0,0,0,0,0,0,0,0,0,0,0
270530024002020,52,Sheridan,17,17,1000000US270530024002020,"Block 2020, Block Group 2, Census Tract 24, Hennepin County, Minnesota",108,102,1,0,1,0,0,4,108,104,100,0,0,1,0,0,3,4,2,1,0,0,0,0,1
270530024001004,52,Sheridan,17,17,1000000US270530024001004,"Block 1004, Block Group 1, Census Tract 24, Hennepin County, Minnesota",0,0,0,0,0,0,0,0,0,0,0,0,0,0,0,0,0,0,0,0,0,0,0,0,0
270530024001001,52,Sheridan,17,17,1000000US270530024001001,"Block 1001, Block Group 1, Census Tract 24, Hennepin County, Minnesota",58,44,3,1,1,0,4,5,58,48,38,3,1,1,0,0,5,10,6,0,0,0,0,4,0
270530024001000,52,Sheridan,17,17,1000000US270530024001000,"Block 1000, Block Group 1, Census Tract 24, Hennepin County, Minnesota",27,17,0,0,0,0,10,0,27,17,17,0,0,0,0,0,0,10,0,0,0,0,0,10,0
270530024001007,52,Sheridan,17,17,1000000US270530024001007,"Block 1007, Block Group 1, Census Tract 24, Hennepin County, Minnesota",19,9,0,0,7,0,2,1,19,10,3,0,0,7,0,0,0,9,6,0,0,0,0,2,1
270530024001008,52,Sheridan,17,17,1000000US270530024001008,"Block 1008, Block Group 1, Census Tract 24, Hennepin County, Minnesota",30,26,4,0,0,0,0,0,30,28,24,4,0,0,0,0,0,2,2,0,0,0,0,0,0
270530024001011,52,Sheridan,17,17,1000000US270530024001011,"Block 1011, Block Group 1, Census Tract 24, Hennepin County, Minnesota",117,93,8,6,0,0,5,5,117,93,79,8,1,0,0,0,5,24,14,0,5,0,0,5,0
270530024001005,52,Sheridan,17,17,1000000US270530024001005,"Block 1005, Block Group 1, Census Tract 24, Hennepin County, Minnesota",0,0,0,0,0,0,0,0,0,0,0,0,0,0,0,0,0,0,0,0,0,0,0,0,0
270530024002007,52,Sheridan,17,17,1000000US270530024002007,"Block 2007, Block Group 2, Census Tract 24, Hennepin County, Minnesota",59,41,17,0,1,0,0,0,59,59,41,17,0,1,0,0,0,0,0,0,0,0,0,0,0
270530024002004,52,Sheridan,17,17,1000000US270530024002004,"Block 2004, Block Group 2, Census Tract 24, Hennepin County, Minnesota",21,16,5,0,0,0,0,0,21,19,14,5,0,0,0,0,0,2,2,0,0,0,0,0,0
270530024001002,52,Sheridan,17,17,1000000US270530024001002,"Block 1002, Block Group 1, Census Tract 24, Hennepin County, Minnesota",6,5,0,0,0,0,1,0,6,0,0,0,0,0,0,0,0,6,5,0,0,0,0,1,0
270530024002006,52,Sheridan,17,17,1000000US270530024002006,"Block 2006, Block Group 2, Census Tract 24, Hennepin County, Minnesota",37,27,2,0,3,0,5,0,37,32,27,2,0,3,0,0,0,5,0,0,0,0,0,5,0
270530024002002,52,Sheridan,17,17,1000000US270530024002002,"Block 2002, Block Group 2, Census Tract 24, Hennepin County, Minnesota",13,13,0,0,0,0,0,0,13,13,13,0,0,0,0,0,0,0,0,0,0,0,0,0,0
270531025001000,52,Sheridan,17,17,1000000US270531025001000,"Block 1000, Block Group 1, Census Tract 1025, Hennepin County, Minnesota",108,86,17,0,0,0,0,5,108,107,85,17,0,0,0,0,5,1,1,0,0,0,0,0,0
270531025001002,52,Sheridan,17,17,1000000US270531025001002,"Block 1002, Block Group 1, Census Tract 1025, Hennepin County, Minnesota",131,78,14,6,0,0,11,22,131,104,77,12,6,0,0,0,9,27,1,2,0,0,0,11,13
270531025001003,52,Sheridan,17,17,1000000US270531025001003,"Block 1003, Block Group 1, Census Tract 1025, Hennepin County, Minnesota",130,83,14,10,4,0,8,11,130,118,80,14,10,4,0,0,10,12,3,0,0,0,0,8,1
270530024002010,52,Sheridan,17,17,1000000US270530024002010,"Block 2010, Block Group 2, Census Tract 24, Hennepin County, Minnesota",67,44,8,4,1,0,4,6,67,60,44,8,3,1,0,0,4,7,0,0,1,0,0,4,2
270531025001001,52,Sheridan,17,17,1000000US270531025001001,"Block 1001, Block Group 1, Census Tract 1025, Hennepin County, Minnesota",17,17,0,0,0,0,0,0,17,17,17,0,0,0,0,0,0,0,0,0,0,0,0,0,0
270530024001015,52,Sheridan,17,17,1000000US270530024001015,"Block 1015, Block Group 1, Census Tract 24, Hennepin County, Minnesota",45,32,1,0,0,0,12,0,45,30,29,1,0,0,0,0,0,15,3,0,0,0,0,12,0
270530024001016,52,Sheridan,17,17,1000000US270530024001016,"Block 1016, Block Group 1, Census Tract 24, Hennepin County, Minnesota",45,28,4,5,8,0,0,0,45,39,22,4,5,8,0,0,0,6,6,0,0,0,0,0,0
270530024001013,52,Sheridan,17,17,1000000US270530024001013,"Block 1013, Block Group 1, Census Tract 24, Hennepin County, Minnesota",245,15,223,0,0,0,0,7,245,245,15,223,0,0,0,0,7,0,0,0,0,0,0,0,0
270530024002025,52,Sheridan,17,17,1000000US270530024002025,"Block 2025, Block Group 2, Census Tract 24, Hennepin County, Minnesota",92,72,10,1,2,0,2,5,92,90,71,10,1,2,0,1,5,2,1,0,0,0,0,1,0
270530024002023,52,Sheridan,17,17,1000000US270530024002023,"Block 2023, Block Group 2, Census Tract 24, Hennepin County, Minnesota",27,18,0,0,0,0,9,0,27,17,17,0,0,0,0,0,0,10,1,0,0,0,0,9,0
270530024002022,52,Sheridan,17,17,1000000US270530024002022,"Block 2022, Block Group 2, Census Tract 24, Hennepin County, Minnesota",57,43,2,0,2,0,5,5,57,44,40,2,0,2,0,0,0,13,3,0,0,0,0,5,5
270530024002013,52,Sheridan,17,17,1000000US270530024002013,"Block 2013, Block Group 2, Census Tract 24, Hennepin County, Minnesota",36,34,1,0,0,0,0,1,36,36,34,1,0,0,0,0,1,0,0,0,0,0,0,0,0
270530024002017,52,Sheridan,17,17,1000000US270530024002017,"Block 2017, Block Group 2, Census Tract 24, Hennepin County, Minnesota",55,49,2,0,2,0,0,2,55,46,41,2,0,2,0,0,1,9,8,0,0,0,0,0,1
270530024002015,52,Sheridan,17,17,1000000US270530024002015,"Block 2015, Block Group 2, Census Tract 24, Hennepin County, Minnesota",20,20,0,0,0,0,0,0,20,20,20,0,0,0,0,0,0,0,0,0,0,0,0,0,0
270530024002024,52,Sheridan,17,17,1000000US270530024002024,"Block 2024, Block Group 2, Census Tract 24, Hennepin County, Minnesota",102,54,40,1,4,1,1,1,102,93,46,39,1,4,1,1,1,9,8,1,0,0,0,0,0
270530024001003,52,Sheridan,17,17,1000000US270530024001003,"Block 1003, Block Group 1, Census Tract 24, Hennepin County, Minnesota",0,0,0,0,0,0,0,0,0,0,0,0,0,0,0,0,0,0,0,0,0,0,0,0,0
270530024001006,52,Sheridan,17,17,1000000US270530024001006,"Block 1006, Block Group 1, Census Tract 24, Hennepin County, Minnesota",2,2,0,0,0,0,0,0,2,2,2,0,0,0,0,0,0,0,0,0,0,0,0,0,0
270531025001004,52,Sheridan,17,17,1000000US270531025001004,"Block 1004, Block Group 1, Census Tract 1025, Hennepin County, Minnesota",148,120,6,4,1,0,8,9,148,131,117,6,1,1,0,0,6,17,3,0,3,0,0,8,3
270530024001010,52,Sheridan,17,17,1000000US270530024001010,"Block 1010, Block Group 1, Census Tract 24, Hennepin County, Minnesota",22,21,0,0,1,0,0,0,22,22,21,0,0,1,0,0,0,0,0,0,0,0,0,0,0
270530024002008,52,Sheridan,17,17,1000000US270530024002008,"Block 2008, Block Group 2, Census Tract 24, Hennepin County, Minnesota",56,40,3,3,0,0,7,3,56,49,38,3,3,0,0,2,3,7,2,0,0,0,0,5,0
270531025001005,52,Sheridan,17,17,1000000US270531025001005,"Block 1005, Block Group 1, Census Tract 1025, Hennepin County, Minnesota",100,89,4,2,1,0,0,4,100,93,84,4,0,1,0,0,4,7,5,0,2,0,0,0,0
270530024001019,52,Sheridan,17,17,1000000US270530024001019,"Block 1019, Block Group 1, Census Tract 24, Hennepin County, Minnesota",0,0,0,0,0,0,0,0,0,0,0,0,0,0,0,0,0,0,0,0,0,0,0,0,0
270530024002001,52,Sheridan,17,17,1000000US270530024002001,"Block 2001, Block Group 2, Census Tract 24, Hennepin County, Minnesota",62,48,12,0,0,0,0,2,62,61,48,11,0,0,0,0,2,1,0,1,0,0,0,0,0
270530024001018,52,Sheridan,17,17,1000000US270530024001018,"Block 1018, Block Group 1, Census Tract 24, Hennepin County, Minnesota",0,0,0,0,0,0,0,0,0,0,0,0,0,0,0,0,0,0,0,0,0,0,0,0,0
270530024002014,52,Sheridan,17,17,1000000US270530024002014,"Block 2014, Block Group 2, Census Tract 24, Hennepin County, Minnesota",60,29,9,0,6,3,10,3,60,49,28,9,0,6,3,0,3,11,1,0,0,0,0,10,0
270530024002027,52,Sheridan,17,17,1000000US270530024002027,"Block 2027, Block Group 2, Census Tract 24, Hennepin County, Minnesota",48,26,3,5,0,0,11,3,48,28,22,3,0,0,0,0,3,20,4,0,5,0,0,11,0
270530024002005,52,Sheridan,17,17,1000000US270530024002005,"Block 2005, Block Group 2, Census Tract 24, Hennepin County, Minnesota",37,23,3,5,0,0,6,0,37,30,23,3,4,0,0,0,0,7,0,0,1,0,0,6,0
270530024002000,52,Sheridan,17,17,1000000US270530024002000,"Block 2000, Block Group 2, Census Tract 24, Hennepin County, Minnesota",38,38,0,0,0,0,0,0,38,38,38,0,0,0,0,0,0,0,0,0,0,0,0,0,0
270530024001012,52,Sheridan,17,17,1000000US270530024001012,"Block 1012, Block Group 1, Census Tract 24, Hennepin County, Minnesota",113,74,26,8,2,0,3,0,113,110,74,26,8,2,0,0,0,3,0,0,0,0,0,3,0
270530024001009,52,Sheridan,17,17,1000000US270530024001009,"Block 1009, Block Group 1, Census Tract 24, Hennepin County, Minnesota",41,32,0,0,1,0,5,3,41,37,32,0,0,1,0,1,3,4,0,0,0,0,0,4,0
270530024002003,52,Sheridan,17,17,1000000US270530024002003,"Block 2003, Block Group 2, Census Tract 24, Hennepin County, Minnesota",26,17,4,0,0,0,0,5,26,26,17,4,0,0,0,0,5,0,0,0,0,0,0,0,0
270530024002009,52,Sheridan,17,17,1000000US270530024002009,"Block 2009, Block Group 2, Census Tract 24, Hennepin County, Minnesota",49,31,4,0,0,0,14,0,49,33,29,4,0,0,0,0,0,16,2,0,0,0,0,14,0
270530024002019,52,Sheridan,17,17,1000000US270530024002019,"Block 2019, Block Group 2, Census Tract 24, Hennepin County, Minnesota",121,84,7,7,0,0,7,16,121,102,81,7,7,0,0,0,7,19,3,0,0,0,0,7,9
270530024002016,52,Sheridan,17,17,1000000US270530024002016,"Block 2016, Block Group 2, Census Tract 24, Hennepin County, Minnesota",19,19,0,0,0,0,0,0,19,16,16,0,0,0,0,0,0,3,3,0,0,0,0,0,0
270530024002012,52,Sheridan,17,17,1000000US270530024002012,"Block 2012, Block Group 2, Census Tract 24, Hennepin County, Minnesota",60,50,0,1,1,0,5,3,60,45,44,0,0,1,0,0,0,15,6,0,1,0,0,5,3
270530024002018,52,Sheridan,17,17,1000000US270530024002018,"Block 2018, Block Group 2, Census Tract 24, Hennepin County, Minnesota",18,17,0,1,0,0,0,0,18,17,16,0,1,0,0,0,0,1,1,0,0,0,0,0,0
270531025003012,53,Logan Park,18,18,1000000US270531025003012,"Block 3012, Block Group 3, Census Tract 1025, Hennepin County, Minnesota",25,22,0,0,0,0,0,3,25,14,11,0,0,0,0,0,3,11,11,0,0,0,0,0,0
270531025002004,53,Logan Park,18,18,1000000US270531025002004,"Block 2004, Block Group 2, Census Tract 1025, Hennepin County, Minnesota",123,95,6,6,0,1,10,5,123,104,92,6,1,0,1,0,4,19,3,0,5,0,0,10,1
270531025003005,53,Logan Park,18,18,1000000US270531025003005,"Block 3005, Block Group 3, Census Tract 1025, Hennepin County, Minnesota",24,15,0,0,0,0,9,0,24,15,15,0,0,0,0,0,0,9,0,0,0,0,0,9,0
270531025003019,53,Logan Park,18,18,1000000US270531025003019,"Block 3019, Block Group 3, Census Tract 1025, Hennepin County, Minnesota",152,103,7,3,10,0,24,5,152,121,101,6,3,6,0,0,5,31,2,1,0,4,0,24,0
270531025003006,53,Logan Park,18,18,1000000US270531025003006,"Block 3006, Block Group 3, Census Tract 1025, Hennepin County, Minnesota",0,0,0,0,0,0,0,0,0,0,0,0,0,0,0,0,0,0,0,0,0,0,0,0,0
270531025003018,53,Logan Park,18,18,1000000US270531025003018,"Block 3018, Block Group 3, Census Tract 1025, Hennepin County, Minnesota",131,95,9,12,0,0,8,7,131,114,95,9,3,0,0,0,7,17,0,0,9,0,0,8,0
270531025003020,53,Logan Park,18,18,1000000US270531025003020,"Block 3020, Block Group 3, Census Tract 1025, Hennepin County, Minnesota",128,81,23,0,2,0,9,13,128,114,77,23,0,2,0,0,12,14,4,0,0,0,0,9,1
270531025002006,53,Logan Park,18,18,1000000US270531025002006,"Block 2006, Block Group 2, Census Tract 1025, Hennepin County, Minnesota",124,95,13,0,7,0,2,7,124,118,93,13,0,7,0,0,5,6,2,0,0,0,0,2,2
270531025003016,53,Logan Park,18,18,1000000US270531025003016,"Block 3016, Block Group 3, Census Tract 1025, Hennepin County, Minnesota",63,34,4,12,2,0,9,2,63,49,32,4,9,2,0,0,2,14,2,0,3,0,0,9,0
270531025002005,53,Logan Park,18,18,1000000US270531025002005,"Block 2005, Block Group 2, Census Tract 1025, Hennepin County, Minnesota",120,82,7,2,12,0,13,4,120,106,82,7,2,12,0,0,3,14,0,0,0,0,0,13,1
270531025003003,53,Logan Park,18,18,1000000US270531025003003,"Block 3003, Block Group 3, Census Tract 1025, Hennepin County, Minnesota",2,1,0,0,0,0,0,1,2,2,1,0,0,0,0,0,1,0,0,0,0,0,0,0,0
270531025003007,53,Logan Park,18,18,1000000US270531025003007,"Block 3007, Block Group 3, Census Tract 1025, Hennepin County, Minnesota",7,5,1,0,0,0,0,1,7,7,5,1,0,0,0,0,1,0,0,0,0,0,0,0,0
270531025002001,53,Logan Park,18,18,1000000US270531025002001,"Block 2001, Block Group 2, Census Tract 1025, Hennepin County, Minnesota",0,0,0,0,0,0,0,0,0,0,0,0,0,0,0,0,0,0,0,0,0,0,0,0,0
270531025002011,53,Logan Park,18,18,1000000US270531025002011,"Block 2011, Block Group 2, Census Tract 1025, Hennepin County, Minnesota",0,0,0,0,0,0,0,0,0,0,0,0,0,0,0,0,0,0,0,0,0,0,0,0,0
270531025002003,53,Logan Park,18,18,1000000US270531025002003,"Block 2003, Block Group 2, Census Tract 1025, Hennepin County, Minnesota",78,61,3,8,3,0,0,3,78,74,60,3,5,3,0,0,3,4,1,0,3,0,0,0,0
270531025003021,53,Logan Park,18,18,1000000US270531025003021,"Block 3021, Block Group 3, Census Tract 1025, Hennepin County, Minnesota",109,81,6,2,0,0,9,11,109,85,69,5,2,0,0,0,9,24,12,1,0,0,0,9,2
270531025003004,53,Logan Park,18,18,1000000US270531025003004,"Block 3004, Block Group 3, Census Tract 1025, Hennepin County, Minnesota",0,0,0,0,0,0,0,0,0,0,0,0,0,0,0,0,0,0,0,0,0,0,0,0,0
270531025002009,53,Logan Park,18,18,1000000US270531025002009,"Block 2009, Block Group 2, Census Tract 1025, Hennepin County, Minnesota",0,0,0,0,0,0,0,0,0,0,0,0,0,0,0,0,0,0,0,0,0,0,0,0,0
270531025003015,53,Logan Park,18,18,1000000US270531025003015,"Block 3015, Block Group 3, Census Tract 1025, Hennepin County, Minnesota",0,0,0,0,0,0,0,0,0,0,0,0,0,0,0,0,0,0,0,0,0,0,0,0,0
270531025003014,53,Logan Park,18,18,1000000US270531025003014,"Block 3014, Block Group 3, Census Tract 1025, Hennepin County, Minnesota",72,62,1,6,2,0,0,1,72,69,61,1,4,2,0,0,1,3,1,0,2,0,0,0,0
270531025003001,53,Logan Park,18,18,1000000US270531025003001,"Block 3001, Block Group 3, Census Tract 1025, Hennepin County, Minnesota",88,46,35,0,0,0,4,3,88,70,33,35,0,0,0,0,2,18,13,0,0,0,0,4,1
270531025003010,53,Logan Park,18,18,1000000US270531025003010,"Block 3010, Block Group 3, Census Tract 1025, Hennepin County, Minnesota",0,0,0,0,0,0,0,0,0,0,0,0,0,0,0,0,0,0,0,0,0,0,0,0,0
270531025002007,53,Logan Park,18,18,1000000US270531025002007,"Block 2007, Block Group 2, Census Tract 1025, Hennepin County, Minnesota",157,86,18,15,8,0,26,4,157,103,68,14,10,7,0,0,4,54,18,4,5,1,0,26,0
270531025002008,53,Logan Park,18,18,1000000US270531025002008,"Block 2008, Block Group 2, Census Tract 1025, Hennepin County, Minnesota",107,89,9,0,4,0,0,5,107,92,74,9,0,4,0,0,5,15,15,0,0,0,0,0,0
270531025003008,53,Logan Park,18,18,1000000US270531025003008,"Block 3008, Block Group 3, Census Tract 1025, Hennepin County, Minnesota",95,46,18,1,0,0,26,4,95,48,26,18,1,0,0,0,3,47,20,0,0,0,0,26,1
270531025003013,53,Logan Park,18,18,1000000US270531025003013,"Block 3013, Block Group 3, Census Tract 1025, Hennepin County, Minnesota",0,0,0,0,0,0,0,0,0,0,0,0,0,0,0,0,0,0,0,0,0,0,0,0,0
270531025002002,53,Logan Park,18,18,1000000US270531025002002,"Block 2002, Block Group 2, Census Tract 1025, Hennepin County, Minnesota",128,104,11,0,3,0,7,3,128,121,104,11,0,3,0,0,3,7,0,0,0,0,0,7,0
270531025002010,53,Logan Park,18,18,1000000US270531025002010,"Block 2010, Block Group 2, Census Tract 1025, Hennepin County, Minnesota",0,0,0,0,0,0,0,0,0,0,0,0,0,0,0,0,0,0,0,0,0,0,0,0,0
270531025002000,53,Logan Park,18,18,1000000US270531025002000,"Block 2000, Block Group 2, Census Tract 1025, Hennepin County, Minnesota",22,18,0,0,2,0,0,2,22,22,18,0,0,2,0,0,2,0,0,0,0,0,0,0,0
270531025003000,53,Logan Park,18,18,1000000US270531025003000,"Block 3000, Block Group 3, Census Tract 1025, Hennepin County, Minnesota",91,45,34,6,0,0,1,5,91,84,38,34,6,0,0,1,5,7,7,0,0,0,0,0,0
270531025003009,53,Logan Park,18,18,1000000US270531025003009,"Block 3009, Block Group 3, Census Tract 1025, Hennepin County, Minnesota",81,40,5,3,3,0,12,18,81,47,21,5,3,3,0,0,15,34,19,0,0,0,0,12,3
270531025003002,53,Logan Park,18,18,1000000US270531025003002,"Block 3002, Block Group 3, Census Tract 1025, Hennepin County, Minnesota",48,34,1,1,0,0,6,6,48,40,34,1,1,0,0,0,4,8,0,0,0,0,0,6,2
270531025003011,53,Logan Park,18,18,1000000US270531025003011,"Block 3011, Block Group 3, Census Tract 1025, Hennepin County, Minnesota",0,0,0,0,0,0,0,0,0,0,0,0,0,0,0,0,0,0,0,0,0,0,0,0,0
270531025003017,53,Logan Park,18,18,1000000US270531025003017,"Block 3017, Block Group 3, Census Tract 1025, Hennepin County, Minnesota",204,121,64,7,2,0,0,10,204,199,118,63,7,2,0,0,9,5,3,1,0,0,0,0,1
270531012003020,54,Windom Park,19,19,1000000US270531012003020,"Block 3020, Block Group 3, Census Tract 1012, Hennepin County, Minnesota",0,0,0,0,0,0,0,0,0,0,0,0,0,0,0,0,0,0,0,0,0,0,0,0,0
270531012003026,54,Windom Park,19,19,1000000US270531012003026,"Block 3026, Block Group 3, Census Tract 1012, Hennepin County, Minnesota",61,55,0,1,1,0,0,4,61,61,55,0,1,1,0,0,4,0,0,0,0,0,0,0,0
270531012004015,54,Windom Park,19,19,1000000US270531012004015,"Block 4015, Block Group 4, Census Tract 1012, Hennepin County, Minnesota",112,99,0,0,7,0,0,6,112,111,98,0,0,7,0,0,6,1,1,0,0,0,0,0,0
270531012004006,54,Windom Park,19,19,1000000US270531012004006,"Block 4006, Block Group 4, Census Tract 1012, Hennepin County, Minnesota",70,58,4,2,0,0,6,0,70,64,58,4,2,0,0,0,0,6,0,0,0,0,0,6,0
270531012004004,54,Windom Park,19,19,1000000US270531012004004,"Block 4004, Block Group 4, Census Tract 1012, Hennepin County, Minnesota",65,58,0,2,2,0,0,3,65,64,58,0,2,2,0,0,2,1,0,0,0,0,0,0,1
270531012003008,54,Windom Park,19,19,1000000US270531012003008,"Block 3008, Block Group 3, Census Tract 1012, Hennepin County, Minnesota",72,62,0,0,6,0,0,4,72,72,62,0,0,6,0,0,4,0,0,0,0,0,0,0,0
270531012003017,54,Windom Park,19,19,1000000US270531012003017,"Block 3017, Block Group 3, Census Tract 1012, Hennepin County, Minnesota",15,13,2,0,0,0,0,0,15,15,13,2,0,0,0,0,0,0,0,0,0,0,0,0,0
270531012004003,54,Windom Park,19,19,1000000US270531012004003,"Block 4003, Block Group 4, Census Tract 1012, Hennepin County, Minnesota",54,53,0,0,1,0,0,0,54,54,53,0,0,1,0,0,0,0,0,0,0,0,0,0,0
270531012003014,54,Windom Park,19,19,1000000US270531012003014,"Block 3014, Block Group 3, Census Tract 1012, Hennepin County, Minnesota",76,72,0,1,2,0,0,1,76,75,71,0,1,2,0,0,1,1,1,0,0,0,0,0,0
270531012004002,54,Windom Park,19,19,1000000US270531012004002,"Block 4002, Block Group 4, Census Tract 1012, Hennepin County, Minnesota",57,52,3,2,0,0,0,0,57,55,50,3,2,0,0,0,0,2,2,0,0,0,0,0,0
270531012003011,54,Windom Park,19,19,1000000US270531012003011,"Block 3011, Block Group 3, Census Tract 1012, Hennepin County, Minnesota",64,61,1,0,1,0,0,1,64,62,59,1,0,1,0,0,1,2,2,0,0,0,0,0,0
270531012003009,54,Windom Park,19,19,1000000US270531012003009,"Block 3009, Block Group 3, Census Tract 1012, Hennepin County, Minnesota",53,47,1,0,1,0,1,3,53,51,46,1,0,1,0,0,3,2,1,0,0,0,0,1,0
270531012004012,54,Windom Park,19,19,1000000US270531012004012,"Block 4012, Block Group 4, Census Tract 1012, Hennepin County, Minnesota",176,91,29,4,14,0,28,10,176,135,84,29,3,14,0,0,5,41,7,0,1,0,0,28,5
270531012004014,54,Windom Park,19,19,1000000US270531012004014,"Block 4014, Block Group 4, Census Tract 1012, Hennepin County, Minnesota",66,57,0,0,4,0,0,5,66,63,55,0,0,4,0,0,4,3,2,0,0,0,0,0,1
270531012003027,54,Windom Park,19,19,1000000US270531012003027,"Block 3027, Block Group 3, Census Tract 1012, Hennepin County, Minnesota",72,69,1,0,0,0,0,2,72,72,69,1,0,0,0,0,2,0,0,0,0,0,0,0,0
270531012003013,54,Windom Park,19,19,1000000US270531012003013,"Block 3013, Block Group 3, Census Tract 1012, Hennepin County, Minnesota",53,49,0,0,3,0,0,1,53,51,48,0,0,3,0,0,0,2,1,0,0,0,0,0,1
270531012003024,54,Windom Park,19,19,1000000US270531012003024,"Block 3024, Block Group 3, Census Tract 1012, Hennepin County, Minnesota",57,53,0,0,1,0,2,1,57,51,49,0,0,1,0,0,1,6,4,0,0,0,0,2,0
270531012004016,54,Windom Park,19,19,1000000US270531012004016,"Block 4016, Block Group 4, Census Tract 1012, Hennepin County, Minnesota",0,0,0,0,0,0,0,0,0,0,0,0,0,0,0,0,0,0,0,0,0,0,0,0,0
270531012003018,54,Windom Park,19,19,1000000US270531012003018,"Block 3018, Block Group 3, Census Tract 1012, Hennepin County, Minnesota",81,68,6,1,0,0,5,1,81,75,68,6,1,0,0,0,0,6,0,0,0,0,0,5,1
270531019001015,54,Windom Park,19,19,1000000US270531019001015,"Block 1015, Block Group 1, Census Tract 1019, Hennepin County, Minnesota",72,58,8,1,4,0,0,1,72,68,54,8,1,4,0,0,1,4,4,0,0,0,0,0,0
270531012004001,54,Windom Park,19,19,1000000US270531012004001,"Block 4001, Block Group 4, Census Tract 1012, Hennepin County, Minnesota",50,48,0,1,0,0,1,0,50,49,48,0,1,0,0,0,0,1,0,0,0,0,0,1,0
270531012003004,54,Windom Park,19,19,1000000US270531012003004,"Block 3004, Block Group 3, Census Tract 1012, Hennepin County, Minnesota",43,43,0,0,0,0,0,0,43,40,40,0,0,0,0,0,0,3,3,0,0,0,0,0,0
270531019001000,54,Windom Park,19,19,1000000US270531019001000,"Block 1000, Block Group 1, Census Tract 1019, Hennepin County, Minnesota",63,49,4,0,7,0,0,3,63,61,49,3,0,7,0,0,2,2,0,1,0,0,0,0,1
270531019001007,54,Windom Park,19,19,1000000US270531019001007,"Block 1007, Block Group 1, Census Tract 1019, Hennepin County, Minnesota",95,77,7,1,2,0,3,5,95,90,74,7,1,2,0,1,5,5,3,0,0,0,0,2,0
270531012003025,54,Windom Park,19,19,1000000US270531012003025,"Block 3025, Block Group 3, Census Tract 1012, Hennepin County, Minnesota",52,43,7,0,1,0,1,0,52,52,43,7,0,1,0,1,0,0,0,0,0,0,0,0,0
270531012003028,54,Windom Park,19,19,1000000US270531012003028,"Block 3028, Block Group 3, Census Tract 1012, Hennepin County, Minnesota",35,33,0,0,1,0,0,1,35,32,30,0,0,1,0,0,1,3,3,0,0,0,0,0,0
270531012003000,54,Windom Park,19,19,1000000US270531012003000,"Block 3000, Block Group 3, Census Tract 1012, Hennepin County, Minnesota",0,0,0,0,0,0,0,0,0,0,0,0,0,0,0,0,0,0,0,0,0,0,0,0,0
270531019001014,54,Windom Park,19,19,1000000US270531019001014,"Block 1014, Block Group 1, Census Tract 1019, Hennepin County, Minnesota",51,36,0,0,2,0,10,3,51,38,33,0,0,2,0,0,3,13,3,0,0,0,0,10,0
270531012003015,54,Windom Park,19,19,1000000US270531012003015,"Block 3015, Block Group 3, Census Tract 1012, Hennepin County, Minnesota",68,67,0,0,0,0,0,1,68,64,63,0,0,0,0,0,1,4,4,0,0,0,0,0,0
270531012003016,54,Windom Park,19,19,1000000US270531012003016,"Block 3016, Block Group 3, Census Tract 1012, Hennepin County, Minnesota",0,0,0,0,0,0,0,0,0,0,0,0,0,0,0,0,0,0,0,0,0,0,0,0,0
270531012003006,54,Windom Park,19,19,1000000US270531012003006,"Block 3006, Block Group 3, Census Tract 1012, Hennepin County, Minnesota",0,0,0,0,0,0,0,0,0,0,0,0,0,0,0,0,0,0,0,0,0,0,0,0,0
270531012003001,54,Windom Park,19,19,1000000US270531012003001,"Block 3001, Block Group 3, Census Tract 1012, Hennepin County, Minnesota",32,30,0,0,0,0,0,2,32,32,30,0,0,0,0,0,2,0,0,0,0,0,0,0,0
270531012003021,54,Windom Park,19,19,1000000US270531012003021,"Block 3021, Block Group 3, Census Tract 1012, Hennepin County, Minnesota",10,10,0,0,0,0,0,0,10,10,10,0,0,0,0,0,0,0,0,0,0,0,0,0,0
270531019001008,54,Windom Park,19,19,1000000US270531019001008,"Block 1008, Block Group 1, Census Tract 1019, Hennepin County, Minnesota",54,47,0,0,5,0,0,2,54,54,47,0,0,5,0,0,2,0,0,0,0,0,0,0,0
270531012004007,54,Windom Park,19,19,1000000US270531012004007,"Block 4007, Block Group 4, Census Tract 1012, Hennepin County, Minnesota",76,51,2,1,1,0,11,10,76,58,50,2,1,1,0,0,4,18,1,0,0,0,0,11,6
270531012004009,54,Windom Park,19,19,1000000US270531012004009,"Block 4009, Block Group 4, Census Tract 1012, Hennepin County, Minnesota",73,39,24,2,2,0,0,6,73,72,39,24,2,2,0,0,5,1,0,0,0,0,0,0,1
270531012003002,54,Windom Park,19,19,1000000US270531012003002,"Block 3002, Block Group 3, Census Tract 1012, Hennepin County, Minnesota",30,30,0,0,0,0,0,0,30,30,30,0,0,0,0,0,0,0,0,0,0,0,0,0,0
270531019001009,54,Windom Park,19,19,1000000US270531019001009,"Block 1009, Block Group 1, Census Tract 1019, Hennepin County, Minnesota",64,53,4,2,2,0,1,2,64,62,53,4,1,2,0,0,2,2,0,0,1,0,0,1,0
270531019002003,54,Windom Park,19,19,1000000US270531019002003,"Block 2003, Block Group 2, Census Tract 1019, Hennepin County, Minnesota",47,25,4,3,0,0,13,2,47,30,22,4,2,0,0,0,2,17,3,0,1,0,0,13,0
270531019002005,54,Windom Park,19,19,1000000US270531019002005,"Block 2005, Block Group 2, Census Tract 1019, Hennepin County, Minnesota",68,48,2,0,2,0,8,8,68,57,48,2,0,2,0,0,5,11,0,0,0,0,0,8,3
270531019001011,54,Windom Park,19,19,1000000US270531019001011,"Block 1011, Block Group 1, Census Tract 1019, Hennepin County, Minnesota",95,61,5,4,4,0,7,14,95,84,60,5,4,4,0,0,11,11,1,0,0,0,0,7,3
270531019001012,54,Windom Park,19,19,1000000US270531019001012,"Block 1012, Block Group 1, Census Tract 1019, Hennepin County, Minnesota",76,62,0,5,8,0,0,1,76,71,57,0,5,8,0,0,1,5,5,0,0,0,0,0,0
270531012004011,54,Windom Park,19,19,1000000US270531012004011,"Block 4011, Block Group 4, Census Tract 1012, Hennepin County, Minnesota",184,82,64,3,11,0,9,15,184,146,62,64,3,11,0,0,6,38,20,0,0,0,0,9,9
270531012004013,54,Windom Park,19,19,1000000US270531012004013,"Block 4013, Block Group 4, Census Tract 1012, Hennepin County, Minnesota",61,36,7,1,11,1,2,3,61,59,36,7,1,11,1,0,3,2,0,0,0,0,0,2,0
270531019002001,54,Windom Park,19,19,1000000US270531019002001,"Block 2001, Block Group 2, Census Tract 1019, Hennepin County, Minnesota",62,30,15,4,1,0,5,7,62,53,30,15,4,1,0,0,3,9,0,0,0,0,0,5,4
270531019002008,54,Windom Park,19,19,1000000US270531019002008,"Block 2008, Block Group 2, Census Tract 1019, Hennepin County, Minnesota",327,184,115,5,11,0,4,8,327,319,178,115,5,11,0,2,8,8,6,0,0,0,0,2,0
270531019003009,54,Windom Park,19,19,1000000US270531019003009,"Block 3009, Block Group 3, Census Tract 1019, Hennepin County, Minnesota",199,153,28,2,4,0,5,7,199,182,143,27,2,4,0,0,6,17,10,1,0,0,0,5,1
270531019002002,54,Windom Park,19,19,1000000US270531019002002,"Block 2002, Block Group 2, Census Tract 1019, Hennepin County, Minnesota",25,19,1,0,2,0,3,0,25,15,12,1,0,2,0,0,0,10,7,0,0,0,0,3,0
270531019002006,54,Windom Park,19,19,1000000US270531019002006,"Block 2006, Block Group 2, Census Tract 1019, Hennepin County, Minnesota",36,29,2,1,3,0,0,1,36,33,26,2,1,3,0,0,1,3,3,0,0,0,0,0,0
270531019003002,54,Windom Park,19,19,1000000US270531019003002,"Block 3002, Block Group 3, Census Tract 1019, Hennepin County, Minnesota",99,35,10,0,0,5,45,4,99,42,23,8,0,0,5,4,2,57,12,2,0,0,0,41,2
270531019003008,54,Windom Park,19,19,1000000US270531019003008,"Block 3008, Block Group 3, Census Tract 1019, Hennepin County, Minnesota",43,28,5,4,0,0,0,6,43,42,27,5,4,0,0,0,6,1,1,0,0,0,0,0,0
270531019002004,54,Windom Park,19,19,1000000US270531019002004,"Block 2004, Block Group 2, Census Tract 1019, Hennepin County, Minnesota",88,67,0,1,1,0,12,7,88,65,61,0,1,1,0,0,2,23,6,0,0,0,0,12,5
270531019002000,54,Windom Park,19,19,1000000US270531019002000,"Block 2000, Block Group 2, Census Tract 1019, Hennepin County, Minnesota",42,32,5,0,0,0,0,5,42,42,32,5,0,0,0,0,5,0,0,0,0,0,0,0,0
270531019003001,54,Windom Park,19,19,1000000US270531019003001,"Block 3001, Block Group 3, Census Tract 1019, Hennepin County, Minnesota",96,35,23,4,0,0,22,12,96,62,28,23,0,0,0,0,11,34,7,0,4,0,0,22,1
270531019003003,54,Windom Park,19,19,1000000US270531019003003,"Block 3003, Block Group 3, Census Tract 1019, Hennepin County, Minnesota",42,15,13,0,2,0,12,0,42,18,6,10,0,2,0,0,0,24,9,3,0,0,0,12,0
270531012003007,54,Windom Park,19,19,1000000US270531012003007,"Block 3007, Block Group 3, Census Tract 1012, Hennepin County, Minnesota",71,63,0,0,3,0,4,1,71,67,63,0,0,3,0,0,1,4,0,0,0,0,0,4,0
270531012003005,54,Windom Park,19,19,1000000US270531012003005,"Block 3005, Block Group 3, Census Tract 1012, Hennepin County, Minnesota",44,37,2,1,1,1,0,2,44,44,37,2,1,1,1,0,2,0,0,0,0,0,0,0,0
270531012004000,54,Windom Park,19,19,1000000US270531012004000,"Block 4000, Block Group 4, Census Tract 1012, Hennepin County, Minnesota",0,0,0,0,0,0,0,0,0,0,0,0,0,0,0,0,0,0,0,0,0,0,0,0,0
270531019003007,54,Windom Park,19,19,1000000US270531019003007,"Block 3007, Block Group 3, Census Tract 1019, Hennepin County, Minnesota",60,44,6,6,0,0,1,3,60,59,44,6,6,0,0,0,3,1,0,0,0,0,0,1,0
270531019003011,54,Windom Park,19,19,1000000US270531019003011,"Block 3011, Block Group 3, Census Tract 1019, Hennepin County, Minnesota",39,28,0,0,2,0,9,0,39,30,28,0,0,2,0,0,0,9,0,0,0,0,0,9,0
270531019001002,54,Windom Park,19,19,1000000US270531019001002,"Block 1002, Block Group 1, Census Tract 1019, Hennepin County, Minnesota",74,61,4,0,0,0,8,1,74,66,61,4,0,0,0,0,1,8,0,0,0,0,0,8,0
270531019001005,54,Windom Park,19,19,1000000US270531019001005,"Block 1005, Block Group 1, Census Tract 1019, Hennepin County, Minnesota",67,67,0,0,0,0,0,0,67,62,62,0,0,0,0,0,0,5,5,0,0,0,0,0,0
270531012004008,54,Windom Park,19,19,1000000US270531012004008,"Block 4008, Block Group 4, Census Tract 1012, Hennepin County, Minnesota",68,56,2,2,6,0,2,0,68,64,54,2,2,6,0,0,0,4,2,0,0,0,0,2,0
270531019001013,54,Windom Park,19,19,1000000US270531019001013,"Block 1013, Block Group 1, Census Tract 1019, Hennepin County, Minnesota",70,51,5,0,9,0,0,5,70,60,42,5,0,8,0,0,5,10,9,0,0,1,0,0,0
270531019002007,54,Windom Park,19,19,1000000US270531019002007,"Block 2007, Block Group 2, Census Tract 1019, Hennepin County, Minnesota",69,56,6,3,1,0,1,2,69,66,55,5,3,1,0,0,2,3,1,1,0,0,0,1,0
270531019001001,54,Windom Park,19,19,1000000US270531019001001,"Block 1001, Block Group 1, Census Tract 1019, Hennepin County, Minnesota",75,61,7,0,0,0,0,7,75,75,61,7,0,0,0,0,7,0,0,0,0,0,0,0,0
270531019001006,54,Windom Park,19,19,1000000US270531019001006,"Block 1006, Block Group 1, Census Tract 1019, Hennepin County, Minnesota",54,46,1,0,6,0,0,1,54,53,46,0,0,6,0,0,1,1,0,1,0,0,0,0,0
270531012003019,54,Windom Park,19,19,1000000US270531012003019,"Block 3019, Block Group 3, Census Tract 1012, Hennepin County, Minnesota",79,61,12,1,0,0,4,1,79,72,59,12,0,0,0,0,1,7,2,0,1,0,0,4,0
270531012004010,54,Windom Park,19,19,1000000US270531012004010,"Block 4010, Block Group 4, Census Tract 1012, Hennepin County, Minnesota",277,103,83,20,5,0,44,22,277,186,81,78,12,5,0,0,10,91,22,5,8,0,0,44,12
270531019001003,54,Windom Park,19,19,1000000US270531019001003,"Block 1003, Block Group 1, Census Tract 1019, Hennepin County, Minnesota",89,60,4,4,0,0,4,17,89,73,60,4,4,0,0,2,3,16,0,0,0,0,0,2,14
270531019003005,54,Windom Park,19,19,1000000US270531019003005,"Block 3005, Block Group 3, Census Tract 1019, Hennepin County, Minnesota",60,46,6,0,6,0,2,0,60,57,45,6,0,6,0,0,0,3,1,0,0,0,0,2,0
270531012003003,54,Windom Park,19,19,1000000US270531012003003,"Block 3003, Block Group 3, Census Tract 1012, Hennepin County, Minnesota",59,56,0,3,0,0,0,0,59,58,56,0,2,0,0,0,0,1,0,0,1,0,0,0,0
270531012004005,54,Windom Park,19,19,1000000US270531012004005,"Block 4005, Block Group 4, Census Tract 1012, Hennepin County, Minnesota",52,50,1,0,1,0,0,0,52,52,50,1,0,1,0,0,0,0,0,0,0,0,0,0,0
270531012003010,54,Windom Park,19,19,1000000US270531012003010,"Block 3010, Block Group 3, Census Tract 1012, Hennepin County, Minnesota",69,69,0,0,0,0,0,0,69,69,69,0,0,0,0,0,0,0,0,0,0,0,0,0,0
270531012003023,54,Windom Park,19,19,1000000US270531012003023,"Block 3023, Block Group 3, Census Tract 1012, Hennepin County, Minnesota",51,45,3,0,1,0,0,2,51,50,44,3,0,1,0,0,2,1,1,0,0,0,0,0,0
270531012003022,54,Windom Park,19,19,1000000US270531012003022,"Block 3022, Block Group 3, Census Tract 1012, Hennepin County, Minnesota",38,34,0,0,0,0,0,4,38,38,34,0,0,0,0,0,4,0,0,0,0,0,0,0,0
270531019003004,54,Windom Park,19,19,1000000US270531019003004,"Block 3004, Block Group 3, Census Tract 1019, Hennepin County, Minnesota",102,84,4,0,0,0,8,6,102,84,77,1,0,0,0,0,6,18,7,3,0,0,0,8,0
270531019001010,54,Windom Park,19,19,1000000US270531019001010,"Block 1010, Block Group 1, Census Tract 1019, Hennepin County, Minnesota",75,57,9,0,2,0,7,0,75,61,51,8,0,2,0,0,0,14,6,1,0,0,0,7,0
270531012003012,54,Windom Park,19,19,1000000US270531012003012,"Block 3012, Block Group 3, Census Tract 1012, Hennepin County, Minnesota",111,108,3,0,0,0,0,0,111,111,108,3,0,0,0,0,0,0,0,0,0,0,0,0,0
270531019003000,54,Windom Park,19,19,1000000US270531019003000,"Block 3000, Block Group 3, Census Tract 1019, Hennepin County, Minnesota",64,52,7,1,0,0,0,4,64,63,52,7,0,0,0,0,4,1,0,0,1,0,0,0,0
270531019003006,54,Windom Park,19,19,1000000US270531019003006,"Block 3006, Block Group 3, Census Tract 1019, Hennepin County, Minnesota",61,33,13,0,4,0,6,5,61,47,30,13,0,4,0,0,0,14,3,0,0,0,0,6,5
270531019001004,54,Windom Park,19,19,1000000US270531019001004,"Block 1004, Block Group 1, Census Tract 1019, Hennepin County, Minnesota",80,69,4,1,0,0,5,1,80,72,66,4,1,0,0,0,1,8,3,0,0,0,0,5,0
270531019003010,54,Windom Park,19,19,1000000US270531019003010,"Block 3010, Block Group 3, Census Tract 1019, Hennepin County, Minnesota",58,44,0,3,6,0,5,0,58,53,44,0,3,6,0,0,0,5,0,0,0,0,0,5,0
270531091003016,55,Linden Hills,69,69,1000000US270531091003016,"Block 3016, Block Group 3, Census Tract 1091, Hennepin County, Minnesota",91,88,0,0,2,0,1,0,91,89,87,0,0,2,0,0,0,2,1,0,0,0,0,1,0
270531098001003,55,Linden Hills,69,69,1000000US270531098001003,"Block 1003, Block Group 1, Census Tract 1098, Hennepin County, Minnesota",57,50,0,0,2,0,4,1,57,53,50,0,0,2,0,0,1,4,0,0,0,0,0,4,0
270531098002006,55,Linden Hills,69,69,1000000US270531098002006,"Block 2006, Block Group 2, Census Tract 1098, Hennepin County, Minnesota",51,46,0,0,0,0,0,5,51,47,46,0,0,0,0,0,1,4,0,0,0,0,0,0,4
270531091003013,55,Linden Hills,69,69,1000000US270531091003013,"Block 3013, Block Group 3, Census Tract 1091, Hennepin County, Minnesota",43,40,0,0,3,0,0,0,43,39,36,0,0,3,0,0,0,4,4,0,0,0,0,0,0
270531098002016,55,Linden Hills,69,69,1000000US270531098002016,"Block 2016, Block Group 2, Census Tract 1098, Hennepin County, Minnesota",59,58,1,0,0,0,0,0,59,58,58,0,0,0,0,0,0,1,0,1,0,0,0,0,0
270531098002005,55,Linden Hills,69,69,1000000US270531098002005,"Block 2005, Block Group 2, Census Tract 1098, Hennepin County, Minnesota",61,49,0,3,2,0,0,7,61,59,47,0,3,2,0,0,7,2,2,0,0,0,0,0,0
270531098001011,55,Linden Hills,69,69,1000000US270531098001011,"Block 1011, Block Group 1, Census Tract 1098, Hennepin County, Minnesota",50,44,0,0,4,0,0,2,50,50,44,0,0,4,0,0,2,0,0,0,0,0,0,0,0
270531098001006,55,Linden Hills,69,69,1000000US270531098001006,"Block 1006, Block Group 1, Census Tract 1098, Hennepin County, Minnesota",51,48,0,1,2,0,0,0,51,48,46,0,0,2,0,0,0,3,2,0,1,0,0,0,0
270531091006012,55,Linden Hills,69,69,1000000US270531091006012,"Block 6012, Block Group 6, Census Tract 1091, Hennepin County, Minnesota",57,54,0,0,1,0,1,1,57,57,54,0,0,1,0,1,1,0,0,0,0,0,0,0,0
270531091006011,55,Linden Hills,69,69,1000000US270531091006011,"Block 6011, Block Group 6, Census Tract 1091, Hennepin County, Minnesota",51,51,0,0,0,0,0,0,51,51,51,0,0,0,0,0,0,0,0,0,0,0,0,0,0
270531091003003,55,Linden Hills,69,69,1000000US270531091003003,"Block 3003, Block Group 3, Census Tract 1091, Hennepin County, Minnesota",22,19,0,0,1,0,0,2,22,22,19,0,0,1,0,0,2,0,0,0,0,0,0,0,0
270531091006001,55,Linden Hills,69,69,1000000US270531091006001,"Block 6001, Block Group 6, Census Tract 1091, Hennepin County, Minnesota",70,57,0,0,5,0,0,8,70,65,52,0,0,5,0,0,8,5,5,0,0,0,0,0,0
270531091006007,55,Linden Hills,69,69,1000000US270531091006007,"Block 6007, Block Group 6, Census Tract 1091, Hennepin County, Minnesota",58,52,1,0,4,0,0,1,58,58,52,1,0,4,0,0,1,0,0,0,0,0,0,0,0
270531091004007,55,Linden Hills,69,69,1000000US270531091004007,"Block 4007, Block Group 4, Census Tract 1091, Hennepin County, Minnesota",38,38,0,0,0,0,0,0,38,38,38,0,0,0,0,0,0,0,0,0,0,0,0,0,0
270531098001001,55,Linden Hills,69,69,1000000US270531098001001,"Block 1001, Block Group 1, Census Tract 1098, Hennepin County, Minnesota",56,47,0,0,4,0,0,5,56,55,46,0,0,4,0,0,5,1,1,0,0,0,0,0,0
270531098001005,55,Linden Hills,69,69,1000000US270531098001005,"Block 1005, Block Group 1, Census Tract 1098, Hennepin County, Minnesota",34,34,0,0,0,0,0,0,34,31,31,0,0,0,0,0,0,3,3,0,0,0,0,0,0
270531098003002,55,Linden Hills,69,69,1000000US270531098003002,"Block 3002, Block Group 3, Census Tract 1098, Hennepin County, Minnesota",56,54,0,0,0,0,0,2,56,55,53,0,0,0,0,0,2,1,1,0,0,0,0,0,0
270531091006002,55,Linden Hills,69,69,1000000US270531091006002,"Block 6002, Block Group 6, Census Tract 1091, Hennepin County, Minnesota",43,42,0,0,1,0,0,0,43,43,42,0,0,1,0,0,0,0,0,0,0,0,0,0,0
270531098001008,55,Linden Hills,69,69,1000000US270531098001008,"Block 1008, Block Group 1, Census Tract 1098, Hennepin County, Minnesota",44,39,0,0,5,0,0,0,44,44,39,0,0,5,0,0,0,0,0,0,0,0,0,0,0
270531091003000,55,Linden Hills,69,69,1000000US270531091003000,"Block 3000, Block Group 3, Census Tract 1091, Hennepin County, Minnesota",61,60,0,0,1,0,0,0,61,60,59,0,0,1,0,0,0,1,1,0,0,0,0,0,0
270531091005000,55,Linden Hills,69,69,1000000US270531091005000,"Block 5000, Block Group 5, Census Tract 1091, Hennepin County, Minnesota",185,161,3,0,8,0,3,10,185,177,157,3,0,7,0,0,10,8,4,0,0,1,0,3,0
270531098002003,55,Linden Hills,69,69,1000000US270531098002003,"Block 2003, Block Group 2, Census Tract 1098, Hennepin County, Minnesota",82,58,18,0,2,0,0,4,82,81,57,18,0,2,0,0,4,1,1,0,0,0,0,0,0
270531098002004,55,Linden Hills,69,69,1000000US270531098002004,"Block 2004, Block Group 2, Census Tract 1098, Hennepin County, Minnesota",68,64,1,0,1,0,2,0,68,64,62,1,0,1,0,0,0,4,2,0,0,0,0,2,0
270531098004009,55,Linden Hills,69,69,1000000US270531098004009,"Block 4009, Block Group 4, Census Tract 1098, Hennepin County, Minnesota",58,45,7,0,2,0,0,4,58,55,42,7,0,2,0,0,4,3,3,0,0,0,0,0,0
270531098004004,55,Linden Hills,69,69,1000000US270531098004004,"Block 4004, Block Group 4, Census Tract 1098, Hennepin County, Minnesota",69,64,2,0,0,0,2,1,69,65,60,2,0,0,0,2,1,4,4,0,0,0,0,0,0
270531098002007,55,Linden Hills,69,69,1000000US270531098002007,"Block 2007, Block Group 2, Census Tract 1098, Hennepin County, Minnesota",40,40,0,0,0,0,0,0,40,40,40,0,0,0,0,0,0,0,0,0,0,0,0,0,0
270531098001004,55,Linden Hills,69,69,1000000US270531098001004,"Block 1004, Block Group 1, Census Tract 1098, Hennepin County, Minnesota",56,51,0,0,0,0,0,5,56,56,51,0,0,0,0,0,5,0,0,0,0,0,0,0,0
270531091003004,55,Linden Hills,69,69,1000000US270531091003004,"Block 3004, Block Group 3, Census Tract 1091, Hennepin County, Minnesota",10,8,1,0,0,0,1,0,10,9,8,1,0,0,0,0,0,1,0,0,0,0,0,1,0
270531091004003,55,Linden Hills,69,69,1000000US270531091004003,"Block 4003, Block Group 4, Census Tract 1091, Hennepin County, Minnesota",39,37,0,0,0,0,0,2,39,39,37,0,0,0,0,0,2,0,0,0,0,0,0,0,0
270531091006009,55,Linden Hills,69,69,1000000US270531091006009,"Block 6009, Block Group 6, Census Tract 1091, Hennepin County, Minnesota",76,64,1,0,0,0,0,11,76,74,64,1,0,0,0,0,9,2,0,0,0,0,0,0,2
270531098001013,55,Linden Hills,69,69,1000000US270531098001013,"Block 1013, Block Group 1, Census Tract 1098, Hennepin County, Minnesota",52,52,0,0,0,0,0,0,52,46,46,0,0,0,0,0,0,6,6,0,0,0,0,0,0
270531098003001,55,Linden Hills,69,69,1000000US270531098003001,"Block 3001, Block Group 3, Census Tract 1098, Hennepin County, Minnesota",56,52,3,0,0,0,0,1,56,55,52,3,0,0,0,0,0,1,0,0,0,0,0,0,1
270531098001007,55,Linden Hills,69,69,1000000US270531098001007,"Block 1007, Block Group 1, Census Tract 1098, Hennepin County, Minnesota",57,48,0,0,5,0,0,4,57,55,46,0,0,5,0,0,4,2,2,0,0,0,0,0,0
270531091003001,55,Linden Hills,69,69,1000000US270531091003001,"Block 3001, Block Group 3, Census Tract 1091, Hennepin County, Minnesota",51,51,0,0,0,0,0,0,51,50,50,0,0,0,0,0,0,1,1,0,0,0,0,0,0
270531091004000,55,Linden Hills,69,69,1000000US270531091004000,"Block 4000, Block Group 4, Census Tract 1091, Hennepin County, Minnesota",68,55,0,0,10,0,0,3,68,68,55,0,0,10,0,0,3,0,0,0,0,0,0,0,0
270531098004010,55,Linden Hills,69,69,1000000US270531098004010,"Block 4010, Block Group 4, Census Tract 1098, Hennepin County, Minnesota",66,60,1,0,5,0,0,0,66,64,58,1,0,5,0,0,0,2,2,0,0,0,0,0,0
270531098004005,55,Linden Hills,69,69,1000000US270531098004005,"Block 4005, Block Group 4, Census Tract 1098, Hennepin County, Minnesota",24,24,0,0,0,0,0,0,24,24,24,0,0,0,0,0,0,0,0,0,0,0,0,0,0
270531091003007,55,Linden Hills,69,69,1000000US270531091003007,"Block 3007, Block Group 3, Census Tract 1091, Hennepin County, Minnesota",72,69,0,0,2,0,1,0,72,71,68,0,0,2,0,1,0,1,1,0,0,0,0,0,0
270531091006004,55,Linden Hills,69,69,1000000US270531091006004,"Block 6004, Block Group 6, Census Tract 1091, Hennepin County, Minnesota",47,43,1,0,0,0,0,3,47,44,42,1,0,0,0,0,1,3,1,0,0,0,0,0,2
270531091006005,55,Linden Hills,69,69,1000000US270531091006005,"Block 6005, Block Group 6, Census Tract 1091, Hennepin County, Minnesota",55,53,1,0,1,0,0,0,55,54,52,1,0,1,0,0,0,1,1,0,0,0,0,0,0
270531098001015,55,Linden Hills,69,69,1000000US270531098001015,"Block 1015, Block Group 1, Census Tract 1098, Hennepin County, Minnesota",55,50,0,0,3,0,1,1,55,50,46,0,0,3,0,0,1,5,4,0,0,0,0,1,0
270531091006006,55,Linden Hills,69,69,1000000US270531091006006,"Block 6006, Block Group 6, Census Tract 1091, Hennepin County, Minnesota",52,48,0,0,3,0,1,0,52,49,46,0,0,3,0,0,0,3,2,0,0,0,0,1,0
270531091004005,55,Linden Hills,69,69,1000000US270531091004005,"Block 4005, Block Group 4, Census Tract 1091, Hennepin County, Minnesota",63,63,0,0,0,0,0,0,63,62,62,0,0,0,0,0,0,1,1,0,0,0,0,0,0
270531091003008,55,Linden Hills,69,69,1000000US270531091003008,"Block 3008, Block Group 3, Census Tract 1091, Hennepin County, Minnesota",0,0,0,0,0,0,0,0,0,0,0,0,0,0,0,0,0,0,0,0,0,0,0,0,0
270531098003012,55,Linden Hills,69,69,1000000US270531098003012,"Block 3012, Block Group 3, Census Tract 1098, Hennepin County, Minnesota",69,52,9,0,2,0,0,6,69,68,51,9,0,2,0,0,6,1,1,0,0,0,0,0,0
270531098004006,55,Linden Hills,69,69,1000000US270531098004006,"Block 4006, Block Group 4, Census Tract 1098, Hennepin County, Minnesota",65,56,7,0,1,0,1,0,65,65,56,7,0,1,0,1,0,0,0,0,0,0,0,0,0
270531098005007,55,Linden Hills,69,69,1000000US270531098005007,"Block 5007, Block Group 5, Census Tract 1098, Hennepin County, Minnesota",59,56,0,0,2,0,0,1,59,59,56,0,0,2,0,0,1,0,0,0,0,0,0,0,0
270530106003006,55,Linden Hills,69,69,1000000US270530106003006,"Block 3006, Block Group 3, Census Tract 106, Hennepin County, Minnesota",60,55,3,0,2,0,0,0,60,59,55,2,0,2,0,0,0,1,0,1,0,0,0,0,0
270531098005009,55,Linden Hills,69,69,1000000US270531098005009,"Block 5009, Block Group 5, Census Tract 1098, Hennepin County, Minnesota",65,60,0,0,3,0,2,0,65,63,60,0,0,3,0,0,0,2,0,0,0,0,0,2,0
270530106003003,55,Linden Hills,69,69,1000000US270530106003003,"Block 3003, Block Group 3, Census Tract 106, Hennepin County, Minnesota",135,120,0,0,3,0,3,9,135,132,120,0,0,3,0,0,9,3,0,0,0,0,0,3,0
270530106003000,55,Linden Hills,69,69,1000000US270530106003000,"Block 3000, Block Group 3, Census Tract 106, Hennepin County, Minnesota",121,110,4,0,2,0,0,5,121,118,107,4,0,2,0,0,5,3,3,0,0,0,0,0,0
270531098003008,55,Linden Hills,69,69,1000000US270531098003008,"Block 3008, Block Group 3, Census Tract 1098, Hennepin County, Minnesota",39,38,0,0,1,0,0,0,39,39,38,0,0,1,0,0,0,0,0,0,0,0,0,0,0
270531098003010,55,Linden Hills,69,69,1000000US270531098003010,"Block 3010, Block Group 3, Census Tract 1098, Hennepin County, Minnesota",67,67,0,0,0,0,0,0,67,65,65,0,0,0,0,0,0,2,2,0,0,0,0,0,0
270530106003002,55,Linden Hills,69,69,1000000US270530106003002,"Block 3002, Block Group 3, Census Tract 106, Hennepin County, Minnesota",97,88,0,0,2,3,0,4,97,89,80,0,0,2,3,0,4,8,8,0,0,0,0,0,0
270531091003015,55,Linden Hills,69,69,1000000US270531091003015,"Block 3015, Block Group 3, Census Tract 1091, Hennepin County, Minnesota",0,0,0,0,0,0,0,0,0,0,0,0,0,0,0,0,0,0,0,0,0,0,0,0,0
270531098003007,55,Linden Hills,69,69,1000000US270531098003007,"Block 3007, Block Group 3, Census Tract 1098, Hennepin County, Minnesota",52,46,0,0,2,0,0,4,52,52,46,0,0,2,0,0,4,0,0,0,0,0,0,0,0
270531098003017,55,Linden Hills,69,69,1000000US270531098003017,"Block 3017, Block Group 3, Census Tract 1098, Hennepin County, Minnesota",59,55,0,0,0,0,0,4,59,59,55,0,0,0,0,0,4,0,0,0,0,0,0,0,0
270531098004007,55,Linden Hills,69,69,1000000US270531098004007,"Block 4007, Block Group 4, Census Tract 1098, Hennepin County, Minnesota",82,78,3,0,0,0,0,1,82,82,78,3,0,0,0,0,1,0,0,0,0,0,0,0,0
270531098005008,55,Linden Hills,69,69,1000000US270531098005008,"Block 5008, Block Group 5, Census Tract 1098, Hennepin County, Minnesota",52,52,0,0,0,0,0,0,52,49,49,0,0,0,0,0,0,3,3,0,0,0,0,0,0
270530106003009,55,Linden Hills,69,69,1000000US270530106003009,"Block 3009, Block Group 3, Census Tract 106, Hennepin County, Minnesota",68,58,1,0,3,0,1,5,68,68,58,1,0,3,0,1,5,0,0,0,0,0,0,0,0
270531099004004,55,Linden Hills,69,69,1000000US270531099004004,"Block 4004, Block Group 4, Census Tract 1099, Hennepin County, Minnesota",0,0,0,0,0,0,0,0,0,0,0,0,0,0,0,0,0,0,0,0,0,0,0,0,0
270531098005002,55,Linden Hills,69,69,1000000US270531098005002,"Block 5002, Block Group 5, Census Tract 1098, Hennepin County, Minnesota",90,84,2,1,0,0,2,1,90,88,84,2,1,0,0,0,1,2,0,0,0,0,0,2,0
270530106003011,55,Linden Hills,69,69,1000000US270530106003011,"Block 3011, Block Group 3, Census Tract 106, Hennepin County, Minnesota",58,52,0,0,3,0,0,3,58,58,52,0,0,3,0,0,3,0,0,0,0,0,0,0,0
270530106003007,55,Linden Hills,69,69,1000000US270530106003007,"Block 3007, Block Group 3, Census Tract 106, Hennepin County, Minnesota",74,70,1,0,1,0,0,2,74,70,66,1,0,1,0,0,2,4,4,0,0,0,0,0,0
270531091005001,55,Linden Hills,69,69,1000000US270531091005001,"Block 5001, Block Group 5, Census Tract 1091, Hennepin County, Minnesota",358,331,7,0,13,0,1,6,358,352,327,7,0,13,0,0,5,6,4,0,0,0,0,1,1
270531098002012,55,Linden Hills,69,69,1000000US270531098002012,"Block 2012, Block Group 2, Census Tract 1098, Hennepin County, Minnesota",37,36,0,0,0,0,0,1,37,35,34,0,0,0,0,0,1,2,2,0,0,0,0,0,0
270531098005005,55,Linden Hills,69,69,1000000US270531098005005,"Block 5005, Block Group 5, Census Tract 1098, Hennepin County, Minnesota",79,79,0,0,0,0,0,0,79,79,79,0,0,0,0,0,0,0,0,0,0,0,0,0,0
270531098005001,55,Linden Hills,69,69,1000000US270531098005001,"Block 5001, Block Group 5, Census Tract 1098, Hennepin County, Minnesota",83,78,2,0,1,0,1,1,83,76,72,2,0,1,0,0,1,7,6,0,0,0,0,1,0
270531098005010,55,Linden Hills,69,69,1000000US270531098005010,"Block 5010, Block Group 5, Census Tract 1098, Hennepin County, Minnesota",65,63,0,2,0,0,0,0,65,60,58,0,2,0,0,0,0,5,5,0,0,0,0,0,0
270530106003004,55,Linden Hills,69,69,1000000US270530106003004,"Block 3004, Block Group 3, Census Tract 106, Hennepin County, Minnesota",79,79,0,0,0,0,0,0,79,78,78,0,0,0,0,0,0,1,1,0,0,0,0,0,0
270530106003008,55,Linden Hills,69,69,1000000US270530106003008,"Block 3008, Block Group 3, Census Tract 106, Hennepin County, Minnesota",52,52,0,0,0,0,0,0,52,50,50,0,0,0,0,0,0,2,2,0,0,0,0,0,0
270531098003011,55,Linden Hills,69,69,1000000US270531098003011,"Block 3011, Block Group 3, Census Tract 1098, Hennepin County, Minnesota",0,0,0,0,0,0,0,0,0,0,0,0,0,0,0,0,0,0,0,0,0,0,0,0,0
270531098002014,55,Linden Hills,69,69,1000000US270531098002014,"Block 2014, Block Group 2, Census Tract 1098, Hennepin County, Minnesota",26,25,0,0,1,0,0,0,26,25,24,0,0,1,0,0,0,1,1,0,0,0,0,0,0
270531098002011,55,Linden Hills,69,69,1000000US270531098002011,"Block 2011, Block Group 2, Census Tract 1098, Hennepin County, Minnesota",31,31,0,0,0,0,0,0,31,31,31,0,0,0,0,0,0,0,0,0,0,0,0,0,0
270531098002010,55,Linden Hills,69,69,1000000US270531098002010,"Block 2010, Block Group 2, Census Tract 1098, Hennepin County, Minnesota",29,21,1,0,4,0,1,2,29,25,19,1,0,3,0,0,2,4,2,0,0,1,0,1,0
270531098002013,55,Linden Hills,69,69,1000000US270531098002013,"Block 2013, Block Group 2, Census Tract 1098, Hennepin County, Minnesota",39,31,8,0,0,0,0,0,39,37,29,8,0,0,0,0,0,2,2,0,0,0,0,0,0
270531091003014,55,Linden Hills,69,69,1000000US270531091003014,"Block 3014, Block Group 3, Census Tract 1091, Hennepin County, Minnesota",0,0,0,0,0,0,0,0,0,0,0,0,0,0,0,0,0,0,0,0,0,0,0,0,0
270531098003006,55,Linden Hills,69,69,1000000US270531098003006,"Block 3006, Block Group 3, Census Tract 1098, Hennepin County, Minnesota",39,34,0,0,4,0,0,1,39,39,34,0,0,4,0,0,1,0,0,0,0,0,0,0,0
270531098002000,55,Linden Hills,69,69,1000000US270531098002000,"Block 2000, Block Group 2, Census Tract 1098, Hennepin County, Minnesota",50,44,0,0,6,0,0,0,50,50,44,0,0,6,0,0,0,0,0,0,0,0,0,0,0
270531091001005,55,Linden Hills,69,69,1000000US270531091001005,"Block 1005, Block Group 1, Census Tract 1091, Hennepin County, Minnesota",0,0,0,0,0,0,0,0,0,0,0,0,0,0,0,0,0,0,0,0,0,0,0,0,0
270531098001002,55,Linden Hills,69,69,1000000US270531098001002,"Block 1002, Block Group 1, Census Tract 1098, Hennepin County, Minnesota",44,41,2,1,0,0,0,0,44,43,40,2,1,0,0,0,0,1,1,0,0,0,0,0,0
270531091003005,55,Linden Hills,69,69,1000000US270531091003005,"Block 3005, Block Group 3, Census Tract 1091, Hennepin County, Minnesota",15,14,0,0,0,1,0,0,15,13,12,0,0,0,1,0,0,2,2,0,0,0,0,0,0
270531091006003,55,Linden Hills,69,69,1000000US270531091006003,"Block 6003, Block Group 6, Census Tract 1091, Hennepin County, Minnesota",43,38,0,0,3,0,0,2,43,43,38,0,0,3,0,0,2,0,0,0,0,0,0,0,0
270531091003010,55,Linden Hills,69,69,1000000US270531091003010,"Block 3010, Block Group 3, Census Tract 1091, Hennepin County, Minnesota",27,27,0,0,0,0,0,0,27,27,27,0,0,0,0,0,0,0,0,0,0,0,0,0,0
270531091004001,55,Linden Hills,69,69,1000000US270531091004001,"Block 4001, Block Group 4, Census Tract 1091, Hennepin County, Minnesota",71,58,0,5,3,0,0,5,71,65,56,0,1,3,0,0,5,6,2,0,4,0,0,0,0
270531091006010,55,Linden Hills,69,69,1000000US270531091006010,"Block 6010, Block Group 6, Census Tract 1091, Hennepin County, Minnesota",69,63,0,0,4,0,1,1,69,65,60,0,0,4,0,0,1,4,3,0,0,0,0,1,0
270531098004002,55,Linden Hills,69,69,1000000US270531098004002,"Block 4002, Block Group 4, Census Tract 1098, Hennepin County, Minnesota",0,0,0,0,0,0,0,0,0,0,0,0,0,0,0,0,0,0,0,0,0,0,0,0,0
270531098003013,55,Linden Hills,69,69,1000000US270531098003013,"Block 3013, Block Group 3, Census Tract 1098, Hennepin County, Minnesota",67,64,0,0,1,0,0,2,67,67,64,0,0,1,0,0,2,0,0,0,0,0,0,0,0
270531098004001,55,Linden Hills,69,69,1000000US270531098004001,"Block 4001, Block Group 4, Census Tract 1098, Hennepin County, Minnesota",181,141,19,0,6,0,0,15,181,173,136,17,0,6,0,0,14,8,5,2,0,0,0,0,1
270531098004008,55,Linden Hills,69,69,1000000US270531098004008,"Block 4008, Block Group 4, Census Tract 1098, Hennepin County, Minnesota",58,53,5,0,0,0,0,0,58,58,53,5,0,0,0,0,0,0,0,0,0,0,0,0,0
270531098004000,55,Linden Hills,69,69,1000000US270531098004000,"Block 4000, Block Group 4, Census Tract 1098, Hennepin County, Minnesota",157,131,12,1,5,0,0,8,157,155,130,12,1,5,0,0,7,2,1,0,0,0,0,0,1
270531098005004,55,Linden Hills,69,69,1000000US270531098005004,"Block 5004, Block Group 5, Census Tract 1098, Hennepin County, Minnesota",88,87,0,0,0,0,0,1,88,86,85,0,0,0,0,0,1,2,2,0,0,0,0,0,0
270531098005000,55,Linden Hills,69,69,1000000US270531098005000,"Block 5000, Block Group 5, Census Tract 1098, Hennepin County, Minnesota",58,48,2,0,7,0,1,0,58,58,48,2,0,7,0,1,0,0,0,0,0,0,0,0,0
270531098003009,55,Linden Hills,69,69,1000000US270531098003009,"Block 3009, Block Group 3, Census Tract 1098, Hennepin County, Minnesota",71,66,0,2,1,0,0,2,71,71,66,0,2,1,0,0,2,0,0,0,0,0,0,0,0
270531091004008,55,Linden Hills,69,69,1000000US270531091004008,"Block 4008, Block Group 4, Census Tract 1091, Hennepin County, Minnesota",155,145,5,0,3,0,1,1,155,153,143,5,0,3,0,1,1,2,2,0,0,0,0,0,0
270530106003005,55,Linden Hills,69,69,1000000US270530106003005,"Block 3005, Block Group 3, Census Tract 106, Hennepin County, Minnesota",64,59,0,0,1,0,0,4,64,64,59,0,0,1,0,0,4,0,0,0,0,0,0,0,0
270531091003009,55,Linden Hills,69,69,1000000US270531091003009,"Block 3009, Block Group 3, Census Tract 1091, Hennepin County, Minnesota",0,0,0,0,0,0,0,0,0,0,0,0,0,0,0,0,0,0,0,0,0,0,0,0,0
270531098002002,55,Linden Hills,69,69,1000000US270531098002002,"Block 2002, Block Group 2, Census Tract 1098, Hennepin County, Minnesota",48,47,0,0,1,0,0,0,48,48,47,0,0,1,0,0,0,0,0,0,0,0,0,0,0
270531098002001,55,Linden Hills,69,69,1000000US270531098002001,"Block 2001, Block Group 2, Census Tract 1098, Hennepin County, Minnesota",51,51,0,0,0,0,0,0,51,45,45,0,0,0,0,0,0,6,6,0,0,0,0,0,0
270531098002015,55,Linden Hills,69,69,1000000US270531098002015,"Block 2015, Block Group 2, Census Tract 1098, Hennepin County, Minnesota",25,24,0,0,1,0,0,0,25,25,24,0,0,1,0,0,0,0,0,0,0,0,0,0,0
270531098002008,55,Linden Hills,69,69,1000000US270531098002008,"Block 2008, Block Group 2, Census Tract 1098, Hennepin County, Minnesota",0,0,0,0,0,0,0,0,0,0,0,0,0,0,0,0,0,0,0,0,0,0,0,0,0
270531098002017,55,Linden Hills,69,69,1000000US270531098002017,"Block 2017, Block Group 2, Census Tract 1098, Hennepin County, Minnesota",66,63,0,0,3,0,0,0,66,64,61,0,0,3,0,0,0,2,2,0,0,0,0,0,0
270531098002018,55,Linden Hills,69,69,1000000US270531098002018,"Block 2018, Block Group 2, Census Tract 1098, Hennepin County, Minnesota",71,59,4,0,4,0,0,4,71,66,54,4,0,4,0,0,4,5,5,0,0,0,0,0,0
270531098003004,55,Linden Hills,69,69,1000000US270531098003004,"Block 3004, Block Group 3, Census Tract 1098, Hennepin County, Minnesota",34,30,1,0,0,0,0,3,34,34,30,1,0,0,0,0,3,0,0,0,0,0,0,0,0
270531098001012,55,Linden Hills,69,69,1000000US270531098001012,"Block 1012, Block Group 1, Census Tract 1098, Hennepin County, Minnesota",63,57,0,0,2,0,0,4,63,63,57,0,0,2,0,0,4,0,0,0,0,0,0,0,0
270531091003006,55,Linden Hills,69,69,1000000US270531091003006,"Block 3006, Block Group 3, Census Tract 1091, Hennepin County, Minnesota",0,0,0,0,0,0,0,0,0,0,0,0,0,0,0,0,0,0,0,0,0,0,0,0,0
270531098001009,55,Linden Hills,69,69,1000000US270531098001009,"Block 1009, Block Group 1, Census Tract 1098, Hennepin County, Minnesota",47,47,0,0,0,0,0,0,47,46,46,0,0,0,0,0,0,1,1,0,0,0,0,0,0
270531098001014,55,Linden Hills,69,69,1000000US270531098001014,"Block 1014, Block Group 1, Census Tract 1098, Hennepin County, Minnesota",64,64,0,0,0,0,0,0,64,58,58,0,0,0,0,0,0,6,6,0,0,0,0,0,0
270531098003000,55,Linden Hills,69,69,1000000US270531098003000,"Block 3000, Block Group 3, Census Tract 1098, Hennepin County, Minnesota",0,0,0,0,0,0,0,0,0,0,0,0,0,0,0,0,0,0,0,0,0,0,0,0,0
270531091006000,55,Linden Hills,69,69,1000000US270531091006000,"Block 6000, Block Group 6, Census Tract 1091, Hennepin County, Minnesota",52,51,0,0,1,0,0,0,52,52,51,0,0,1,0,0,0,0,0,0,0,0,0,0,0
270531091006008,55,Linden Hills,69,69,1000000US270531091006008,"Block 6008, Block Group 6, Census Tract 1091, Hennepin County, Minnesota",79,72,3,1,3,0,0,0,79,79,72,3,1,3,0,0,0,0,0,0,0,0,0,0,0
270531091004006,55,Linden Hills,69,69,1000000US270531091004006,"Block 4006, Block Group 4, Census Tract 1091, Hennepin County, Minnesota",76,70,0,0,3,0,1,2,76,71,66,0,0,3,0,1,1,5,4,0,0,0,0,0,1
270531098003016,55,Linden Hills,69,69,1000000US270531098003016,"Block 3016, Block Group 3, Census Tract 1098, Hennepin County, Minnesota",48,20,26,0,0,0,0,2,48,48,20,26,0,0,0,0,2,0,0,0,0,0,0,0,0
270531098003014,55,Linden Hills,69,69,1000000US270531098003014,"Block 3014, Block Group 3, Census Tract 1098, Hennepin County, Minnesota",0,0,0,0,0,0,0,0,0,0,0,0,0,0,0,0,0,0,0,0,0,0,0,0,0
270531098005003,55,Linden Hills,69,69,1000000US270531098005003,"Block 5003, Block Group 5, Census Tract 1098, Hennepin County, Minnesota",63,60,0,0,0,0,0,3,63,63,60,0,0,0,0,0,3,0,0,0,0,0,0,0,0
270531091003012,55,Linden Hills,69,69,1000000US270531091003012,"Block 3012, Block Group 3, Census Tract 1091, Hennepin County, Minnesota",173,162,6,0,1,0,1,3,173,170,159,6,0,1,0,1,3,3,3,0,0,0,0,0,0
270530106003001,55,Linden Hills,69,69,1000000US270530106003001,"Block 3001, Block Group 3, Census Tract 106, Hennepin County, Minnesota",17,16,1,0,0,0,0,0,17,17,16,1,0,0,0,0,0,0,0,0,0,0,0,0,0
270531098002009,55,Linden Hills,69,69,1000000US270531098002009,"Block 2009, Block Group 2, Census Tract 1098, Hennepin County, Minnesota",61,57,0,0,2,0,2,0,61,60,57,0,0,2,0,1,0,1,0,0,0,0,0,1,0
270531098003005,55,Linden Hills,69,69,1000000US270531098003005,"Block 3005, Block Group 3, Census Tract 1098, Hennepin County, Minnesota",57,56,0,0,0,0,0,1,57,56,55,0,0,0,0,0,1,1,1,0,0,0,0,0,0
270531098003003,55,Linden Hills,69,69,1000000US270531098003003,"Block 3003, Block Group 3, Census Tract 1098, Hennepin County, Minnesota",58,50,1,0,7,0,0,0,58,52,44,1,0,7,0,0,0,6,6,0,0,0,0,0,0
270531098001000,55,Linden Hills,69,69,1000000US270531098001000,"Block 1000, Block Group 1, Census Tract 1098, Hennepin County, Minnesota",39,39,0,0,0,0,0,0,39,39,39,0,0,0,0,0,0,0,0,0,0,0,0,0,0
270531098001010,55,Linden Hills,69,69,1000000US270531098001010,"Block 1010, Block Group 1, Census Tract 1098, Hennepin County, Minnesota",41,37,0,0,4,0,0,0,41,41,37,0,0,4,0,0,0,0,0,0,0,0,0,0,0
270531091004002,55,Linden Hills,69,69,1000000US270531091004002,"Block 4002, Block Group 4, Census Tract 1091, Hennepin County, Minnesota",56,54,0,0,1,0,0,1,56,51,49,0,0,1,0,0,1,5,5,0,0,0,0,0,0
270531091004004,55,Linden Hills,69,69,1000000US270531091004004,"Block 4004, Block Group 4, Census Tract 1091, Hennepin County, Minnesota",67,63,0,0,1,0,3,0,67,67,63,0,0,1,0,3,0,0,0,0,0,0,0,0,0
270531091003002,55,Linden Hills,69,69,1000000US270531091003002,"Block 3002, Block Group 3, Census Tract 1091, Hennepin County, Minnesota",12,12,0,0,0,0,0,0,12,12,12,0,0,0,0,0,0,0,0,0,0,0,0,0,0
270531091003011,55,Linden Hills,69,69,1000000US270531091003011,"Block 3011, Block Group 3, Census Tract 1091, Hennepin County, Minnesota",110,99,2,0,5,0,1,3,110,107,97,2,0,5,0,0,3,3,2,0,0,0,0,1,0
270531098004003,55,Linden Hills,69,69,1000000US270531098004003,"Block 4003, Block Group 4, Census Tract 1098, Hennepin County, Minnesota",0,0,0,0,0,0,0,0,0,0,0,0,0,0,0,0,0,0,0,0,0,0,0,0,0
270531098003015,55,Linden Hills,69,69,1000000US270531098003015,"Block 3015, Block Group 3, Census Tract 1098, Hennepin County, Minnesota",33,29,2,1,0,0,0,1,33,32,28,2,1,0,0,0,1,1,1,0,0,0,0,0,0
270531098005006,55,Linden Hills,69,69,1000000US270531098005006,"Block 5006, Block Group 5, Census Tract 1098, Hennepin County, Minnesota",66,60,1,0,0,0,2,3,66,63,59,1,0,0,0,0,3,3,1,0,0,0,0,2,0
270530106003010,55,Linden Hills,69,69,1000000US270530106003010,"Block 3010, Block Group 3, Census Tract 106, Hennepin County, Minnesota",66,65,0,0,0,0,1,0,66,65,65,0,0,0,0,0,0,1,0,0,0,0,0,1,0
270531099004006,56,East Harriet,70,70,1000000US270531099004006,"Block 4006, Block Group 4, Census Tract 1099, Hennepin County, Minnesota",0,0,0,0,0,0,0,0,0,0,0,0,0,0,0,0,0,0,0,0,0,0,0,0,0
270531092002003,56,East Harriet,70,70,1000000US270531092002003,"Block 2003, Block Group 2, Census Tract 1092, Hennepin County, Minnesota",82,72,1,3,4,0,1,1,82,76,66,1,3,4,0,1,1,6,6,0,0,0,0,0,0
270530107003000,56,East Harriet,70,70,1000000US270530107003000,"Block 3000, Block Group 3, Census Tract 107, Hennepin County, Minnesota",24,24,0,0,0,0,0,0,24,24,24,0,0,0,0,0,0,0,0,0,0,0,0,0,0
270531099004018,56,East Harriet,70,70,1000000US270531099004018,"Block 4018, Block Group 4, Census Tract 1099, Hennepin County, Minnesota",60,57,1,0,0,2,0,0,60,60,57,1,0,0,2,0,0,0,0,0,0,0,0,0,0
270530107001001,56,East Harriet,70,70,1000000US270530107001001,"Block 1001, Block Group 1, Census Tract 107, Hennepin County, Minnesota",59,49,3,0,4,0,0,3,59,59,49,3,0,4,0,0,3,0,0,0,0,0,0,0,0
270530107001000,56,East Harriet,70,70,1000000US270530107001000,"Block 1000, Block Group 1, Census Tract 107, Hennepin County, Minnesota",88,75,8,0,0,0,0,5,88,88,75,8,0,0,0,0,5,0,0,0,0,0,0,0,0
270531099004005,56,East Harriet,70,70,1000000US270531099004005,"Block 4005, Block Group 4, Census Tract 1099, Hennepin County, Minnesota",0,0,0,0,0,0,0,0,0,0,0,0,0,0,0,0,0,0,0,0,0,0,0,0,0
270531099004002,56,East Harriet,70,70,1000000US270531099004002,"Block 4002, Block Group 4, Census Tract 1099, Hennepin County, Minnesota",0,0,0,0,0,0,0,0,0,0,0,0,0,0,0,0,0,0,0,0,0,0,0,0,0
270531099004003,56,East Harriet,70,70,1000000US270531099004003,"Block 4003, Block Group 4, Census Tract 1099, Hennepin County, Minnesota",0,0,0,0,0,0,0,0,0,0,0,0,0,0,0,0,0,0,0,0,0,0,0,0,0
270531099004000,56,East Harriet,70,70,1000000US270531099004000,"Block 4000, Block Group 4, Census Tract 1099, Hennepin County, Minnesota",0,0,0,0,0,0,0,0,0,0,0,0,0,0,0,0,0,0,0,0,0,0,0,0,0
270531092002001,56,East Harriet,70,70,1000000US270531092002001,"Block 2001, Block Group 2, Census Tract 1092, Hennepin County, Minnesota",113,96,11,0,4,0,0,2,113,109,94,10,0,4,0,0,1,4,2,1,0,0,0,0,1
270531092002006,56,East Harriet,70,70,1000000US270531092002006,"Block 2006, Block Group 2, Census Tract 1092, Hennepin County, Minnesota",443,395,37,1,5,0,0,5,443,440,394,36,1,5,0,0,4,3,1,1,0,0,0,0,1
270531092002000,56,East Harriet,70,70,1000000US270531092002000,"Block 2000, Block Group 2, Census Tract 1092, Hennepin County, Minnesota",107,82,3,0,4,0,10,8,107,93,80,3,0,4,0,0,6,14,2,0,0,0,0,10,2
270531099004010,56,East Harriet,70,70,1000000US270531099004010,"Block 4010, Block Group 4, Census Tract 1099, Hennepin County, Minnesota",115,95,8,0,1,0,6,5,115,106,94,8,0,1,0,0,3,9,1,0,0,0,0,6,2
270531099004015,56,East Harriet,70,70,1000000US270531099004015,"Block 4015, Block Group 4, Census Tract 1099, Hennepin County, Minnesota",68,65,0,0,2,0,0,1,68,68,65,0,0,2,0,0,1,0,0,0,0,0,0,0,0
270531099004017,56,East Harriet,70,70,1000000US270531099004017,"Block 4017, Block Group 4, Census Tract 1099, Hennepin County, Minnesota",48,48,0,0,0,0,0,0,48,48,48,0,0,0,0,0,0,0,0,0,0,0,0,0,0
270530107003001,56,East Harriet,70,70,1000000US270530107003001,"Block 3001, Block Group 3, Census Tract 107, Hennepin County, Minnesota",61,58,0,0,1,0,0,2,61,60,57,0,0,1,0,0,2,1,1,0,0,0,0,0,0
270530107003002,56,East Harriet,70,70,1000000US270530107003002,"Block 3002, Block Group 3, Census Tract 107, Hennepin County, Minnesota",37,35,0,0,2,0,0,0,37,37,35,0,0,2,0,0,0,0,0,0,0,0,0,0,0
270531092002005,56,East Harriet,70,70,1000000US270531092002005,"Block 2005, Block Group 2, Census Tract 1092, Hennepin County, Minnesota",88,75,4,1,0,0,0,8,88,85,74,4,0,0,0,0,7,3,1,0,1,0,0,0,1
270531099004021,56,East Harriet,70,70,1000000US270531099004021,"Block 4021, Block Group 4, Census Tract 1099, Hennepin County, Minnesota",0,0,0,0,0,0,0,0,0,0,0,0,0,0,0,0,0,0,0,0,0,0,0,0,0
270531092002002,56,East Harriet,70,70,1000000US270531092002002,"Block 2002, Block Group 2, Census Tract 1092, Hennepin County, Minnesota",146,99,30,2,1,0,3,11,146,140,96,30,0,1,0,2,11,6,3,0,2,0,0,1,0
270531099004009,56,East Harriet,70,70,1000000US270531099004009,"Block 4009, Block Group 4, Census Tract 1099, Hennepin County, Minnesota",0,0,0,0,0,0,0,0,0,0,0,0,0,0,0,0,0,0,0,0,0,0,0,0,0
270531099004008,56,East Harriet,70,70,1000000US270531099004008,"Block 4008, Block Group 4, Census Tract 1099, Hennepin County, Minnesota",80,68,5,0,2,0,1,4,80,78,67,5,0,2,0,0,4,2,1,0,0,0,0,1,0
270531099004016,56,East Harriet,70,70,1000000US270531099004016,"Block 4016, Block Group 4, Census Tract 1099, Hennepin County, Minnesota",114,102,5,0,2,0,0,5,114,113,101,5,0,2,0,0,5,1,1,0,0,0,0,0,0
270531099004019,56,East Harriet,70,70,1000000US270531099004019,"Block 4019, Block Group 4, Census Tract 1099, Hennepin County, Minnesota",24,24,0,0,0,0,0,0,24,24,24,0,0,0,0,0,0,0,0,0,0,0,0,0,0
270530107003003,56,East Harriet,70,70,1000000US270530107003003,"Block 3003, Block Group 3, Census Tract 107, Hennepin County, Minnesota",31,26,0,0,0,0,0,5,31,27,26,0,0,0,0,0,1,4,0,0,0,0,0,0,4
270530107003011,56,East Harriet,70,70,1000000US270530107003011,"Block 3011, Block Group 3, Census Tract 107, Hennepin County, Minnesota",67,67,0,0,0,0,0,0,67,67,67,0,0,0,0,0,0,0,0,0,0,0,0,0,0
270530107003009,56,East Harriet,70,70,1000000US270530107003009,"Block 3009, Block Group 3, Census Tract 107, Hennepin County, Minnesota",50,46,0,0,0,1,0,3,50,50,46,0,0,0,1,0,3,0,0,0,0,0,0,0,0
270530107003007,56,East Harriet,70,70,1000000US270530107003007,"Block 3007, Block Group 3, Census Tract 107, Hennepin County, Minnesota",81,76,1,0,0,0,0,4,81,81,76,1,0,0,0,0,4,0,0,0,0,0,0,0,0
270530107003005,56,East Harriet,70,70,1000000US270530107003005,"Block 3005, Block Group 3, Census Tract 107, Hennepin County, Minnesota",41,36,0,0,3,0,0,2,41,41,36,0,0,3,0,0,2,0,0,0,0,0,0,0,0
270530107003006,56,East Harriet,70,70,1000000US270530107003006,"Block 3006, Block Group 3, Census Tract 107, Hennepin County, Minnesota",78,71,0,0,2,0,0,5,78,78,71,0,0,2,0,0,5,0,0,0,0,0,0,0,0
270530107003013,56,East Harriet,70,70,1000000US270530107003013,"Block 3013, Block Group 3, Census Tract 107, Hennepin County, Minnesota",63,60,0,0,3,0,0,0,63,61,58,0,0,3,0,0,0,2,2,0,0,0,0,0,0
270530107003008,56,East Harriet,70,70,1000000US270530107003008,"Block 3008, Block Group 3, Census Tract 107, Hennepin County, Minnesota",82,72,0,0,4,0,0,6,82,82,72,0,0,4,0,0,6,0,0,0,0,0,0,0,0
270530107001005,56,East Harriet,70,70,1000000US270530107001005,"Block 1005, Block Group 1, Census Tract 107, Hennepin County, Minnesota",72,60,4,0,4,0,1,3,72,70,60,4,0,4,0,0,2,2,0,0,0,0,0,1,1
270530107001004,56,East Harriet,70,70,1000000US270530107001004,"Block 1004, Block Group 1, Census Tract 107, Hennepin County, Minnesota",90,80,9,0,0,0,0,1,90,87,77,9,0,0,0,0,1,3,3,0,0,0,0,0,0
270530107003010,56,East Harriet,70,70,1000000US270530107003010,"Block 3010, Block Group 3, Census Tract 107, Hennepin County, Minnesota",85,71,1,0,7,0,0,6,85,85,71,1,0,7,0,0,6,0,0,0,0,0,0,0,0
270530107001007,56,East Harriet,70,70,1000000US270530107001007,"Block 1007, Block Group 1, Census Tract 107, Hennepin County, Minnesota",61,59,2,0,0,0,0,0,61,59,57,2,0,0,0,0,0,2,2,0,0,0,0,0,0
270530107001006,56,East Harriet,70,70,1000000US270530107001006,"Block 1006, Block Group 1, Census Tract 107, Hennepin County, Minnesota",84,79,2,1,2,0,0,0,84,84,79,2,1,2,0,0,0,0,0,0,0,0,0,0,0
270530107001003,56,East Harriet,70,70,1000000US270530107001003,"Block 1003, Block Group 1, Census Tract 107, Hennepin County, Minnesota",92,74,4,0,8,0,1,5,92,87,73,4,0,8,0,0,2,5,1,0,0,0,0,1,3
270531099004001,56,East Harriet,70,70,1000000US270531099004001,"Block 4001, Block Group 4, Census Tract 1099, Hennepin County, Minnesota",0,0,0,0,0,0,0,0,0,0,0,0,0,0,0,0,0,0,0,0,0,0,0,0,0
270531099004007,56,East Harriet,70,70,1000000US270531099004007,"Block 4007, Block Group 4, Census Tract 1099, Hennepin County, Minnesota",0,0,0,0,0,0,0,0,0,0,0,0,0,0,0,0,0,0,0,0,0,0,0,0,0
270531092002004,56,East Harriet,70,70,1000000US270531092002004,"Block 2004, Block Group 2, Census Tract 1092, Hennepin County, Minnesota",64,60,0,0,3,1,0,0,64,64,60,0,0,3,1,0,0,0,0,0,0,0,0,0,0
270531092002007,56,East Harriet,70,70,1000000US270531092002007,"Block 2007, Block Group 2, Census Tract 1092, Hennepin County, Minnesota",118,83,13,3,5,0,3,11,118,113,81,13,3,5,0,1,10,5,2,0,0,0,0,2,1
270531099004013,56,East Harriet,70,70,1000000US270531099004013,"Block 4013, Block Group 4, Census Tract 1099, Hennepin County, Minnesota",155,139,11,0,1,0,3,1,155,148,135,11,0,1,0,0,1,7,4,0,0,0,0,3,0
270531099004012,56,East Harriet,70,70,1000000US270531099004012,"Block 4012, Block Group 4, Census Tract 1099, Hennepin County, Minnesota",80,64,4,0,3,0,0,9,80,78,62,4,0,3,0,0,9,2,2,0,0,0,0,0,0
270530107003004,56,East Harriet,70,70,1000000US270530107003004,"Block 3004, Block Group 3, Census Tract 107, Hennepin County, Minnesota",47,43,0,0,0,0,1,3,47,46,43,0,0,0,0,0,3,1,0,0,0,0,0,1,0
270531099004011,56,East Harriet,70,70,1000000US270531099004011,"Block 4011, Block Group 4, Census Tract 1099, Hennepin County, Minnesota",86,78,2,2,0,0,2,2,86,81,76,1,2,0,0,0,2,5,2,1,0,0,0,2,0
270530107003012,56,East Harriet,70,70,1000000US270530107003012,"Block 3012, Block Group 3, Census Tract 107, Hennepin County, Minnesota",84,75,2,0,2,0,4,1,84,83,75,2,0,2,0,3,1,1,0,0,0,0,0,1,0
270531099004014,56,East Harriet,70,70,1000000US270531099004014,"Block 4014, Block Group 4, Census Tract 1099, Hennepin County, Minnesota",72,72,0,0,0,0,0,0,72,70,70,0,0,0,0,0,0,2,2,0,0,0,0,0,0
270530107001002,56,East Harriet,70,70,1000000US270530107001002,"Block 1002, Block Group 1, Census Tract 107, Hennepin County, Minnesota",99,84,1,1,1,0,0,12,99,97,83,1,0,1,0,0,12,2,1,0,1,0,0,0,0
270531099004020,56,East Harriet,70,70,1000000US270531099004020,"Block 4020, Block Group 4, Census Tract 1099, Hennepin County, Minnesota",65,63,2,0,0,0,0,0,65,65,63,2,0,0,0,0,0,0,0,0,0,0,0,0,0
270531108005009,57,King Field,71,71,1000000US270531108005009,"Block 5009, Block Group 5, Census Tract 1108, Hennepin County, Minnesota",55,41,10,1,1,0,0,2,55,55,41,10,1,1,0,0,2,0,0,0,0,0,0,0,0
270531108006005,57,King Field,71,71,1000000US270531108006005,"Block 6005, Block Group 6, Census Tract 1108, Hennepin County, Minnesota",68,53,9,0,1,0,0,5,68,68,53,9,0,1,0,0,5,0,0,0,0,0,0,0,0
270531108001009,57,King Field,71,71,1000000US270531108001009,"Block 1009, Block Group 1, Census Tract 1108, Hennepin County, Minnesota",65,56,2,1,0,0,2,4,65,63,56,2,1,0,0,0,4,2,0,0,0,0,0,2,0
270531108001003,57,King Field,71,71,1000000US270531108001003,"Block 1003, Block Group 1, Census Tract 1108, Hennepin County, Minnesota",161,49,80,0,0,0,7,25,161,124,32,77,0,0,0,0,15,37,17,3,0,0,0,7,10
270531108006006,57,King Field,71,71,1000000US270531108006006,"Block 6006, Block Group 6, Census Tract 1108, Hennepin County, Minnesota",62,53,3,2,0,0,0,4,62,60,51,3,2,0,0,0,4,2,2,0,0,0,0,0,0
270531108006007,57,King Field,71,71,1000000US270531108006007,"Block 6007, Block Group 6, Census Tract 1108, Hennepin County, Minnesota",64,60,2,0,2,0,0,0,64,64,60,2,0,2,0,0,0,0,0,0,0,0,0,0,0
270531108001008,57,King Field,71,71,1000000US270531108001008,"Block 1008, Block Group 1, Census Tract 1108, Hennepin County, Minnesota",74,63,0,0,2,0,7,2,74,71,63,0,0,2,0,5,1,3,0,0,0,0,0,2,1
270531093001000,57,King Field,71,71,1000000US270531093001000,"Block 1000, Block Group 1, Census Tract 1093, Hennepin County, Minnesota",0,0,0,0,0,0,0,0,0,0,0,0,0,0,0,0,0,0,0,0,0,0,0,0,0
270531093002006,57,King Field,71,71,1000000US270531093002006,"Block 2006, Block Group 2, Census Tract 1093, Hennepin County, Minnesota",105,89,5,3,4,0,2,2,105,95,85,5,0,4,0,0,1,10,4,0,3,0,0,2,1
270531099003003,57,King Field,71,71,1000000US270531099003003,"Block 3003, Block Group 3, Census Tract 1099, Hennepin County, Minnesota",89,76,1,1,7,0,1,3,89,85,73,1,1,7,0,0,3,4,3,0,0,0,0,1,0
270531108004005,57,King Field,71,71,1000000US270531108004005,"Block 4005, Block Group 4, Census Tract 1108, Hennepin County, Minnesota",28,24,0,0,2,0,2,0,28,24,24,0,0,0,0,0,0,4,0,0,0,2,0,2,0
270531108004004,57,King Field,71,71,1000000US270531108004004,"Block 4004, Block Group 4, Census Tract 1108, Hennepin County, Minnesota",32,28,1,0,2,0,1,0,32,32,28,1,0,2,0,1,0,0,0,0,0,0,0,0,0
270531093002008,57,King Field,71,71,1000000US270531093002008,"Block 2008, Block Group 2, Census Tract 1093, Hennepin County, Minnesota",102,92,3,2,1,0,0,4,102,99,89,3,2,1,0,0,4,3,3,0,0,0,0,0,0
270531093002009,57,King Field,71,71,1000000US270531093002009,"Block 2009, Block Group 2, Census Tract 1093, Hennepin County, Minnesota",53,48,3,0,0,0,2,0,53,51,48,3,0,0,0,0,0,2,0,0,0,0,0,2,0
270531099003001,57,King Field,71,71,1000000US270531099003001,"Block 3001, Block Group 3, Census Tract 1099, Hennepin County, Minnesota",66,64,0,0,0,0,0,2,66,66,64,0,0,0,0,0,2,0,0,0,0,0,0,0,0
270531093001003,57,King Field,71,71,1000000US270531093001003,"Block 1003, Block Group 1, Census Tract 1093, Hennepin County, Minnesota",108,83,4,0,2,0,15,4,108,88,80,4,0,2,0,0,2,20,3,0,0,0,0,15,2
270531099001004,57,King Field,71,71,1000000US270531099001004,"Block 1004, Block Group 1, Census Tract 1099, Hennepin County, Minnesota",107,87,7,0,3,0,2,8,107,101,85,7,0,3,0,1,5,6,2,0,0,0,0,1,3
270531099001002,57,King Field,71,71,1000000US270531099001002,"Block 1002, Block Group 1, Census Tract 1099, Hennepin County, Minnesota",179,100,28,0,12,0,18,21,179,128,73,28,0,12,0,0,15,51,27,0,0,0,0,18,6
270531099002013,57,King Field,71,71,1000000US270531099002013,"Block 2013, Block Group 2, Census Tract 1099, Hennepin County, Minnesota",81,76,0,0,5,0,0,0,81,77,72,0,0,5,0,0,0,4,4,0,0,0,0,0,0
270531099002016,57,King Field,71,71,1000000US270531099002016,"Block 2016, Block Group 2, Census Tract 1099, Hennepin County, Minnesota",63,50,10,0,1,0,0,2,63,62,49,10,0,1,0,0,2,1,1,0,0,0,0,0,0
270531099003005,57,King Field,71,71,1000000US270531099003005,"Block 3005, Block Group 3, Census Tract 1099, Hennepin County, Minnesota",72,66,3,0,0,0,3,0,72,69,66,3,0,0,0,0,0,3,0,0,0,0,0,3,0
270531099002008,57,King Field,71,71,1000000US270531099002008,"Block 2008, Block Group 2, Census Tract 1099, Hennepin County, Minnesota",65,50,10,1,4,0,0,0,65,64,49,10,1,4,0,0,0,1,1,0,0,0,0,0,0
270531099002009,57,King Field,71,71,1000000US270531099002009,"Block 2009, Block Group 2, Census Tract 1099, Hennepin County, Minnesota",66,62,0,3,1,0,0,0,66,62,58,0,3,1,0,0,0,4,4,0,0,0,0,0,0
270531099002010,57,King Field,71,71,1000000US270531099002010,"Block 2010, Block Group 2, Census Tract 1099, Hennepin County, Minnesota",80,75,0,0,0,0,5,0,80,77,72,0,0,0,0,5,0,3,3,0,0,0,0,0,0
270531099002011,57,King Field,71,71,1000000US270531099002011,"Block 2011, Block Group 2, Census Tract 1099, Hennepin County, Minnesota",64,54,0,0,1,0,2,7,64,52,51,0,0,1,0,0,0,12,3,0,0,0,0,2,7
270531099003004,57,King Field,71,71,1000000US270531099003004,"Block 3004, Block Group 3, Census Tract 1099, Hennepin County, Minnesota",80,72,0,0,0,0,0,8,80,77,70,0,0,0,0,0,7,3,2,0,0,0,0,0,1
270531108005008,57,King Field,71,71,1000000US270531108005008,"Block 5008, Block Group 5, Census Tract 1108, Hennepin County, Minnesota",70,63,6,1,0,0,0,0,70,68,61,6,1,0,0,0,0,2,2,0,0,0,0,0,0
270531108004000,57,King Field,71,71,1000000US270531108004000,"Block 4000, Block Group 4, Census Tract 1108, Hennepin County, Minnesota",56,48,0,2,5,0,0,1,56,55,47,0,2,5,0,0,1,1,1,0,0,0,0,0,0
270531099003002,57,King Field,71,71,1000000US270531099003002,"Block 3002, Block Group 3, Census Tract 1099, Hennepin County, Minnesota",102,92,4,1,1,0,0,4,102,95,89,3,0,1,0,0,2,7,3,1,1,0,0,0,2
270531093002005,57,King Field,71,71,1000000US270531093002005,"Block 2005, Block Group 2, Census Tract 1093, Hennepin County, Minnesota",71,61,0,0,5,0,0,5,71,68,58,0,0,5,0,0,5,3,3,0,0,0,0,0,0
270531093002002,57,King Field,71,71,1000000US270531093002002,"Block 2002, Block Group 2, Census Tract 1093, Hennepin County, Minnesota",98,81,10,0,4,0,1,2,98,96,80,10,0,4,0,0,2,2,1,0,0,0,0,1,0
270531099002007,57,King Field,71,71,1000000US270531099002007,"Block 2007, Block Group 2, Census Tract 1099, Hennepin County, Minnesota",60,55,0,0,3,0,0,2,60,60,55,0,0,3,0,0,2,0,0,0,0,0,0,0,0
270531099003007,57,King Field,71,71,1000000US270531099003007,"Block 3007, Block Group 3, Census Tract 1099, Hennepin County, Minnesota",86,84,1,0,0,0,0,1,86,84,82,1,0,0,0,0,1,2,2,0,0,0,0,0,0
270531108005003,57,King Field,71,71,1000000US270531108005003,"Block 5003, Block Group 5, Census Tract 1108, Hennepin County, Minnesota",72,62,0,0,0,0,0,10,72,68,61,0,0,0,0,0,7,4,1,0,0,0,0,0,3
270531108004002,57,King Field,71,71,1000000US270531108004002,"Block 4002, Block Group 4, Census Tract 1108, Hennepin County, Minnesota",64,56,5,1,1,0,0,1,64,64,56,5,1,1,0,0,1,0,0,0,0,0,0,0,0
270531108005006,57,King Field,71,71,1000000US270531108005006,"Block 5006, Block Group 5, Census Tract 1108, Hennepin County, Minnesota",78,76,0,0,1,0,0,1,78,77,76,0,0,1,0,0,0,1,0,0,0,0,0,0,1
270531108004007,57,King Field,71,71,1000000US270531108004007,"Block 4007, Block Group 4, Census Tract 1108, Hennepin County, Minnesota",73,62,2,3,1,0,0,5,73,72,62,2,3,1,0,0,4,1,0,0,0,0,0,0,1
270531108005005,57,King Field,71,71,1000000US270531108005005,"Block 5005, Block Group 5, Census Tract 1108, Hennepin County, Minnesota",59,50,1,0,4,0,3,1,59,51,45,1,0,4,0,0,1,8,5,0,0,0,0,3,0
270531108005002,57,King Field,71,71,1000000US270531108005002,"Block 5002, Block Group 5, Census Tract 1108, Hennepin County, Minnesota",66,63,0,0,1,0,0,2,66,65,63,0,0,1,0,0,1,1,0,0,0,0,0,0,1
270531108004006,57,King Field,71,71,1000000US270531108004006,"Block 4006, Block Group 4, Census Tract 1108, Hennepin County, Minnesota",68,66,2,0,0,0,0,0,68,68,66,2,0,0,0,0,0,0,0,0,0,0,0,0,0
270531108004008,57,King Field,71,71,1000000US270531108004008,"Block 4008, Block Group 4, Census Tract 1108, Hennepin County, Minnesota",77,71,2,0,0,0,0,4,77,74,70,2,0,0,0,0,2,3,1,0,0,0,0,0,2
270531093002001,57,King Field,71,71,1000000US270531093002001,"Block 2001, Block Group 2, Census Tract 1093, Hennepin County, Minnesota",107,87,3,1,7,0,3,6,107,101,84,3,1,6,0,2,5,6,3,0,0,1,0,1,1
270531099003008,57,King Field,71,71,1000000US270531099003008,"Block 3008, Block Group 3, Census Tract 1099, Hennepin County, Minnesota",72,69,1,1,1,0,0,0,72,72,69,1,1,1,0,0,0,0,0,0,0,0,0,0,0
270531099003009,57,King Field,71,71,1000000US270531099003009,"Block 3009, Block Group 3, Census Tract 1099, Hennepin County, Minnesota",103,95,4,0,2,0,0,2,103,103,95,4,0,2,0,0,2,0,0,0,0,0,0,0,0
270531108005000,57,King Field,71,71,1000000US270531108005000,"Block 5000, Block Group 5, Census Tract 1108, Hennepin County, Minnesota",100,78,10,2,2,0,1,7,100,97,76,10,2,2,0,0,7,3,2,0,0,0,0,1,0
270531093001002,57,King Field,71,71,1000000US270531093001002,"Block 1002, Block Group 1, Census Tract 1093, Hennepin County, Minnesota",168,74,54,2,3,0,19,16,168,100,32,53,2,3,0,0,10,68,42,1,0,0,0,19,6
270531093001007,57,King Field,71,71,1000000US270531093001007,"Block 1007, Block Group 1, Census Tract 1093, Hennepin County, Minnesota",132,60,23,5,4,0,34,6,132,60,23,23,5,4,0,0,5,72,37,0,0,0,0,34,1
270531108006001,57,King Field,71,71,1000000US270531108006001,"Block 6001, Block Group 6, Census Tract 1108, Hennepin County, Minnesota",100,70,26,0,0,0,2,2,100,91,65,25,0,0,0,1,0,9,5,1,0,0,0,1,2
270531093001004,57,King Field,71,71,1000000US270531093001004,"Block 1004, Block Group 1, Census Tract 1093, Hennepin County, Minnesota",100,91,6,0,1,0,1,1,100,92,83,6,0,1,0,1,1,8,8,0,0,0,0,0,0
270531099002004,57,King Field,71,71,1000000US270531099002004,"Block 2004, Block Group 2, Census Tract 1099, Hennepin County, Minnesota",85,80,0,0,0,0,0,5,85,83,79,0,0,0,0,0,4,2,1,0,0,0,0,0,1
270531093001005,57,King Field,71,71,1000000US270531093001005,"Block 1005, Block Group 1, Census Tract 1093, Hennepin County, Minnesota",81,74,4,0,1,0,0,2,81,80,73,4,0,1,0,0,2,1,1,0,0,0,0,0,0
270531099001003,57,King Field,71,71,1000000US270531099001003,"Block 1003, Block Group 1, Census Tract 1099, Hennepin County, Minnesota",131,82,33,0,1,0,7,8,131,124,82,32,0,1,0,1,8,7,0,1,0,0,0,6,0
270531099001005,57,King Field,71,71,1000000US270531099001005,"Block 1005, Block Group 1, Census Tract 1099, Hennepin County, Minnesota",57,48,0,0,3,0,5,1,57,51,47,0,0,3,0,0,1,6,1,0,0,0,0,5,0
270531093001001,57,King Field,71,71,1000000US270531093001001,"Block 1001, Block Group 1, Census Tract 1093, Hennepin County, Minnesota",99,37,37,13,4,0,6,2,99,83,33,34,11,4,0,0,1,16,4,3,2,0,0,6,1
270531099001008,57,King Field,71,71,1000000US270531099001008,"Block 1008, Block Group 1, Census Tract 1099, Hennepin County, Minnesota",94,53,19,5,0,0,9,8,94,82,52,19,3,0,0,0,8,12,1,0,2,0,0,9,0
270531099002003,57,King Field,71,71,1000000US270531099002003,"Block 2003, Block Group 2, Census Tract 1099, Hennepin County, Minnesota",78,70,0,0,3,0,0,5,78,75,70,0,0,3,0,0,2,3,0,0,0,0,0,0,3
270531108006004,57,King Field,71,71,1000000US270531108006004,"Block 6004, Block Group 6, Census Tract 1108, Hennepin County, Minnesota",93,80,6,0,4,0,0,3,93,90,77,6,0,4,0,0,3,3,3,0,0,0,0,0,0
270531099002002,57,King Field,71,71,1000000US270531099002002,"Block 2002, Block Group 2, Census Tract 1099, Hennepin County, Minnesota",81,65,8,0,0,0,6,2,81,81,65,8,0,0,0,6,2,0,0,0,0,0,0,0,0
270531099002005,57,King Field,71,71,1000000US270531099002005,"Block 2005, Block Group 2, Census Tract 1099, Hennepin County, Minnesota",70,57,1,0,3,0,0,9,70,69,56,1,0,3,0,0,9,1,1,0,0,0,0,0,0
270531099002001,57,King Field,71,71,1000000US270531099002001,"Block 2001, Block Group 2, Census Tract 1099, Hennepin County, Minnesota",67,53,8,1,2,0,0,3,67,65,52,8,0,2,0,0,3,2,1,0,1,0,0,0,0
270531093001008,57,King Field,71,71,1000000US270531093001008,"Block 1008, Block Group 1, Census Tract 1093, Hennepin County, Minnesota",135,73,21,5,2,0,21,13,135,78,40,21,5,2,0,7,3,57,33,0,0,0,0,14,10
270531099001006,57,King Field,71,71,1000000US270531099001006,"Block 1006, Block Group 1, Census Tract 1099, Hennepin County, Minnesota",31,17,2,0,0,0,12,0,31,15,13,2,0,0,0,0,0,16,4,0,0,0,0,12,0
270531108006002,57,King Field,71,71,1000000US270531108006002,"Block 6002, Block Group 6, Census Tract 1108, Hennepin County, Minnesota",49,42,4,0,1,1,0,1,49,46,41,3,0,1,0,0,1,3,1,1,0,0,1,0,0
270531108005001,57,King Field,71,71,1000000US270531108005001,"Block 5001, Block Group 5, Census Tract 1108, Hennepin County, Minnesota",61,59,1,0,0,0,1,0,61,58,58,0,0,0,0,0,0,3,1,1,0,0,0,1,0
270531099002015,57,King Field,71,71,1000000US270531099002015,"Block 2015, Block Group 2, Census Tract 1099, Hennepin County, Minnesota",67,61,0,0,1,0,0,5,67,66,61,0,0,0,0,0,5,1,0,0,0,1,0,0,0
270531099001001,57,King Field,71,71,1000000US270531099001001,"Block 1001, Block Group 1, Census Tract 1099, Hennepin County, Minnesota",63,36,19,0,0,1,3,4,63,60,35,19,0,0,1,1,4,3,1,0,0,0,0,2,0
270531093001009,57,King Field,71,71,1000000US270531093001009,"Block 1009, Block Group 1, Census Tract 1093, Hennepin County, Minnesota",0,0,0,0,0,0,0,0,0,0,0,0,0,0,0,0,0,0,0,0,0,0,0,0,0
270531099002000,57,King Field,71,71,1000000US270531099002000,"Block 2000, Block Group 2, Census Tract 1099, Hennepin County, Minnesota",0,0,0,0,0,0,0,0,0,0,0,0,0,0,0,0,0,0,0,0,0,0,0,0,0
270531108004001,57,King Field,71,71,1000000US270531108004001,"Block 4001, Block Group 4, Census Tract 1108, Hennepin County, Minnesota",57,52,0,0,1,0,0,4,57,55,52,0,0,0,0,0,3,2,0,0,0,1,0,0,1
270531108001005,57,King Field,71,71,1000000US270531108001005,"Block 1005, Block Group 1, Census Tract 1108, Hennepin County, Minnesota",63,51,3,3,0,0,0,6,63,55,47,3,3,0,0,0,2,8,4,0,0,0,0,0,4
270531108001010,57,King Field,71,71,1000000US270531108001010,"Block 1010, Block Group 1, Census Tract 1108, Hennepin County, Minnesota",52,43,3,0,0,0,6,0,52,46,43,3,0,0,0,0,0,6,0,0,0,0,0,6,0
270531108006000,57,King Field,71,71,1000000US270531108006000,"Block 6000, Block Group 6, Census Tract 1108, Hennepin County, Minnesota",73,59,4,5,1,0,4,0,73,66,53,4,4,1,0,4,0,7,6,0,1,0,0,0,0
270531108001001,57,King Field,71,71,1000000US270531108001001,"Block 1001, Block Group 1, Census Tract 1108, Hennepin County, Minnesota",86,50,23,2,2,0,7,2,86,73,45,23,2,2,0,0,1,13,5,0,0,0,0,7,1
270531108004010,57,King Field,71,71,1000000US270531108004010,"Block 4010, Block Group 4, Census Tract 1108, Hennepin County, Minnesota",72,65,4,0,0,0,1,2,72,72,65,4,0,0,0,1,2,0,0,0,0,0,0,0,0
270531108001007,57,King Field,71,71,1000000US270531108001007,"Block 1007, Block Group 1, Census Tract 1108, Hennepin County, Minnesota",79,68,3,0,1,0,0,7,79,76,65,3,0,1,0,0,7,3,3,0,0,0,0,0,0
270531108001004,57,King Field,71,71,1000000US270531108001004,"Block 1004, Block Group 1, Census Tract 1108, Hennepin County, Minnesota",73,48,19,0,0,0,4,2,73,69,48,19,0,0,0,0,2,4,0,0,0,0,0,4,0
270531108006009,57,King Field,71,71,1000000US270531108006009,"Block 6009, Block Group 6, Census Tract 1108, Hennepin County, Minnesota",55,42,9,0,0,0,4,0,55,49,40,9,0,0,0,0,0,6,2,0,0,0,0,4,0
270531108001002,57,King Field,71,71,1000000US270531108001002,"Block 1002, Block Group 1, Census Tract 1108, Hennepin County, Minnesota",80,52,18,0,0,0,1,9,80,78,51,18,0,0,0,0,9,2,1,0,0,0,0,1,0
270531108004009,57,King Field,71,71,1000000US270531108004009,"Block 4009, Block Group 4, Census Tract 1108, Hennepin County, Minnesota",84,79,0,1,3,0,0,1,84,81,78,0,0,3,0,0,0,3,1,0,1,0,0,0,1
270531108001006,57,King Field,71,71,1000000US270531108001006,"Block 1006, Block Group 1, Census Tract 1108, Hennepin County, Minnesota",65,54,8,0,2,0,1,0,65,64,54,8,0,1,0,1,0,1,0,0,0,1,0,0,0
270531108001000,57,King Field,71,71,1000000US270531108001000,"Block 1000, Block Group 1, Census Tract 1108, Hennepin County, Minnesota",0,0,0,0,0,0,0,0,0,0,0,0,0,0,0,0,0,0,0,0,0,0,0,0,0
270531093001006,57,King Field,71,71,1000000US270531093001006,"Block 1006, Block Group 1, Census Tract 1093, Hennepin County, Minnesota",64,50,5,0,1,0,3,5,64,52,45,4,0,1,0,0,2,12,5,1,0,0,0,3,3
270531099002014,57,King Field,71,71,1000000US270531099002014,"Block 2014, Block Group 2, Census Tract 1099, Hennepin County, Minnesota",71,64,0,1,3,0,0,3,71,68,62,0,0,3,0,0,3,3,2,0,1,0,0,0,0
270531093002003,57,King Field,71,71,1000000US270531093002003,"Block 2003, Block Group 2, Census Tract 1093, Hennepin County, Minnesota",88,85,2,0,0,0,1,0,88,84,82,2,0,0,0,0,0,4,3,0,0,0,0,1,0
270531099003006,57,King Field,71,71,1000000US270531099003006,"Block 3006, Block Group 3, Census Tract 1099, Hennepin County, Minnesota",88,83,2,1,0,0,1,1,88,80,75,2,1,0,0,1,1,8,8,0,0,0,0,0,0
270531108006003,57,King Field,71,71,1000000US270531108006003,"Block 6003, Block Group 6, Census Tract 1108, Hennepin County, Minnesota",63,57,2,0,1,0,0,3,63,63,57,2,0,1,0,0,3,0,0,0,0,0,0,0,0
270531093002000,57,King Field,71,71,1000000US270531093002000,"Block 2000, Block Group 2, Census Tract 1093, Hennepin County, Minnesota",82,75,0,0,0,0,2,5,82,78,73,0,0,0,0,0,5,4,2,0,0,0,0,2,0
270531099001000,57,King Field,71,71,1000000US270531099001000,"Block 1000, Block Group 1, Census Tract 1099, Hennepin County, Minnesota",77,65,3,0,1,0,2,6,77,68,61,3,0,1,0,0,3,9,4,0,0,0,0,2,3
270531099001007,57,King Field,71,71,1000000US270531099001007,"Block 1007, Block Group 1, Census Tract 1099, Hennepin County, Minnesota",89,55,20,2,1,0,8,3,89,76,51,19,2,1,0,0,3,13,4,1,0,0,0,8,0
270531099003000,57,King Field,71,71,1000000US270531099003000,"Block 3000, Block Group 3, Census Tract 1099, Hennepin County, Minnesota",75,65,0,0,7,0,3,0,75,72,65,0,0,7,0,0,0,3,0,0,0,0,0,3,0
270531099002012,57,King Field,71,71,1000000US270531099002012,"Block 2012, Block Group 2, Census Tract 1099, Hennepin County, Minnesota",82,67,6,0,4,0,2,3,82,81,66,6,0,4,0,2,3,1,1,0,0,0,0,0,0
270531093002004,57,King Field,71,71,1000000US270531093002004,"Block 2004, Block Group 2, Census Tract 1093, Hennepin County, Minnesota",58,54,2,0,0,0,0,2,58,56,53,2,0,0,0,0,1,2,1,0,0,0,0,0,1
270531093002007,57,King Field,71,71,1000000US270531093002007,"Block 2007, Block Group 2, Census Tract 1093, Hennepin County, Minnesota",174,142,3,2,3,0,18,6,174,129,120,3,0,3,0,0,3,45,22,0,2,0,0,18,3
270531108006008,57,King Field,71,71,1000000US270531108006008,"Block 6008, Block Group 6, Census Tract 1108, Hennepin County, Minnesota",33,28,2,1,1,0,0,1,33,33,28,2,1,1,0,0,1,0,0,0,0,0,0,0,0
270531099002006,57,King Field,71,71,1000000US270531099002006,"Block 2006, Block Group 2, Census Tract 1099, Hennepin County, Minnesota",76,67,4,0,2,0,1,2,76,74,66,4,0,2,0,0,2,2,1,0,0,0,0,1,0
270531108005004,57,King Field,71,71,1000000US270531108005004,"Block 5004, Block Group 5, Census Tract 1108, Hennepin County, Minnesota",56,49,2,0,2,0,0,3,56,51,44,2,0,2,0,0,3,5,5,0,0,0,0,0,0
270531108004003,57,King Field,71,71,1000000US270531108004003,"Block 4003, Block Group 4, Census Tract 1108, Hennepin County, Minnesota",65,61,0,0,2,0,0,2,65,64,60,0,0,2,0,0,2,1,1,0,0,0,0,0,0
270531108005007,57,King Field,71,71,1000000US270531108005007,"Block 5007, Block Group 5, Census Tract 1108, Hennepin County, Minnesota",80,73,4,1,1,0,0,1,80,80,73,4,1,1,0,0,1,0,0,0,0,0,0,0,0
270530121024011,58,Morris Park,84,84,1000000US270530121024011,"Block 4011, Block Group 4, Census Tract 121.02, Hennepin County, Minnesota",46,35,3,0,5,0,0,3,46,46,35,3,0,5,0,0,3,0,0,0,0,0,0,0,0
270530121022009,58,Morris Park,84,84,1000000US270530121022009,"Block 2009, Block Group 2, Census Tract 121.02, Hennepin County, Minnesota",0,0,0,0,0,0,0,0,0,0,0,0,0,0,0,0,0,0,0,0,0,0,0,0,0
270530121022004,58,Morris Park,84,84,1000000US270530121022004,"Block 2004, Block Group 2, Census Tract 121.02, Hennepin County, Minnesota",46,37,0,1,2,0,6,0,46,35,32,0,1,2,0,0,0,11,5,0,0,0,0,6,0
270530121024002,58,Morris Park,84,84,1000000US270530121024002,"Block 4002, Block Group 4, Census Tract 121.02, Hennepin County, Minnesota",62,54,0,1,0,0,3,4,62,50,49,0,1,0,0,0,0,12,5,0,0,0,0,3,4
270530121023005,58,Morris Park,84,84,1000000US270530121023005,"Block 3005, Block Group 3, Census Tract 121.02, Hennepin County, Minnesota",1,1,0,0,0,0,0,0,1,1,1,0,0,0,0,0,0,0,0,0,0,0,0,0,0
270530121023000,58,Morris Park,84,84,1000000US270530121023000,"Block 3000, Block Group 3, Census Tract 121.02, Hennepin County, Minnesota",36,20,3,5,0,0,1,7,36,34,20,3,4,0,0,0,7,2,0,0,1,0,0,1,0
270530121021003,58,Morris Park,84,84,1000000US270530121021003,"Block 1003, Block Group 1, Census Tract 121.02, Hennepin County, Minnesota",46,42,1,3,0,0,0,0,46,44,40,1,3,0,0,0,0,2,2,0,0,0,0,0,0
270530121021010,58,Morris Park,84,84,1000000US270530121021010,"Block 1010, Block Group 1, Census Tract 121.02, Hennepin County, Minnesota",63,56,4,0,2,0,0,1,63,62,56,4,0,2,0,0,0,1,0,0,0,0,0,0,1
270530121021000,58,Morris Park,84,84,1000000US270530121021000,"Block 1000, Block Group 1, Census Tract 121.02, Hennepin County, Minnesota",74,52,6,0,0,0,10,6,74,63,51,6,0,0,0,0,6,11,1,0,0,0,0,10,0
270530121024006,58,Morris Park,84,84,1000000US270530121024006,"Block 4006, Block Group 4, Census Tract 121.02, Hennepin County, Minnesota",49,38,7,1,1,0,1,1,49,41,32,6,1,1,0,0,1,8,6,1,0,0,0,1,0
270530121021004,58,Morris Park,84,84,1000000US270530121021004,"Block 1004, Block Group 1, Census Tract 121.02, Hennepin County, Minnesota",63,52,5,4,0,0,0,2,63,63,52,5,4,0,0,0,2,0,0,0,0,0,0,0,0
270530121022011,58,Morris Park,84,84,1000000US270530121022011,"Block 2011, Block Group 2, Census Tract 121.02, Hennepin County, Minnesota",0,0,0,0,0,0,0,0,0,0,0,0,0,0,0,0,0,0,0,0,0,0,0,0,0
270530121024010,58,Morris Park,84,84,1000000US270530121024010,"Block 4010, Block Group 4, Census Tract 121.02, Hennepin County, Minnesota",46,26,11,0,0,0,0,9,46,45,26,11,0,0,0,0,8,1,0,0,0,0,0,0,1
270530121022006,58,Morris Park,84,84,1000000US270530121022006,"Block 2006, Block Group 2, Census Tract 121.02, Hennepin County, Minnesota",51,27,0,0,14,0,9,1,51,42,27,0,0,14,0,0,1,9,0,0,0,0,0,9,0
270530121022002,58,Morris Park,84,84,1000000US270530121022002,"Block 2002, Block Group 2, Census Tract 121.02, Hennepin County, Minnesota",40,40,0,0,0,0,0,0,40,39,39,0,0,0,0,0,0,1,1,0,0,0,0,0,0
270530121022001,58,Morris Park,84,84,1000000US270530121022001,"Block 2001, Block Group 2, Census Tract 121.02, Hennepin County, Minnesota",40,33,4,0,0,0,0,3,40,36,29,4,0,0,0,0,3,4,4,0,0,0,0,0,0
270530121022016,58,Morris Park,84,84,1000000US270530121022016,"Block 2016, Block Group 2, Census Tract 121.02, Hennepin County, Minnesota",71,54,11,0,4,0,2,0,71,61,46,11,0,4,0,0,0,10,8,0,0,0,0,2,0
270530121024008,58,Morris Park,84,84,1000000US270530121024008,"Block 4008, Block Group 4, Census Tract 121.02, Hennepin County, Minnesota",47,45,0,0,0,0,0,2,47,47,45,0,0,0,0,0,2,0,0,0,0,0,0,0,0
270530121023002,58,Morris Park,84,84,1000000US270530121023002,"Block 3002, Block Group 3, Census Tract 121.02, Hennepin County, Minnesota",48,47,0,0,0,0,0,1,48,48,47,0,0,0,0,0,1,0,0,0,0,0,0,0,0
270530121023006,58,Morris Park,84,84,1000000US270530121023006,"Block 3006, Block Group 3, Census Tract 121.02, Hennepin County, Minnesota",59,42,6,3,0,0,2,6,59,55,42,6,3,0,0,0,4,4,0,0,0,0,0,2,2
270530121023009,58,Morris Park,84,84,1000000US270530121023009,"Block 3009, Block Group 3, Census Tract 121.02, Hennepin County, Minnesota",52,41,5,4,1,0,0,1,52,52,41,5,4,1,0,0,1,0,0,0,0,0,0,0,0
270530121021009,58,Morris Park,84,84,1000000US270530121021009,"Block 1009, Block Group 1, Census Tract 121.02, Hennepin County, Minnesota",48,45,2,0,0,0,0,1,48,46,43,2,0,0,0,0,1,2,2,0,0,0,0,0,0
270530121022013,58,Morris Park,84,84,1000000US270530121022013,"Block 2013, Block Group 2, Census Tract 121.02, Hennepin County, Minnesota",0,0,0,0,0,0,0,0,0,0,0,0,0,0,0,0,0,0,0,0,0,0,0,0,0
270530121023001,58,Morris Park,84,84,1000000US270530121023001,"Block 3001, Block Group 3, Census Tract 121.02, Hennepin County, Minnesota",48,34,10,0,4,0,0,0,48,48,34,10,0,4,0,0,0,0,0,0,0,0,0,0,0
270530121023003,58,Morris Park,84,84,1000000US270530121023003,"Block 3003, Block Group 3, Census Tract 121.02, Hennepin County, Minnesota",51,47,4,0,0,0,0,0,51,51,47,4,0,0,0,0,0,0,0,0,0,0,0,0,0
270530121023007,58,Morris Park,84,84,1000000US270530121023007,"Block 3007, Block Group 3, Census Tract 121.02, Hennepin County, Minnesota",61,52,0,0,5,0,0,4,61,60,51,0,0,5,0,0,4,1,1,0,0,0,0,0,0
270530121022040,58,Morris Park,84,84,1000000US270530121022040,"Block 2040, Block Group 2, Census Tract 121.02, Hennepin County, Minnesota",0,0,0,0,0,0,0,0,0,0,0,0,0,0,0,0,0,0,0,0,0,0,0,0,0
270530121022008,58,Morris Park,84,84,1000000US270530121022008,"Block 2008, Block Group 2, Census Tract 121.02, Hennepin County, Minnesota",0,0,0,0,0,0,0,0,0,0,0,0,0,0,0,0,0,0,0,0,0,0,0,0,0
270530121022017,58,Morris Park,84,84,1000000US270530121022017,"Block 2017, Block Group 2, Census Tract 121.02, Hennepin County, Minnesota",78,67,6,0,3,0,0,2,78,62,51,6,0,3,0,0,2,16,16,0,0,0,0,0,0
270530121022021,58,Morris Park,84,84,1000000US270530121022021,"Block 2021, Block Group 2, Census Tract 121.02, Hennepin County, Minnesota",0,0,0,0,0,0,0,0,0,0,0,0,0,0,0,0,0,0,0,0,0,0,0,0,0
270530121022022,58,Morris Park,84,84,1000000US270530121022022,"Block 2022, Block Group 2, Census Tract 121.02, Hennepin County, Minnesota",0,0,0,0,0,0,0,0,0,0,0,0,0,0,0,0,0,0,0,0,0,0,0,0,0
270530121022036,58,Morris Park,84,84,1000000US270530121022036,"Block 2036, Block Group 2, Census Tract 121.02, Hennepin County, Minnesota",0,0,0,0,0,0,0,0,0,0,0,0,0,0,0,0,0,0,0,0,0,0,0,0,0
270530121022014,58,Morris Park,84,84,1000000US270530121022014,"Block 2014, Block Group 2, Census Tract 121.02, Hennepin County, Minnesota",0,0,0,0,0,0,0,0,0,0,0,0,0,0,0,0,0,0,0,0,0,0,0,0,0
270530121021008,58,Morris Park,84,84,1000000US270530121021008,"Block 1008, Block Group 1, Census Tract 121.02, Hennepin County, Minnesota",64,43,2,0,4,0,15,0,64,49,43,2,0,4,0,0,0,15,0,0,0,0,0,15,0
270530121022007,58,Morris Park,84,84,1000000US270530121022007,"Block 2007, Block Group 2, Census Tract 121.02, Hennepin County, Minnesota",44,33,4,0,0,0,4,3,44,37,30,4,0,0,0,0,3,7,3,0,0,0,0,4,0
270530121022010,58,Morris Park,84,84,1000000US270530121022010,"Block 2010, Block Group 2, Census Tract 121.02, Hennepin County, Minnesota",0,0,0,0,0,0,0,0,0,0,0,0,0,0,0,0,0,0,0,0,0,0,0,0,0
270530121022003,58,Morris Park,84,84,1000000US270530121022003,"Block 2003, Block Group 2, Census Tract 121.02, Hennepin County, Minnesota",46,40,4,0,2,0,0,0,46,43,37,4,0,2,0,0,0,3,3,0,0,0,0,0,0
270530121022034,58,Morris Park,84,84,1000000US270530121022034,"Block 2034, Block Group 2, Census Tract 121.02, Hennepin County, Minnesota",0,0,0,0,0,0,0,0,0,0,0,0,0,0,0,0,0,0,0,0,0,0,0,0,0
270530121023004,58,Morris Park,84,84,1000000US270530121023004,"Block 3004, Block Group 3, Census Tract 121.02, Hennepin County, Minnesota",34,34,0,0,0,0,0,0,34,31,31,0,0,0,0,0,0,3,3,0,0,0,0,0,0
270530121022037,58,Morris Park,84,84,1000000US270530121022037,"Block 2037, Block Group 2, Census Tract 121.02, Hennepin County, Minnesota",0,0,0,0,0,0,0,0,0,0,0,0,0,0,0,0,0,0,0,0,0,0,0,0,0
270530121024001,58,Morris Park,84,84,1000000US270530121024001,"Block 4001, Block Group 4, Census Tract 121.02, Hennepin County, Minnesota",101,85,6,5,0,0,1,4,101,97,82,6,5,0,0,0,4,4,3,0,0,0,0,1,0
270530121024000,58,Morris Park,84,84,1000000US270530121024000,"Block 4000, Block Group 4, Census Tract 121.02, Hennepin County, Minnesota",96,80,5,1,1,0,1,8,96,92,79,5,1,1,0,0,6,4,1,0,0,0,0,1,2
270530121022030,58,Morris Park,84,84,1000000US270530121022030,"Block 2030, Block Group 2, Census Tract 121.02, Hennepin County, Minnesota",0,0,0,0,0,0,0,0,0,0,0,0,0,0,0,0,0,0,0,0,0,0,0,0,0
270530121024003,58,Morris Park,84,84,1000000US270530121024003,"Block 4003, Block Group 4, Census Tract 121.02, Hennepin County, Minnesota",76,27,11,0,0,0,28,10,76,45,27,11,0,0,0,0,7,31,0,0,0,0,0,28,3
270530121024004,58,Morris Park,84,84,1000000US270530121024004,"Block 4004, Block Group 4, Census Tract 121.02, Hennepin County, Minnesota",158,89,32,5,0,0,28,4,158,122,86,29,5,0,0,1,1,36,3,3,0,0,0,27,3
270530121022020,58,Morris Park,84,84,1000000US270530121022020,"Block 2020, Block Group 2, Census Tract 121.02, Hennepin County, Minnesota",0,0,0,0,0,0,0,0,0,0,0,0,0,0,0,0,0,0,0,0,0,0,0,0,0
270530121024007,58,Morris Park,84,84,1000000US270530121024007,"Block 4007, Block Group 4, Census Tract 121.02, Hennepin County, Minnesota",57,42,9,0,1,0,1,4,57,57,42,9,0,1,0,1,4,0,0,0,0,0,0,0,0
270530121021006,58,Morris Park,84,84,1000000US270530121021006,"Block 1006, Block Group 1, Census Tract 121.02, Hennepin County, Minnesota",50,47,0,0,0,0,3,0,50,44,44,0,0,0,0,0,0,6,3,0,0,0,0,3,0
270530121024012,58,Morris Park,84,84,1000000US270530121024012,"Block 4012, Block Group 4, Census Tract 121.02, Hennepin County, Minnesota",57,44,1,9,0,0,0,3,57,53,43,1,6,0,0,0,3,4,1,0,3,0,0,0,0
270530121022005,58,Morris Park,84,84,1000000US270530121022005,"Block 2005, Block Group 2, Census Tract 121.02, Hennepin County, Minnesota",33,28,0,0,0,0,3,2,33,29,28,0,0,0,0,0,1,4,0,0,0,0,0,3,1
270530121022015,58,Morris Park,84,84,1000000US270530121022015,"Block 2015, Block Group 2, Census Tract 121.02, Hennepin County, Minnesota",56,50,6,0,0,0,0,0,56,51,46,5,0,0,0,0,0,5,4,1,0,0,0,0,0
270530121022012,58,Morris Park,84,84,1000000US270530121022012,"Block 2012, Block Group 2, Census Tract 121.02, Hennepin County, Minnesota",0,0,0,0,0,0,0,0,0,0,0,0,0,0,0,0,0,0,0,0,0,0,0,0,0
270530121022023,58,Morris Park,84,84,1000000US270530121022023,"Block 2023, Block Group 2, Census Tract 121.02, Hennepin County, Minnesota",0,0,0,0,0,0,0,0,0,0,0,0,0,0,0,0,0,0,0,0,0,0,0,0,0
270530121022028,58,Morris Park,84,84,1000000US270530121022028,"Block 2028, Block Group 2, Census Tract 121.02, Hennepin County, Minnesota",0,0,0,0,0,0,0,0,0,0,0,0,0,0,0,0,0,0,0,0,0,0,0,0,0
270530121022025,58,Morris Park,84,84,1000000US270530121022025,"Block 2025, Block Group 2, Census Tract 121.02, Hennepin County, Minnesota",0,0,0,0,0,0,0,0,0,0,0,0,0,0,0,0,0,0,0,0,0,0,0,0,0
270530121024005,58,Morris Park,84,84,1000000US270530121024005,"Block 4005, Block Group 4, Census Tract 121.02, Hennepin County, Minnesota",47,38,2,0,0,0,4,3,47,39,34,2,0,0,0,0,3,8,4,0,0,0,0,4,0
270530121023011,58,Morris Park,84,84,1000000US270530121023011,"Block 3011, Block Group 3, Census Tract 121.02, Hennepin County, Minnesota",69,66,3,0,0,0,0,0,69,68,65,3,0,0,0,0,0,1,1,0,0,0,0,0,0
270530121021011,58,Morris Park,84,84,1000000US270530121021011,"Block 1011, Block Group 1, Census Tract 121.02, Hennepin County, Minnesota",67,53,6,0,0,0,1,7,67,56,49,6,0,0,0,0,1,11,4,0,0,0,0,1,6
270530121021005,58,Morris Park,84,84,1000000US270530121021005,"Block 1005, Block Group 1, Census Tract 121.02, Hennepin County, Minnesota",53,45,2,0,0,0,1,5,53,48,45,2,0,0,0,0,1,5,0,0,0,0,0,1,4
270530121022018,58,Morris Park,84,84,1000000US270530121022018,"Block 2018, Block Group 2, Census Tract 121.02, Hennepin County, Minnesota",82,44,15,7,0,0,0,16,82,67,38,15,7,0,0,0,7,15,6,0,0,0,0,0,9
270530121022035,58,Morris Park,84,84,1000000US270530121022035,"Block 2035, Block Group 2, Census Tract 121.02, Hennepin County, Minnesota",0,0,0,0,0,0,0,0,0,0,0,0,0,0,0,0,0,0,0,0,0,0,0,0,0
270530121022038,58,Morris Park,84,84,1000000US270530121022038,"Block 2038, Block Group 2, Census Tract 121.02, Hennepin County, Minnesota",0,0,0,0,0,0,0,0,0,0,0,0,0,0,0,0,0,0,0,0,0,0,0,0,0
270530121022039,58,Morris Park,84,84,1000000US270530121022039,"Block 2039, Block Group 2, Census Tract 121.02, Hennepin County, Minnesota",0,0,0,0,0,0,0,0,0,0,0,0,0,0,0,0,0,0,0,0,0,0,0,0,0
270530121022024,58,Morris Park,84,84,1000000US270530121022024,"Block 2024, Block Group 2, Census Tract 121.02, Hennepin County, Minnesota",0,0,0,0,0,0,0,0,0,0,0,0,0,0,0,0,0,0,0,0,0,0,0,0,0
270530121022026,58,Morris Park,84,84,1000000US270530121022026,"Block 2026, Block Group 2, Census Tract 121.02, Hennepin County, Minnesota",0,0,0,0,0,0,0,0,0,0,0,0,0,0,0,0,0,0,0,0,0,0,0,0,0
270530121022032,58,Morris Park,84,84,1000000US270530121022032,"Block 2032, Block Group 2, Census Tract 121.02, Hennepin County, Minnesota",0,0,0,0,0,0,0,0,0,0,0,0,0,0,0,0,0,0,0,0,0,0,0,0,0
270530121024009,58,Morris Park,84,84,1000000US270530121024009,"Block 4009, Block Group 4, Census Tract 121.02, Hennepin County, Minnesota",57,49,0,0,3,0,4,1,57,48,44,0,0,3,0,0,1,9,5,0,0,0,0,4,0
270530121021002,58,Morris Park,84,84,1000000US270530121021002,"Block 1002, Block Group 1, Census Tract 121.02, Hennepin County, Minnesota",62,50,3,0,0,0,9,0,62,53,50,3,0,0,0,0,0,9,0,0,0,0,0,9,0
270530121023010,58,Morris Park,84,84,1000000US270530121023010,"Block 3010, Block Group 3, Census Tract 121.02, Hennepin County, Minnesota",63,48,4,0,3,0,3,5,63,63,48,4,0,3,0,3,5,0,0,0,0,0,0,0,0
270530121022000,58,Morris Park,84,84,1000000US270530121022000,"Block 2000, Block Group 2, Census Tract 121.02, Hennepin County, Minnesota",42,28,1,2,0,0,8,3,42,34,28,1,2,0,0,0,3,8,0,0,0,0,0,8,0
270530121023008,58,Morris Park,84,84,1000000US270530121023008,"Block 3008, Block Group 3, Census Tract 121.02, Hennepin County, Minnesota",59,58,1,0,0,0,0,0,59,59,58,1,0,0,0,0,0,0,0,0,0,0,0,0,0
270530121021001,58,Morris Park,84,84,1000000US270530121021001,"Block 1001, Block Group 1, Census Tract 121.02, Hennepin County, Minnesota",68,50,4,0,0,0,7,7,68,55,44,4,0,0,0,0,7,13,6,0,0,0,0,7,0
270530121021007,58,Morris Park,84,84,1000000US270530121021007,"Block 1007, Block Group 1, Census Tract 121.02, Hennepin County, Minnesota",52,47,0,2,1,0,0,2,52,51,46,0,2,1,0,0,2,1,1,0,0,0,0,0,0
270531040001014,59,Mid - City Industrial,85,85,1000000US270531040001014,"Block 1014, Block Group 1, Census Tract 1040, Hennepin County, Minnesota",0,0,0,0,0,0,0,0,0,0,0,0,0,0,0,0,0,0,0,0,0,0,0,0,0
270531040005005,59,Mid - City Industrial,85,85,1000000US270531040005005,"Block 5005, Block Group 5, Census Tract 1040, Hennepin County, Minnesota",0,0,0,0,0,0,0,0,0,0,0,0,0,0,0,0,0,0,0,0,0,0,0,0,0
270531040005026,59,Mid - City Industrial,85,85,1000000US270531040005026,"Block 5026, Block Group 5, Census Tract 1040, Hennepin County, Minnesota",10,7,1,0,2,0,0,0,10,10,7,1,0,2,0,0,0,0,0,0,0,0,0,0,0
270531040005015,59,Mid - City Industrial,85,85,1000000US270531040005015,"Block 5015, Block Group 5, Census Tract 1040, Hennepin County, Minnesota",0,0,0,0,0,0,0,0,0,0,0,0,0,0,0,0,0,0,0,0,0,0,0,0,0
270531040005020,59,Mid - City Industrial,85,85,1000000US270531040005020,"Block 5020, Block Group 5, Census Tract 1040, Hennepin County, Minnesota",62,57,0,0,4,0,0,1,62,61,57,0,0,4,0,0,0,1,0,0,0,0,0,0,1
270531040001000,59,Mid - City Industrial,85,85,1000000US270531040001000,"Block 1000, Block Group 1, Census Tract 1040, Hennepin County, Minnesota",0,0,0,0,0,0,0,0,0,0,0,0,0,0,0,0,0,0,0,0,0,0,0,0,0
270531040001003,59,Mid - City Industrial,85,85,1000000US270531040001003,"Block 1003, Block Group 1, Census Tract 1040, Hennepin County, Minnesota",0,0,0,0,0,0,0,0,0,0,0,0,0,0,0,0,0,0,0,0,0,0,0,0,0
270531040001004,59,Mid - City Industrial,85,85,1000000US270531040001004,"Block 1004, Block Group 1, Census Tract 1040, Hennepin County, Minnesota",0,0,0,0,0,0,0,0,0,0,0,0,0,0,0,0,0,0,0,0,0,0,0,0,0
270531040005004,59,Mid - City Industrial,85,85,1000000US270531040005004,"Block 5004, Block Group 5, Census Tract 1040, Hennepin County, Minnesota",0,0,0,0,0,0,0,0,0,0,0,0,0,0,0,0,0,0,0,0,0,0,0,0,0
270531040001011,59,Mid - City Industrial,85,85,1000000US270531040001011,"Block 1011, Block Group 1, Census Tract 1040, Hennepin County, Minnesota",0,0,0,0,0,0,0,0,0,0,0,0,0,0,0,0,0,0,0,0,0,0,0,0,0
270531040005010,59,Mid - City Industrial,85,85,1000000US270531040005010,"Block 5010, Block Group 5, Census Tract 1040, Hennepin County, Minnesota",0,0,0,0,0,0,0,0,0,0,0,0,0,0,0,0,0,0,0,0,0,0,0,0,0
270531040001010,59,Mid - City Industrial,85,85,1000000US270531040001010,"Block 1010, Block Group 1, Census Tract 1040, Hennepin County, Minnesota",0,0,0,0,0,0,0,0,0,0,0,0,0,0,0,0,0,0,0,0,0,0,0,0,0
270531040005012,59,Mid - City Industrial,85,85,1000000US270531040005012,"Block 5012, Block Group 5, Census Tract 1040, Hennepin County, Minnesota",0,0,0,0,0,0,0,0,0,0,0,0,0,0,0,0,0,0,0,0,0,0,0,0,0
270531040001017,59,Mid - City Industrial,85,85,1000000US270531040001017,"Block 1017, Block Group 1, Census Tract 1040, Hennepin County, Minnesota",12,11,0,0,1,0,0,0,12,10,9,0,0,1,0,0,0,2,2,0,0,0,0,0,0
270531040001015,59,Mid - City Industrial,85,85,1000000US270531040001015,"Block 1015, Block Group 1, Census Tract 1040, Hennepin County, Minnesota",129,117,4,0,7,0,1,0,129,127,116,4,0,7,0,0,0,2,1,0,0,0,0,1,0
270531040005023,59,Mid - City Industrial,85,85,1000000US270531040005023,"Block 5023, Block Group 5, Census Tract 1040, Hennepin County, Minnesota",0,0,0,0,0,0,0,0,0,0,0,0,0,0,0,0,0,0,0,0,0,0,0,0,0
270531040005007,59,Mid - City Industrial,85,85,1000000US270531040005007,"Block 5007, Block Group 5, Census Tract 1040, Hennepin County, Minnesota",0,0,0,0,0,0,0,0,0,0,0,0,0,0,0,0,0,0,0,0,0,0,0,0,0
270531040005016,59,Mid - City Industrial,85,85,1000000US270531040005016,"Block 5016, Block Group 5, Census Tract 1040, Hennepin County, Minnesota",0,0,0,0,0,0,0,0,0,0,0,0,0,0,0,0,0,0,0,0,0,0,0,0,0
270531040005022,59,Mid - City Industrial,85,85,1000000US270531040005022,"Block 5022, Block Group 5, Census Tract 1040, Hennepin County, Minnesota",0,0,0,0,0,0,0,0,0,0,0,0,0,0,0,0,0,0,0,0,0,0,0,0,0
270531040001001,59,Mid - City Industrial,85,85,1000000US270531040001001,"Block 1001, Block Group 1, Census Tract 1040, Hennepin County, Minnesota",0,0,0,0,0,0,0,0,0,0,0,0,0,0,0,0,0,0,0,0,0,0,0,0,0
270531040005021,59,Mid - City Industrial,85,85,1000000US270531040005021,"Block 5021, Block Group 5, Census Tract 1040, Hennepin County, Minnesota",0,0,0,0,0,0,0,0,0,0,0,0,0,0,0,0,0,0,0,0,0,0,0,0,0
270531040001008,59,Mid - City Industrial,85,85,1000000US270531040001008,"Block 1008, Block Group 1, Census Tract 1040, Hennepin County, Minnesota",0,0,0,0,0,0,0,0,0,0,0,0,0,0,0,0,0,0,0,0,0,0,0,0,0
270531040001006,59,Mid - City Industrial,85,85,1000000US270531040001006,"Block 1006, Block Group 1, Census Tract 1040, Hennepin County, Minnesota",0,0,0,0,0,0,0,0,0,0,0,0,0,0,0,0,0,0,0,0,0,0,0,0,0
270531040001016,59,Mid - City Industrial,85,85,1000000US270531040001016,"Block 1016, Block Group 1, Census Tract 1040, Hennepin County, Minnesota",0,0,0,0,0,0,0,0,0,0,0,0,0,0,0,0,0,0,0,0,0,0,0,0,0
270531040001002,59,Mid - City Industrial,85,85,1000000US270531040001002,"Block 1002, Block Group 1, Census Tract 1040, Hennepin County, Minnesota",0,0,0,0,0,0,0,0,0,0,0,0,0,0,0,0,0,0,0,0,0,0,0,0,0
270531040005008,59,Mid - City Industrial,85,85,1000000US270531040005008,"Block 5008, Block Group 5, Census Tract 1040, Hennepin County, Minnesota",0,0,0,0,0,0,0,0,0,0,0,0,0,0,0,0,0,0,0,0,0,0,0,0,0
270531040001005,59,Mid - City Industrial,85,85,1000000US270531040001005,"Block 1005, Block Group 1, Census Tract 1040, Hennepin County, Minnesota",0,0,0,0,0,0,0,0,0,0,0,0,0,0,0,0,0,0,0,0,0,0,0,0,0
270531040005017,59,Mid - City Industrial,85,85,1000000US270531040005017,"Block 5017, Block Group 5, Census Tract 1040, Hennepin County, Minnesota",0,0,0,0,0,0,0,0,0,0,0,0,0,0,0,0,0,0,0,0,0,0,0,0,0
270531040005018,59,Mid - City Industrial,85,85,1000000US270531040005018,"Block 5018, Block Group 5, Census Tract 1040, Hennepin County, Minnesota",0,0,0,0,0,0,0,0,0,0,0,0,0,0,0,0,0,0,0,0,0,0,0,0,0
270531040005013,59,Mid - City Industrial,85,85,1000000US270531040005013,"Block 5013, Block Group 5, Census Tract 1040, Hennepin County, Minnesota",0,0,0,0,0,0,0,0,0,0,0,0,0,0,0,0,0,0,0,0,0,0,0,0,0
270531040005024,59,Mid - City Industrial,85,85,1000000US270531040005024,"Block 5024, Block Group 5, Census Tract 1040, Hennepin County, Minnesota",0,0,0,0,0,0,0,0,0,0,0,0,0,0,0,0,0,0,0,0,0,0,0,0,0
270531040005000,59,Mid - City Industrial,85,85,1000000US270531040005000,"Block 5000, Block Group 5, Census Tract 1040, Hennepin County, Minnesota",0,0,0,0,0,0,0,0,0,0,0,0,0,0,0,0,0,0,0,0,0,0,0,0,0
270531040005025,59,Mid - City Industrial,85,85,1000000US270531040005025,"Block 5025, Block Group 5, Census Tract 1040, Hennepin County, Minnesota",0,0,0,0,0,0,0,0,0,0,0,0,0,0,0,0,0,0,0,0,0,0,0,0,0
270531040005001,59,Mid - City Industrial,85,85,1000000US270531040005001,"Block 5001, Block Group 5, Census Tract 1040, Hennepin County, Minnesota",0,0,0,0,0,0,0,0,0,0,0,0,0,0,0,0,0,0,0,0,0,0,0,0,0
270531040005019,59,Mid - City Industrial,85,85,1000000US270531040005019,"Block 5019, Block Group 5, Census Tract 1040, Hennepin County, Minnesota",0,0,0,0,0,0,0,0,0,0,0,0,0,0,0,0,0,0,0,0,0,0,0,0,0
270531040005003,59,Mid - City Industrial,85,85,1000000US270531040005003,"Block 5003, Block Group 5, Census Tract 1040, Hennepin County, Minnesota",0,0,0,0,0,0,0,0,0,0,0,0,0,0,0,0,0,0,0,0,0,0,0,0,0
270531040005009,59,Mid - City Industrial,85,85,1000000US270531040005009,"Block 5009, Block Group 5, Census Tract 1040, Hennepin County, Minnesota",0,0,0,0,0,0,0,0,0,0,0,0,0,0,0,0,0,0,0,0,0,0,0,0,0
270531040005002,59,Mid - City Industrial,85,85,1000000US270531040005002,"Block 5002, Block Group 5, Census Tract 1040, Hennepin County, Minnesota",0,0,0,0,0,0,0,0,0,0,0,0,0,0,0,0,0,0,0,0,0,0,0,0,0
270531040001012,59,Mid - City Industrial,85,85,1000000US270531040001012,"Block 1012, Block Group 1, Census Tract 1040, Hennepin County, Minnesota",0,0,0,0,0,0,0,0,0,0,0,0,0,0,0,0,0,0,0,0,0,0,0,0,0
270531040001013,59,Mid - City Industrial,85,85,1000000US270531040001013,"Block 1013, Block Group 1, Census Tract 1040, Hennepin County, Minnesota",0,0,0,0,0,0,0,0,0,0,0,0,0,0,0,0,0,0,0,0,0,0,0,0,0
270531040005011,59,Mid - City Industrial,85,85,1000000US270531040005011,"Block 5011, Block Group 5, Census Tract 1040, Hennepin County, Minnesota",0,0,0,0,0,0,0,0,0,0,0,0,0,0,0,0,0,0,0,0,0,0,0,0,0
270531040005014,59,Mid - City Industrial,85,85,1000000US270531040005014,"Block 5014, Block Group 5, Census Tract 1040, Hennepin County, Minnesota",0,0,0,0,0,0,0,0,0,0,0,0,0,0,0,0,0,0,0,0,0,0,0,0,0
270531040001007,59,Mid - City Industrial,85,85,1000000US270531040001007,"Block 1007, Block Group 1, Census Tract 1040, Hennepin County, Minnesota",0,0,0,0,0,0,0,0,0,0,0,0,0,0,0,0,0,0,0,0,0,0,0,0,0
270531040001022,59,Mid - City Industrial,85,85,1000000US270531040001022,"Block 1022, Block Group 1, Census Tract 1040, Hennepin County, Minnesota",0,0,0,0,0,0,0,0,0,0,0,0,0,0,0,0,0,0,0,0,0,0,0,0,0
270531040001009,59,Mid - City Industrial,85,85,1000000US270531040001009,"Block 1009, Block Group 1, Census Tract 1040, Hennepin County, Minnesota",0,0,0,0,0,0,0,0,0,0,0,0,0,0,0,0,0,0,0,0,0,0,0,0,0
270531040005006,59,Mid - City Industrial,85,85,1000000US270531040005006,"Block 5006, Block Group 5, Census Tract 1040, Hennepin County, Minnesota",0,0,0,0,0,0,0,0,0,0,0,0,0,0,0,0,0,0,0,0,0,0,0,0,0
270531040005045,59,Mid - City Industrial,85,85,1000000US270531040005045,"Block 5045, Block Group 5, Census Tract 1040, Hennepin County, Minnesota",0,0,0,0,0,0,0,0,0,0,0,0,0,0,0,0,0,0,0,0,0,0,0,0,0
270531258003011,60,Midtown Phillips,91,91,1000000US270531258003011,"Block 3011, Block Group 3, Census Tract 1258, Hennepin County, Minnesota",131,13,44,8,0,0,64,2,131,61,7,44,8,0,0,1,1,70,6,0,0,0,0,63,1
270531258003024,60,Midtown Phillips,91,91,1000000US270531258003024,"Block 3024, Block Group 3, Census Tract 1258, Hennepin County, Minnesota",89,33,5,17,0,0,29,5,89,44,19,5,17,0,0,0,3,45,14,0,0,0,0,29,2
270531258003025,60,Midtown Phillips,91,91,1000000US270531258003025,"Block 3025, Block Group 3, Census Tract 1258, Hennepin County, Minnesota",46,15,1,1,0,0,29,0,46,9,7,1,1,0,0,0,0,37,8,0,0,0,0,29,0
270531258003005,60,Midtown Phillips,91,91,1000000US270531258003005,"Block 3005, Block Group 3, Census Tract 1258, Hennepin County, Minnesota",0,0,0,0,0,0,0,0,0,0,0,0,0,0,0,0,0,0,0,0,0,0,0,0,0
270531258002003,60,Midtown Phillips,91,91,1000000US270531258002003,"Block 2003, Block Group 2, Census Tract 1258, Hennepin County, Minnesota",104,40,36,2,0,0,13,13,104,60,21,36,2,0,0,0,1,44,19,0,0,0,0,13,12
270531258002002,60,Midtown Phillips,91,91,1000000US270531258002002,"Block 2002, Block Group 2, Census Tract 1258, Hennepin County, Minnesota",106,27,34,14,2,0,25,4,106,79,27,34,13,2,0,0,3,27,0,0,1,0,0,25,1
270531258003020,60,Midtown Phillips,91,91,1000000US270531258003020,"Block 3020, Block Group 3, Census Tract 1258, Hennepin County, Minnesota",0,0,0,0,0,0,0,0,0,0,0,0,0,0,0,0,0,0,0,0,0,0,0,0,0
270531258003027,60,Midtown Phillips,91,91,1000000US270531258003027,"Block 3027, Block Group 3, Census Tract 1258, Hennepin County, Minnesota",76,22,3,4,1,1,40,5,76,28,18,3,4,1,1,0,1,48,4,0,0,0,0,40,4
270531258003019,60,Midtown Phillips,91,91,1000000US270531258003019,"Block 3019, Block Group 3, Census Tract 1258, Hennepin County, Minnesota",0,0,0,0,0,0,0,0,0,0,0,0,0,0,0,0,0,0,0,0,0,0,0,0,0
270531258003026,60,Midtown Phillips,91,91,1000000US270531258003026,"Block 3026, Block Group 3, Census Tract 1258, Hennepin County, Minnesota",138,43,25,0,0,0,68,2,138,48,23,25,0,0,0,0,0,90,20,0,0,0,0,68,2
270531258003008,60,Midtown Phillips,91,91,1000000US270531258003008,"Block 3008, Block Group 3, Census Tract 1258, Hennepin County, Minnesota",70,18,6,2,1,0,32,11,70,25,10,6,2,1,0,0,6,45,8,0,0,0,0,32,5
270531258003016,60,Midtown Phillips,91,91,1000000US270531258003016,"Block 3016, Block Group 3, Census Tract 1258, Hennepin County, Minnesota",0,0,0,0,0,0,0,0,0,0,0,0,0,0,0,0,0,0,0,0,0,0,0,0,0
270531258002008,60,Midtown Phillips,91,91,1000000US270531258002008,"Block 2008, Block Group 2, Census Tract 1258, Hennepin County, Minnesota",198,75,24,15,2,9,46,27,198,87,39,24,11,2,9,0,2,111,36,0,4,0,0,46,25
270531258001005,60,Midtown Phillips,91,91,1000000US270531258001005,"Block 1005, Block Group 1, Census Tract 1258, Hennepin County, Minnesota",0,0,0,0,0,0,0,0,0,0,0,0,0,0,0,0,0,0,0,0,0,0,0,0,0
270531258001004,60,Midtown Phillips,91,91,1000000US270531258001004,"Block 1004, Block Group 1, Census Tract 1258, Hennepin County, Minnesota",0,0,0,0,0,0,0,0,0,0,0,0,0,0,0,0,0,0,0,0,0,0,0,0,0
270531258003006,60,Midtown Phillips,91,91,1000000US270531258003006,"Block 3006, Block Group 3, Census Tract 1258, Hennepin County, Minnesota",0,0,0,0,0,0,0,0,0,0,0,0,0,0,0,0,0,0,0,0,0,0,0,0,0
270531258001003,60,Midtown Phillips,91,91,1000000US270531258001003,"Block 1003, Block Group 1, Census Tract 1258, Hennepin County, Minnesota",173,74,33,0,9,0,46,11,173,113,65,33,0,9,0,1,5,60,9,0,0,0,0,45,6
270531258001002,60,Midtown Phillips,91,91,1000000US270531258001002,"Block 1002, Block Group 1, Census Tract 1258, Hennepin County, Minnesota",188,41,51,9,9,0,46,32,188,104,26,51,6,9,0,0,12,84,15,0,3,0,0,46,20
270531258001009,60,Midtown Phillips,91,91,1000000US270531258001009,"Block 1009, Block Group 1, Census Tract 1258, Hennepin County, Minnesota",0,0,0,0,0,0,0,0,0,0,0,0,0,0,0,0,0,0,0,0,0,0,0,0,0
270531258001007,60,Midtown Phillips,91,91,1000000US270531258001007,"Block 1007, Block Group 1, Census Tract 1258, Hennepin County, Minnesota",135,73,19,15,0,0,16,12,135,74,37,19,15,0,0,0,3,61,36,0,0,0,0,16,9
270531258003013,60,Midtown Phillips,91,91,1000000US270531258003013,"Block 3013, Block Group 3, Census Tract 1258, Hennepin County, Minnesota",91,21,14,3,6,0,40,7,91,35,5,14,3,6,0,0,7,56,16,0,0,0,0,40,0
270531258002007,60,Midtown Phillips,91,91,1000000US270531258002007,"Block 2007, Block Group 2, Census Tract 1258, Hennepin County, Minnesota",103,33,33,12,0,0,23,2,103,60,17,29,12,0,0,1,1,43,16,4,0,0,0,22,1
270531258003007,60,Midtown Phillips,91,91,1000000US270531258003007,"Block 3007, Block Group 3, Census Tract 1258, Hennepin County, Minnesota",501,185,224,10,23,0,15,44,501,451,171,220,6,23,0,1,30,50,14,4,4,0,0,14,14
270531258001008,60,Midtown Phillips,91,91,1000000US270531258001008,"Block 1008, Block Group 1, Census Tract 1258, Hennepin County, Minnesota",0,0,0,0,0,0,0,0,0,0,0,0,0,0,0,0,0,0,0,0,0,0,0,0,0
270531258002006,60,Midtown Phillips,91,91,1000000US270531258002006,"Block 2006, Block Group 2, Census Tract 1258, Hennepin County, Minnesota",102,23,35,18,0,0,20,6,102,74,23,34,12,0,0,0,5,28,0,1,6,0,0,20,1
270531258002001,60,Midtown Phillips,91,91,1000000US270531258002001,"Block 2001, Block Group 2, Census Tract 1258, Hennepin County, Minnesota",112,22,16,15,19,0,32,8,112,60,2,16,15,19,0,0,8,52,20,0,0,0,0,32,0
270531258003002,60,Midtown Phillips,91,91,1000000US270531258003002,"Block 3002, Block Group 3, Census Tract 1258, Hennepin County, Minnesota",125,20,55,1,3,0,36,10,125,74,10,50,1,3,0,0,10,51,10,5,0,0,0,36,0
270531258002000,60,Midtown Phillips,91,91,1000000US270531258002000,"Block 2000, Block Group 2, Census Tract 1258, Hennepin County, Minnesota",107,25,51,10,9,0,8,4,107,85,13,51,10,9,0,0,2,22,12,0,0,0,0,8,2
270531258003015,60,Midtown Phillips,91,91,1000000US270531258003015,"Block 3015, Block Group 3, Census Tract 1258, Hennepin County, Minnesota",120,38,40,5,1,0,27,9,120,59,11,40,3,1,0,0,4,61,27,0,2,0,0,27,5
270531258002005,60,Midtown Phillips,91,91,1000000US270531258002005,"Block 2005, Block Group 2, Census Tract 1258, Hennepin County, Minnesota",167,59,26,45,12,0,21,4,167,111,31,26,40,12,0,0,2,56,28,0,5,0,0,21,2
270531258003012,60,Midtown Phillips,91,91,1000000US270531258003012,"Block 3012, Block Group 3, Census Tract 1258, Hennepin County, Minnesota",44,4,17,0,0,0,22,1,44,21,4,17,0,0,0,0,0,23,0,0,0,0,0,22,1
270531258003003,60,Midtown Phillips,91,91,1000000US270531258003003,"Block 3003, Block Group 3, Census Tract 1258, Hennepin County, Minnesota",128,47,23,7,0,0,47,4,128,53,21,23,7,0,0,0,2,75,26,0,0,0,0,47,2
270531258002004,60,Midtown Phillips,91,91,1000000US270531258002004,"Block 2004, Block Group 2, Census Tract 1258, Hennepin County, Minnesota",122,58,32,8,0,0,19,5,122,92,48,31,8,0,0,0,5,30,10,1,0,0,0,19,0
270531258002010,60,Midtown Phillips,91,91,1000000US270531258002010,"Block 2010, Block Group 2, Census Tract 1258, Hennepin County, Minnesota",129,63,25,5,0,0,32,4,129,88,59,24,5,0,0,0,0,41,4,1,0,0,0,32,4
270531258002009,60,Midtown Phillips,91,91,1000000US270531258002009,"Block 2009, Block Group 2, Census Tract 1258, Hennepin County, Minnesota",160,68,17,25,0,0,45,5,160,70,34,17,16,0,0,0,3,90,34,0,9,0,0,45,2
270531258003001,60,Midtown Phillips,91,91,1000000US270531258003001,"Block 3001, Block Group 3, Census Tract 1258, Hennepin County, Minnesota",116,44,3,0,1,0,58,10,116,33,29,3,0,1,0,0,0,83,15,0,0,0,0,58,10
270531258003018,60,Midtown Phillips,91,91,1000000US270531258003018,"Block 3018, Block Group 3, Census Tract 1258, Hennepin County, Minnesota",0,0,0,0,0,0,0,0,0,0,0,0,0,0,0,0,0,0,0,0,0,0,0,0,0
270531258003017,60,Midtown Phillips,91,91,1000000US270531258003017,"Block 3017, Block Group 3, Census Tract 1258, Hennepin County, Minnesota",0,0,0,0,0,0,0,0,0,0,0,0,0,0,0,0,0,0,0,0,0,0,0,0,0
270531258002011,60,Midtown Phillips,91,91,1000000US270531258002011,"Block 2011, Block Group 2, Census Tract 1258, Hennepin County, Minnesota",143,53,25,3,0,0,48,14,143,82,42,25,3,0,0,0,12,61,11,0,0,0,0,48,2
270531258003014,60,Midtown Phillips,91,91,1000000US270531258003014,"Block 3014, Block Group 3, Census Tract 1258, Hennepin County, Minnesota",116,25,27,23,0,0,41,0,116,55,14,27,14,0,0,0,0,61,11,0,9,0,0,41,0
270531258003000,60,Midtown Phillips,91,91,1000000US270531258003000,"Block 3000, Block Group 3, Census Tract 1258, Hennepin County, Minnesota",177,53,57,7,8,0,47,5,177,108,32,55,6,8,0,2,5,69,21,2,1,0,0,45,0
270531258003023,60,Midtown Phillips,91,91,1000000US270531258003023,"Block 3023, Block Group 3, Census Tract 1258, Hennepin County, Minnesota",74,16,13,7,0,0,30,8,74,39,11,13,7,0,0,0,8,35,5,0,0,0,0,30,0
270531258001001,60,Midtown Phillips,91,91,1000000US270531258001001,"Block 1001, Block Group 1, Census Tract 1258, Hennepin County, Minnesota",174,41,73,7,6,0,37,10,174,114,25,69,7,6,0,0,7,60,16,4,0,0,0,37,3
270531258001000,60,Midtown Phillips,91,91,1000000US270531258001000,"Block 1000, Block Group 1, Census Tract 1258, Hennepin County, Minnesota",143,73,26,6,4,0,22,12,143,86,50,26,6,4,0,0,0,57,23,0,0,0,0,22,12
270531258001006,60,Midtown Phillips,91,91,1000000US270531258001006,"Block 1006, Block Group 1, Census Tract 1258, Hennepin County, Minnesota",157,75,24,0,4,0,51,3,157,86,52,24,0,4,0,5,1,71,23,0,0,0,0,46,2
270531258003004,60,Midtown Phillips,91,91,1000000US270531258003004,"Block 3004, Block Group 3, Census Tract 1258, Hennepin County, Minnesota",0,0,0,0,0,0,0,0,0,0,0,0,0,0,0,0,0,0,0,0,0,0,0,0,0
270531258003009,60,Midtown Phillips,91,91,1000000US270531258003009,"Block 3009, Block Group 3, Census Tract 1258, Hennepin County, Minnesota",55,21,0,1,0,0,33,0,55,22,21,0,1,0,0,0,0,33,0,0,0,0,0,33,0
270531258003010,60,Midtown Phillips,91,91,1000000US270531258003010,"Block 3010, Block Group 3, Census Tract 1258, Hennepin County, Minnesota",82,16,51,3,0,0,0,12,82,69,11,51,3,0,0,0,4,13,5,0,0,0,0,0,8
270531258003021,60,Midtown Phillips,91,91,1000000US270531258003021,"Block 3021, Block Group 3, Census Tract 1258, Hennepin County, Minnesota",0,0,0,0,0,0,0,0,0,0,0,0,0,0,0,0,0,0,0,0,0,0,0,0,0
270531258003022,60,Midtown Phillips,91,91,1000000US270531258003022,"Block 3022, Block Group 3, Census Tract 1258, Hennepin County, Minnesota",80,51,17,0,3,0,4,5,80,74,50,17,0,3,0,0,4,6,1,0,0,0,0,4,1
270531091002004,61,West Calhoun,49,49,1000000US270531091002004,"Block 2004, Block Group 2, Census Tract 1091, Hennepin County, Minnesota",26,19,1,0,3,0,1,2,26,24,18,1,0,3,0,0,2,2,1,0,0,0,0,1,0
270531091001009,61,West Calhoun,49,49,1000000US270531091001009,"Block 1009, Block Group 1, Census Tract 1091, Hennepin County, Minnesota",0,0,0,0,0,0,0,0,0,0,0,0,0,0,0,0,0,0,0,0,0,0,0,0,0
270531091002002,61,West Calhoun,49,49,1000000US270531091002002,"Block 2002, Block Group 2, Census Tract 1091, Hennepin County, Minnesota",211,165,14,2,12,0,10,8,211,194,159,14,2,12,0,0,7,17,6,0,0,0,0,10,1
270531091001004,61,West Calhoun,49,49,1000000US270531091001004,"Block 1004, Block Group 1, Census Tract 1091, Hennepin County, Minnesota",0,0,0,0,0,0,0,0,0,0,0,0,0,0,0,0,0,0,0,0,0,0,0,0,0
270531091001011,61,West Calhoun,49,49,1000000US270531091001011,"Block 1011, Block Group 1, Census Tract 1091, Hennepin County, Minnesota",380,340,15,2,17,0,1,5,380,371,333,14,2,17,0,0,5,9,7,1,0,0,0,1,0
270531091002001,61,West Calhoun,49,49,1000000US270531091002001,"Block 2001, Block Group 2, Census Tract 1091, Hennepin County, Minnesota",26,18,4,0,1,0,0,3,26,23,17,4,0,1,0,0,1,3,1,0,0,0,0,0,2
270531091001008,61,West Calhoun,49,49,1000000US270531091001008,"Block 1008, Block Group 1, Census Tract 1091, Hennepin County, Minnesota",262,211,19,1,10,0,14,7,262,240,204,15,1,10,0,3,7,22,7,4,0,0,0,11,0
270531091001012,61,West Calhoun,49,49,1000000US270531091001012,"Block 1012, Block Group 1, Census Tract 1091, Hennepin County, Minnesota",59,58,0,0,1,0,0,0,59,59,58,0,0,1,0,0,0,0,0,0,0,0,0,0,0
270531091001006,61,West Calhoun,49,49,1000000US270531091001006,"Block 1006, Block Group 1, Census Tract 1091, Hennepin County, Minnesota",322,292,4,1,19,0,0,6,322,319,290,4,1,19,0,0,5,3,2,0,0,0,0,0,1
270531091001007,61,West Calhoun,49,49,1000000US270531091001007,"Block 1007, Block Group 1, Census Tract 1091, Hennepin County, Minnesota",0,0,0,0,0,0,0,0,0,0,0,0,0,0,0,0,0,0,0,0,0,0,0,0,0
270531091002003,61,West Calhoun,49,49,1000000US270531091002003,"Block 2003, Block Group 2, Census Tract 1091, Hennepin County, Minnesota",291,258,14,1,9,0,2,7,291,287,256,14,1,9,0,0,7,4,2,0,0,0,0,2,0
270531091001010,61,West Calhoun,49,49,1000000US270531091001010,"Block 1010, Block Group 1, Census Tract 1091, Hennepin County, Minnesota",23,22,1,0,0,0,0,0,23,23,22,1,0,0,0,0,0,0,0,0,0,0,0,0,0
270531091001014,61,West Calhoun,49,49,1000000US270531091001014,"Block 1014, Block Group 1, Census Tract 1091, Hennepin County, Minnesota",17,12,2,0,1,0,0,2,17,17,12,2,0,1,0,0,2,0,0,0,0,0,0,0,0
270531091001002,61,West Calhoun,49,49,1000000US270531091001002,"Block 1002, Block Group 1, Census Tract 1091, Hennepin County, Minnesota",0,0,0,0,0,0,0,0,0,0,0,0,0,0,0,0,0,0,0,0,0,0,0,0,0
270531091001013,61,West Calhoun,49,49,1000000US270531091001013,"Block 1013, Block Group 1, Census Tract 1091, Hennepin County, Minnesota",83,81,0,0,2,0,0,0,83,82,80,0,0,2,0,0,0,1,1,0,0,0,0,0,0
270531091002000,61,West Calhoun,49,49,1000000US270531091002000,"Block 2000, Block Group 2, Census Tract 1091, Hennepin County, Minnesota",60,58,1,0,0,0,0,1,60,60,58,1,0,0,0,0,1,0,0,0,0,0,0,0,0
270531051001001,62,Bryn - Mawr,50,50,1000000US270531051001001,"Block 1001, Block Group 1, Census Tract 1051, Hennepin County, Minnesota",66,62,3,0,1,0,0,0,66,66,62,3,0,1,0,0,0,0,0,0,0,0,0,0,0
270531051003016,62,Bryn - Mawr,50,50,1000000US270531051003016,"Block 3016, Block Group 3, Census Tract 1051, Hennepin County, Minnesota",0,0,0,0,0,0,0,0,0,0,0,0,0,0,0,0,0,0,0,0,0,0,0,0,0
270531051003025,62,Bryn - Mawr,50,50,1000000US270531051003025,"Block 3025, Block Group 3, Census Tract 1051, Hennepin County, Minnesota",26,21,1,0,4,0,0,0,26,26,21,1,0,4,0,0,0,0,0,0,0,0,0,0,0
270531051001025,62,Bryn - Mawr,50,50,1000000US270531051001025,"Block 1025, Block Group 1, Census Tract 1051, Hennepin County, Minnesota",69,66,0,0,2,0,0,1,69,69,66,0,0,2,0,0,1,0,0,0,0,0,0,0,0
270531051003003,62,Bryn - Mawr,50,50,1000000US270531051003003,"Block 3003, Block Group 3, Census Tract 1051, Hennepin County, Minnesota",0,0,0,0,0,0,0,0,0,0,0,0,0,0,0,0,0,0,0,0,0,0,0,0,0
270531051001016,62,Bryn - Mawr,50,50,1000000US270531051001016,"Block 1016, Block Group 1, Census Tract 1051, Hennepin County, Minnesota",41,39,0,2,0,0,0,0,41,41,39,0,2,0,0,0,0,0,0,0,0,0,0,0,0
270531051003022,62,Bryn - Mawr,50,50,1000000US270531051003022,"Block 3022, Block Group 3, Census Tract 1051, Hennepin County, Minnesota",53,52,0,0,1,0,0,0,53,53,52,0,0,1,0,0,0,0,0,0,0,0,0,0,0
270531051003013,62,Bryn - Mawr,50,50,1000000US270531051003013,"Block 3013, Block Group 3, Census Tract 1051, Hennepin County, Minnesota",35,35,0,0,0,0,0,0,35,35,35,0,0,0,0,0,0,0,0,0,0,0,0,0,0
270531051002021,62,Bryn - Mawr,50,50,1000000US270531051002021,"Block 2021, Block Group 2, Census Tract 1051, Hennepin County, Minnesota",0,0,0,0,0,0,0,0,0,0,0,0,0,0,0,0,0,0,0,0,0,0,0,0,0
270531051001021,62,Bryn - Mawr,50,50,1000000US270531051001021,"Block 1021, Block Group 1, Census Tract 1051, Hennepin County, Minnesota",75,64,9,0,1,0,1,0,75,74,63,9,0,1,0,1,0,1,1,0,0,0,0,0,0
270531051003004,62,Bryn - Mawr,50,50,1000000US270531051003004,"Block 3004, Block Group 3, Census Tract 1051, Hennepin County, Minnesota",45,45,0,0,0,0,0,0,45,42,42,0,0,0,0,0,0,3,3,0,0,0,0,0,0
270531051001005,62,Bryn - Mawr,50,50,1000000US270531051001005,"Block 1005, Block Group 1, Census Tract 1051, Hennepin County, Minnesota",107,88,1,1,7,0,0,10,107,106,87,1,1,7,0,0,10,1,1,0,0,0,0,0,0
270531051003005,62,Bryn - Mawr,50,50,1000000US270531051003005,"Block 3005, Block Group 3, Census Tract 1051, Hennepin County, Minnesota",52,50,0,0,2,0,0,0,52,49,47,0,0,2,0,0,0,3,3,0,0,0,0,0,0
270531051001008,62,Bryn - Mawr,50,50,1000000US270531051001008,"Block 1008, Block Group 1, Census Tract 1051, Hennepin County, Minnesota",0,0,0,0,0,0,0,0,0,0,0,0,0,0,0,0,0,0,0,0,0,0,0,0,0
270531051002020,62,Bryn - Mawr,50,50,1000000US270531051002020,"Block 2020, Block Group 2, Census Tract 1051, Hennepin County, Minnesota",9,9,0,0,0,0,0,0,9,9,9,0,0,0,0,0,0,0,0,0,0,0,0,0,0
270531051001028,62,Bryn - Mawr,50,50,1000000US270531051001028,"Block 1028, Block Group 1, Census Tract 1051, Hennepin County, Minnesota",31,31,0,0,0,0,0,0,31,31,31,0,0,0,0,0,0,0,0,0,0,0,0,0,0
270531051002023,62,Bryn - Mawr,50,50,1000000US270531051002023,"Block 2023, Block Group 2, Census Tract 1051, Hennepin County, Minnesota",9,9,0,0,0,0,0,0,9,9,9,0,0,0,0,0,0,0,0,0,0,0,0,0,0
270531051003026,62,Bryn - Mawr,50,50,1000000US270531051003026,"Block 3026, Block Group 3, Census Tract 1051, Hennepin County, Minnesota",27,26,0,0,1,0,0,0,27,26,25,0,0,1,0,0,0,1,1,0,0,0,0,0,0
270531051003019,62,Bryn - Mawr,50,50,1000000US270531051003019,"Block 3019, Block Group 3, Census Tract 1051, Hennepin County, Minnesota",63,59,3,0,1,0,0,0,63,62,58,3,0,1,0,0,0,1,1,0,0,0,0,0,0
270531051003020,62,Bryn - Mawr,50,50,1000000US270531051003020,"Block 3020, Block Group 3, Census Tract 1051, Hennepin County, Minnesota",63,57,0,0,5,0,1,0,63,58,53,0,0,5,0,0,0,5,4,0,0,0,0,1,0
270531051003012,62,Bryn - Mawr,50,50,1000000US270531051003012,"Block 3012, Block Group 3, Census Tract 1051, Hennepin County, Minnesota",86,71,0,0,7,0,0,8,86,82,70,0,0,7,0,0,5,4,1,0,0,0,0,0,3
270531051002022,62,Bryn - Mawr,50,50,1000000US270531051002022,"Block 2022, Block Group 2, Census Tract 1051, Hennepin County, Minnesota",75,68,1,0,0,0,0,6,75,72,67,1,0,0,0,0,4,3,1,0,0,0,0,0,2
270531051003021,62,Bryn - Mawr,50,50,1000000US270531051003021,"Block 3021, Block Group 3, Census Tract 1051, Hennepin County, Minnesota",35,31,1,0,0,0,3,0,35,32,31,1,0,0,0,0,0,3,0,0,0,0,0,3,0
270531051003015,62,Bryn - Mawr,50,50,1000000US270531051003015,"Block 3015, Block Group 3, Census Tract 1051, Hennepin County, Minnesota",28,26,0,0,0,0,0,2,28,28,26,0,0,0,0,0,2,0,0,0,0,0,0,0,0
270531051001022,62,Bryn - Mawr,50,50,1000000US270531051001022,"Block 1022, Block Group 1, Census Tract 1051, Hennepin County, Minnesota",62,60,0,0,1,0,0,1,62,58,56,0,0,1,0,0,1,4,4,0,0,0,0,0,0
270531051003001,62,Bryn - Mawr,50,50,1000000US270531051003001,"Block 3001, Block Group 3, Census Tract 1051, Hennepin County, Minnesota",43,39,1,0,1,0,0,2,43,43,39,1,0,1,0,0,2,0,0,0,0,0,0,0,0
270531051002013,62,Bryn - Mawr,50,50,1000000US270531051002013,"Block 2013, Block Group 2, Census Tract 1051, Hennepin County, Minnesota",0,0,0,0,0,0,0,0,0,0,0,0,0,0,0,0,0,0,0,0,0,0,0,0,0
270531051001018,62,Bryn - Mawr,50,50,1000000US270531051001018,"Block 1018, Block Group 1, Census Tract 1051, Hennepin County, Minnesota",31,29,0,0,2,0,0,0,31,31,29,0,0,2,0,0,0,0,0,0,0,0,0,0,0
270531051003002,62,Bryn - Mawr,50,50,1000000US270531051003002,"Block 3002, Block Group 3, Census Tract 1051, Hennepin County, Minnesota",89,80,2,0,4,0,1,2,89,87,80,2,0,4,0,0,1,2,0,0,0,0,0,1,1
270531051001009,62,Bryn - Mawr,50,50,1000000US270531051001009,"Block 1009, Block Group 1, Census Tract 1051, Hennepin County, Minnesota",0,0,0,0,0,0,0,0,0,0,0,0,0,0,0,0,0,0,0,0,0,0,0,0,0
270531051003009,62,Bryn - Mawr,50,50,1000000US270531051003009,"Block 3009, Block Group 3, Census Tract 1051, Hennepin County, Minnesota",12,12,0,0,0,0,0,0,12,12,12,0,0,0,0,0,0,0,0,0,0,0,0,0,0
270531065002038,62,Bryn - Mawr,50,50,1000000US270531065002038,"Block 2038, Block Group 2, Census Tract 1065, Hennepin County, Minnesota",0,0,0,0,0,0,0,0,0,0,0,0,0,0,0,0,0,0,0,0,0,0,0,0,0
270531051001024,62,Bryn - Mawr,50,50,1000000US270531051001024,"Block 1024, Block Group 1, Census Tract 1051, Hennepin County, Minnesota",54,47,3,0,1,0,0,3,54,54,47,3,0,1,0,0,3,0,0,0,0,0,0,0,0
270531051001026,62,Bryn - Mawr,50,50,1000000US270531051001026,"Block 1026, Block Group 1, Census Tract 1051, Hennepin County, Minnesota",26,26,0,0,0,0,0,0,26,26,26,0,0,0,0,0,0,0,0,0,0,0,0,0,0
270531051003010,62,Bryn - Mawr,50,50,1000000US270531051003010,"Block 3010, Block Group 3, Census Tract 1051, Hennepin County, Minnesota",0,0,0,0,0,0,0,0,0,0,0,0,0,0,0,0,0,0,0,0,0,0,0,0,0
270531051001013,62,Bryn - Mawr,50,50,1000000US270531051001013,"Block 1013, Block Group 1, Census Tract 1051, Hennepin County, Minnesota",60,51,5,0,1,0,0,3,60,59,50,5,0,1,0,0,3,1,1,0,0,0,0,0,0
270531051002017,62,Bryn - Mawr,50,50,1000000US270531051002017,"Block 2017, Block Group 2, Census Tract 1051, Hennepin County, Minnesota",49,47,0,0,2,0,0,0,49,49,47,0,0,2,0,0,0,0,0,0,0,0,0,0,0
270531051002004,62,Bryn - Mawr,50,50,1000000US270531051002004,"Block 2004, Block Group 2, Census Tract 1051, Hennepin County, Minnesota",30,29,0,0,0,0,0,1,30,29,28,0,0,0,0,0,1,1,1,0,0,0,0,0,0
270531051002012,62,Bryn - Mawr,50,50,1000000US270531051002012,"Block 2012, Block Group 2, Census Tract 1051, Hennepin County, Minnesota",10,10,0,0,0,0,0,0,10,10,10,0,0,0,0,0,0,0,0,0,0,0,0,0,0
270531051002000,62,Bryn - Mawr,50,50,1000000US270531051002000,"Block 2000, Block Group 2, Census Tract 1051, Hennepin County, Minnesota",0,0,0,0,0,0,0,0,0,0,0,0,0,0,0,0,0,0,0,0,0,0,0,0,0
270531051001012,62,Bryn - Mawr,50,50,1000000US270531051001012,"Block 1012, Block Group 1, Census Tract 1051, Hennepin County, Minnesota",0,0,0,0,0,0,0,0,0,0,0,0,0,0,0,0,0,0,0,0,0,0,0,0,0
270531051001011,62,Bryn - Mawr,50,50,1000000US270531051001011,"Block 1011, Block Group 1, Census Tract 1051, Hennepin County, Minnesota",0,0,0,0,0,0,0,0,0,0,0,0,0,0,0,0,0,0,0,0,0,0,0,0,0
270531051001019,62,Bryn - Mawr,50,50,1000000US270531051001019,"Block 1019, Block Group 1, Census Tract 1051, Hennepin County, Minnesota",53,51,1,0,1,0,0,0,53,49,47,1,0,1,0,0,0,4,4,0,0,0,0,0,0
270531051002006,62,Bryn - Mawr,50,50,1000000US270531051002006,"Block 2006, Block Group 2, Census Tract 1051, Hennepin County, Minnesota",9,8,1,0,0,0,0,0,9,9,8,1,0,0,0,0,0,0,0,0,0,0,0,0,0
270531051002003,62,Bryn - Mawr,50,50,1000000US270531051002003,"Block 2003, Block Group 2, Census Tract 1051, Hennepin County, Minnesota",125,114,1,1,2,0,0,7,125,119,108,1,1,2,0,0,7,6,6,0,0,0,0,0,0
270531051002002,62,Bryn - Mawr,50,50,1000000US270531051002002,"Block 2002, Block Group 2, Census Tract 1051, Hennepin County, Minnesota",4,1,0,0,1,0,0,2,4,4,1,0,0,1,0,0,2,0,0,0,0,0,0,0,0
270531051002019,62,Bryn - Mawr,50,50,1000000US270531051002019,"Block 2019, Block Group 2, Census Tract 1051, Hennepin County, Minnesota",29,27,0,0,1,0,0,1,29,27,25,0,0,1,0,0,1,2,2,0,0,0,0,0,0
270531051003000,62,Bryn - Mawr,50,50,1000000US270531051003000,"Block 3000, Block Group 3, Census Tract 1051, Hennepin County, Minnesota",65,58,0,0,0,0,7,0,65,57,57,0,0,0,0,0,0,8,1,0,0,0,0,7,0
270531051002007,62,Bryn - Mawr,50,50,1000000US270531051002007,"Block 2007, Block Group 2, Census Tract 1051, Hennepin County, Minnesota",88,75,7,1,1,0,0,4,88,84,71,7,1,1,0,0,4,4,4,0,0,0,0,0,0
270531051001014,62,Bryn - Mawr,50,50,1000000US270531051001014,"Block 1014, Block Group 1, Census Tract 1051, Hennepin County, Minnesota",53,51,0,0,2,0,0,0,53,53,51,0,0,2,0,0,0,0,0,0,0,0,0,0,0
270531051002010,62,Bryn - Mawr,50,50,1000000US270531051002010,"Block 2010, Block Group 2, Census Tract 1051, Hennepin County, Minnesota",36,29,0,1,3,0,0,3,36,34,28,0,1,3,0,0,2,2,1,0,0,0,0,0,1
270531051002001,62,Bryn - Mawr,50,50,1000000US270531051002001,"Block 2001, Block Group 2, Census Tract 1051, Hennepin County, Minnesota",0,0,0,0,0,0,0,0,0,0,0,0,0,0,0,0,0,0,0,0,0,0,0,0,0
270531065001001,62,Bryn - Mawr,50,50,1000000US270531065001001,"Block 1001, Block Group 1, Census Tract 1065, Hennepin County, Minnesota",0,0,0,0,0,0,0,0,0,0,0,0,0,0,0,0,0,0,0,0,0,0,0,0,0
270531051003023,62,Bryn - Mawr,50,50,1000000US270531051003023,"Block 3023, Block Group 3, Census Tract 1051, Hennepin County, Minnesota",0,0,0,0,0,0,0,0,0,0,0,0,0,0,0,0,0,0,0,0,0,0,0,0,0
270531065002039,62,Bryn - Mawr,50,50,1000000US270531065002039,"Block 2039, Block Group 2, Census Tract 1065, Hennepin County, Minnesota",0,0,0,0,0,0,0,0,0,0,0,0,0,0,0,0,0,0,0,0,0,0,0,0,0
270531065002037,62,Bryn - Mawr,50,50,1000000US270531065002037,"Block 2037, Block Group 2, Census Tract 1065, Hennepin County, Minnesota",0,0,0,0,0,0,0,0,0,0,0,0,0,0,0,0,0,0,0,0,0,0,0,0,0
270531051003006,62,Bryn - Mawr,50,50,1000000US270531051003006,"Block 3006, Block Group 3, Census Tract 1051, Hennepin County, Minnesota",0,0,0,0,0,0,0,0,0,0,0,0,0,0,0,0,0,0,0,0,0,0,0,0,0
270531051001015,62,Bryn - Mawr,50,50,1000000US270531051001015,"Block 1015, Block Group 1, Census Tract 1051, Hennepin County, Minnesota",49,44,4,0,1,0,0,0,49,48,43,4,0,1,0,0,0,1,1,0,0,0,0,0,0
270531051003017,62,Bryn - Mawr,50,50,1000000US270531051003017,"Block 3017, Block Group 3, Census Tract 1051, Hennepin County, Minnesota",0,0,0,0,0,0,0,0,0,0,0,0,0,0,0,0,0,0,0,0,0,0,0,0,0
270531051003014,62,Bryn - Mawr,50,50,1000000US270531051003014,"Block 3014, Block Group 3, Census Tract 1051, Hennepin County, Minnesota",0,0,0,0,0,0,0,0,0,0,0,0,0,0,0,0,0,0,0,0,0,0,0,0,0
270531051002018,62,Bryn - Mawr,50,50,1000000US270531051002018,"Block 2018, Block Group 2, Census Tract 1051, Hennepin County, Minnesota",83,76,4,1,0,1,0,1,83,77,73,4,0,0,0,0,0,6,3,0,1,0,1,0,1
270531051002016,62,Bryn - Mawr,50,50,1000000US270531051002016,"Block 2016, Block Group 2, Census Tract 1051, Hennepin County, Minnesota",77,67,1,0,2,0,1,6,77,75,66,1,0,2,0,0,6,2,1,0,0,0,0,1,0
270531051001002,62,Bryn - Mawr,50,50,1000000US270531051001002,"Block 1002, Block Group 1, Census Tract 1051, Hennepin County, Minnesota",46,43,0,0,0,0,2,1,46,43,43,0,0,0,0,0,0,3,0,0,0,0,0,2,1
270531051003007,62,Bryn - Mawr,50,50,1000000US270531051003007,"Block 3007, Block Group 3, Census Tract 1051, Hennepin County, Minnesota",0,0,0,0,0,0,0,0,0,0,0,0,0,0,0,0,0,0,0,0,0,0,0,0,0
270531051003018,62,Bryn - Mawr,50,50,1000000US270531051003018,"Block 3018, Block Group 3, Census Tract 1051, Hennepin County, Minnesota",0,0,0,0,0,0,0,0,0,0,0,0,0,0,0,0,0,0,0,0,0,0,0,0,0
270531051001020,62,Bryn - Mawr,50,50,1000000US270531051001020,"Block 1020, Block Group 1, Census Tract 1051, Hennepin County, Minnesota",73,58,1,0,14,0,0,0,73,73,58,1,0,14,0,0,0,0,0,0,0,0,0,0,0
270531051002011,62,Bryn - Mawr,50,50,1000000US270531051002011,"Block 2011, Block Group 2, Census Tract 1051, Hennepin County, Minnesota",0,0,0,0,0,0,0,0,0,0,0,0,0,0,0,0,0,0,0,0,0,0,0,0,0
270531051002005,62,Bryn - Mawr,50,50,1000000US270531051002005,"Block 2005, Block Group 2, Census Tract 1051, Hennepin County, Minnesota",45,45,0,0,0,0,0,0,45,45,45,0,0,0,0,0,0,0,0,0,0,0,0,0,0
270531051001000,62,Bryn - Mawr,50,50,1000000US270531051001000,"Block 1000, Block Group 1, Census Tract 1051, Hennepin County, Minnesota",37,32,1,0,2,0,2,0,37,37,32,1,0,2,0,2,0,0,0,0,0,0,0,0,0
270531051001004,62,Bryn - Mawr,50,50,1000000US270531051001004,"Block 1004, Block Group 1, Census Tract 1051, Hennepin County, Minnesota",40,38,1,0,1,0,0,0,40,40,38,1,0,1,0,0,0,0,0,0,0,0,0,0,0
270531051001023,62,Bryn - Mawr,50,50,1000000US270531051001023,"Block 1023, Block Group 1, Census Tract 1051, Hennepin County, Minnesota",53,52,0,0,0,0,0,1,53,53,52,0,0,0,0,0,1,0,0,0,0,0,0,0,0
270531051001007,62,Bryn - Mawr,50,50,1000000US270531051001007,"Block 1007, Block Group 1, Census Tract 1051, Hennepin County, Minnesota",0,0,0,0,0,0,0,0,0,0,0,0,0,0,0,0,0,0,0,0,0,0,0,0,0
270531051001006,62,Bryn - Mawr,50,50,1000000US270531051001006,"Block 1006, Block Group 1, Census Tract 1051, Hennepin County, Minnesota",0,0,0,0,0,0,0,0,0,0,0,0,0,0,0,0,0,0,0,0,0,0,0,0,0
270531051003024,62,Bryn - Mawr,50,50,1000000US270531051003024,"Block 3024, Block Group 3, Census Tract 1051, Hennepin County, Minnesota",9,9,0,0,0,0,0,0,9,9,9,0,0,0,0,0,0,0,0,0,0,0,0,0,0
270531051001017,62,Bryn - Mawr,50,50,1000000US270531051001017,"Block 1017, Block Group 1, Census Tract 1051, Hennepin County, Minnesota",51,50,0,1,0,0,0,0,51,51,50,0,1,0,0,0,0,0,0,0,0,0,0,0,0
270531051003008,62,Bryn - Mawr,50,50,1000000US270531051003008,"Block 3008, Block Group 3, Census Tract 1051, Hennepin County, Minnesota",0,0,0,0,0,0,0,0,0,0,0,0,0,0,0,0,0,0,0,0,0,0,0,0,0
270531051003027,62,Bryn - Mawr,50,50,1000000US270531051003027,"Block 3027, Block Group 3, Census Tract 1051, Hennepin County, Minnesota",0,0,0,0,0,0,0,0,0,0,0,0,0,0,0,0,0,0,0,0,0,0,0,0,0
270531051003011,62,Bryn - Mawr,50,50,1000000US270531051003011,"Block 3011, Block Group 3, Census Tract 1051, Hennepin County, Minnesota",58,53,1,0,2,0,0,2,58,57,52,1,0,2,0,0,2,1,1,0,0,0,0,0,0
270531051002008,62,Bryn - Mawr,50,50,1000000US270531051002008,"Block 2008, Block Group 2, Census Tract 1051, Hennepin County, Minnesota",0,0,0,0,0,0,0,0,0,0,0,0,0,0,0,0,0,0,0,0,0,0,0,0,0
270531051001027,62,Bryn - Mawr,50,50,1000000US270531051001027,"Block 1027, Block Group 1, Census Tract 1051, Hennepin County, Minnesota",16,15,1,0,0,0,0,0,16,13,12,1,0,0,0,0,0,3,3,0,0,0,0,0,0
270531051002015,62,Bryn - Mawr,50,50,1000000US270531051002015,"Block 2015, Block Group 2, Census Tract 1051, Hennepin County, Minnesota",41,41,0,0,0,0,0,0,41,41,41,0,0,0,0,0,0,0,0,0,0,0,0,0,0
270531051001003,62,Bryn - Mawr,50,50,1000000US270531051001003,"Block 1003, Block Group 1, Census Tract 1051, Hennepin County, Minnesota",50,43,2,0,3,0,0,2,50,50,43,2,0,3,0,0,2,0,0,0,0,0,0,0,0
270531026001016,63,Northeast Park,20,20,1000000US270531026001016,"Block 1016, Block Group 1, Census Tract 1026, Hennepin County, Minnesota",28,22,0,0,0,0,5,1,28,23,22,0,0,0,0,0,1,5,0,0,0,0,0,5,0
270531026001004,63,Northeast Park,20,20,1000000US270531026001004,"Block 1004, Block Group 1, Census Tract 1026, Hennepin County, Minnesota",5,1,0,0,4,0,0,0,5,5,1,0,0,4,0,0,0,0,0,0,0,0,0,0,0
270531026001023,63,Northeast Park,20,20,1000000US270531026001023,"Block 1023, Block Group 1, Census Tract 1026, Hennepin County, Minnesota",0,0,0,0,0,0,0,0,0,0,0,0,0,0,0,0,0,0,0,0,0,0,0,0,0
270531026001020,63,Northeast Park,20,20,1000000US270531026001020,"Block 1020, Block Group 1, Census Tract 1026, Hennepin County, Minnesota",0,0,0,0,0,0,0,0,0,0,0,0,0,0,0,0,0,0,0,0,0,0,0,0,0
270531026001025,63,Northeast Park,20,20,1000000US270531026001025,"Block 1025, Block Group 1, Census Tract 1026, Hennepin County, Minnesota",19,19,0,0,0,0,0,0,19,14,14,0,0,0,0,0,0,5,5,0,0,0,0,0,0
270531026001029,63,Northeast Park,20,20,1000000US270531026001029,"Block 1029, Block Group 1, Census Tract 1026, Hennepin County, Minnesota",0,0,0,0,0,0,0,0,0,0,0,0,0,0,0,0,0,0,0,0,0,0,0,0,0
270531026001015,63,Northeast Park,20,20,1000000US270531026001015,"Block 1015, Block Group 1, Census Tract 1026, Hennepin County, Minnesota",0,0,0,0,0,0,0,0,0,0,0,0,0,0,0,0,0,0,0,0,0,0,0,0,0
270531026001002,63,Northeast Park,20,20,1000000US270531026001002,"Block 1002, Block Group 1, Census Tract 1026, Hennepin County, Minnesota",0,0,0,0,0,0,0,0,0,0,0,0,0,0,0,0,0,0,0,0,0,0,0,0,0
270531026001003,63,Northeast Park,20,20,1000000US270531026001003,"Block 1003, Block Group 1, Census Tract 1026, Hennepin County, Minnesota",0,0,0,0,0,0,0,0,0,0,0,0,0,0,0,0,0,0,0,0,0,0,0,0,0
270531026001000,63,Northeast Park,20,20,1000000US270531026001000,"Block 1000, Block Group 1, Census Tract 1026, Hennepin County, Minnesota",0,0,0,0,0,0,0,0,0,0,0,0,0,0,0,0,0,0,0,0,0,0,0,0,0
270531026001028,63,Northeast Park,20,20,1000000US270531026001028,"Block 1028, Block Group 1, Census Tract 1026, Hennepin County, Minnesota",0,0,0,0,0,0,0,0,0,0,0,0,0,0,0,0,0,0,0,0,0,0,0,0,0
270531026001007,63,Northeast Park,20,20,1000000US270531026001007,"Block 1007, Block Group 1, Census Tract 1026, Hennepin County, Minnesota",51,43,1,0,5,0,1,1,51,51,43,1,0,5,0,1,1,0,0,0,0,0,0,0,0
270531026001006,63,Northeast Park,20,20,1000000US270531026001006,"Block 1006, Block Group 1, Census Tract 1026, Hennepin County, Minnesota",75,63,6,0,2,0,0,4,75,70,59,6,0,2,0,0,3,5,4,0,0,0,0,0,1
270531026001024,63,Northeast Park,20,20,1000000US270531026001024,"Block 1024, Block Group 1, Census Tract 1026, Hennepin County, Minnesota",20,15,2,0,0,0,0,3,20,20,15,2,0,0,0,0,3,0,0,0,0,0,0,0,0
270531026001031,63,Northeast Park,20,20,1000000US270531026001031,"Block 1031, Block Group 1, Census Tract 1026, Hennepin County, Minnesota",0,0,0,0,0,0,0,0,0,0,0,0,0,0,0,0,0,0,0,0,0,0,0,0,0
270531026001030,63,Northeast Park,20,20,1000000US270531026001030,"Block 1030, Block Group 1, Census Tract 1026, Hennepin County, Minnesota",0,0,0,0,0,0,0,0,0,0,0,0,0,0,0,0,0,0,0,0,0,0,0,0,0
270531026001021,63,Northeast Park,20,20,1000000US270531026001021,"Block 1021, Block Group 1, Census Tract 1026, Hennepin County, Minnesota",0,0,0,0,0,0,0,0,0,0,0,0,0,0,0,0,0,0,0,0,0,0,0,0,0
270531026001017,63,Northeast Park,20,20,1000000US270531026001017,"Block 1017, Block Group 1, Census Tract 1026, Hennepin County, Minnesota",0,0,0,0,0,0,0,0,0,0,0,0,0,0,0,0,0,0,0,0,0,0,0,0,0
270531026001012,63,Northeast Park,20,20,1000000US270531026001012,"Block 1012, Block Group 1, Census Tract 1026, Hennepin County, Minnesota",30,18,0,2,4,0,6,0,30,22,16,0,2,4,0,0,0,8,2,0,0,0,0,6,0
270531026001013,63,Northeast Park,20,20,1000000US270531026001013,"Block 1013, Block Group 1, Census Tract 1026, Hennepin County, Minnesota",39,34,0,1,0,0,0,4,39,38,33,0,1,0,0,0,4,1,1,0,0,0,0,0,0
270531026001026,63,Northeast Park,20,20,1000000US270531026001026,"Block 1026, Block Group 1, Census Tract 1026, Hennepin County, Minnesota",18,15,1,0,0,0,0,2,18,18,15,1,0,0,0,0,2,0,0,0,0,0,0,0,0
270531026001011,63,Northeast Park,20,20,1000000US270531026001011,"Block 1011, Block Group 1, Census Tract 1026, Hennepin County, Minnesota",0,0,0,0,0,0,0,0,0,0,0,0,0,0,0,0,0,0,0,0,0,0,0,0,0
270531026001009,63,Northeast Park,20,20,1000000US270531026001009,"Block 1009, Block Group 1, Census Tract 1026, Hennepin County, Minnesota",41,37,4,0,0,0,0,0,41,41,37,4,0,0,0,0,0,0,0,0,0,0,0,0,0
270531026001010,63,Northeast Park,20,20,1000000US270531026001010,"Block 1010, Block Group 1, Census Tract 1026, Hennepin County, Minnesota",268,163,42,20,15,0,7,21,268,214,132,39,16,13,0,0,14,54,31,3,4,2,0,7,7
270531026001022,63,Northeast Park,20,20,1000000US270531026001022,"Block 1022, Block Group 1, Census Tract 1026, Hennepin County, Minnesota",0,0,0,0,0,0,0,0,0,0,0,0,0,0,0,0,0,0,0,0,0,0,0,0,0
270531026001008,63,Northeast Park,20,20,1000000US270531026001008,"Block 1008, Block Group 1, Census Tract 1026, Hennepin County, Minnesota",35,28,7,0,0,0,0,0,35,35,28,7,0,0,0,0,0,0,0,0,0,0,0,0,0
270531026001005,63,Northeast Park,20,20,1000000US270531026001005,"Block 1005, Block Group 1, Census Tract 1026, Hennepin County, Minnesota",0,0,0,0,0,0,0,0,0,0,0,0,0,0,0,0,0,0,0,0,0,0,0,0,0
270531026001018,63,Northeast Park,20,20,1000000US270531026001018,"Block 1018, Block Group 1, Census Tract 1026, Hennepin County, Minnesota",0,0,0,0,0,0,0,0,0,0,0,0,0,0,0,0,0,0,0,0,0,0,0,0,0
270531026001014,63,Northeast Park,20,20,1000000US270531026001014,"Block 1014, Block Group 1, Census Tract 1026, Hennepin County, Minnesota",36,26,1,1,1,0,5,2,36,29,25,1,1,1,0,0,1,7,1,0,0,0,0,5,1
270531026001019,63,Northeast Park,20,20,1000000US270531026001019,"Block 1019, Block Group 1, Census Tract 1026, Hennepin County, Minnesota",0,0,0,0,0,0,0,0,0,0,0,0,0,0,0,0,0,0,0,0,0,0,0,0,0
270531026001027,63,Northeast Park,20,20,1000000US270531026001027,"Block 1027, Block Group 1, Census Tract 1026, Hennepin County, Minnesota",7,7,0,0,0,0,0,0,7,6,6,0,0,0,0,0,0,1,1,0,0,0,0,0,0
270531026001001,63,Northeast Park,20,20,1000000US270531026001001,"Block 1001, Block Group 1, Census Tract 1026, Hennepin County, Minnesota",0,0,0,0,0,0,0,0,0,0,0,0,0,0,0,0,0,0,0,0,0,0,0,0,0
270531030001005,64,St. Anthony West,21,21,1000000US270531030001005,"Block 1005, Block Group 1, Census Tract 1030, Hennepin County, Minnesota",26,16,1,0,0,0,6,3,26,19,15,1,0,0,0,0,3,7,1,0,0,0,0,6,0
270531030001004,64,St. Anthony West,21,21,1000000US270531030001004,"Block 1004, Block Group 1, Census Tract 1030, Hennepin County, Minnesota",79,60,5,3,2,0,6,3,79,72,59,5,3,2,0,0,3,7,1,0,0,0,0,6,0
270531030001001,64,St. Anthony West,21,21,1000000US270531030001001,"Block 1001, Block Group 1, Census Tract 1030, Hennepin County, Minnesota",18,4,11,0,0,0,3,0,18,15,4,11,0,0,0,0,0,3,0,0,0,0,0,3,0
270531030002019,64,St. Anthony West,21,21,1000000US270531030002019,"Block 2019, Block Group 2, Census Tract 1030, Hennepin County, Minnesota",0,0,0,0,0,0,0,0,0,0,0,0,0,0,0,0,0,0,0,0,0,0,0,0,0
270531030002013,64,St. Anthony West,21,21,1000000US270531030002013,"Block 2013, Block Group 2, Census Tract 1030, Hennepin County, Minnesota",33,31,0,0,1,0,0,1,33,33,31,0,0,1,0,0,1,0,0,0,0,0,0,0,0
270531030001002,64,St. Anthony West,21,21,1000000US270531030001002,"Block 1002, Block Group 1, Census Tract 1030, Hennepin County, Minnesota",19,10,4,2,1,0,0,2,19,19,10,4,2,1,0,0,2,0,0,0,0,0,0,0,0
270531030002011,64,St. Anthony West,21,21,1000000US270531030002011,"Block 2011, Block Group 2, Census Tract 1030, Hennepin County, Minnesota",40,40,0,0,0,0,0,0,40,40,40,0,0,0,0,0,0,0,0,0,0,0,0,0,0
270531030002008,64,St. Anthony West,21,21,1000000US270531030002008,"Block 2008, Block Group 2, Census Tract 1030, Hennepin County, Minnesota",24,11,9,0,4,0,0,0,24,24,11,9,0,4,0,0,0,0,0,0,0,0,0,0,0
270531030001009,64,St. Anthony West,21,21,1000000US270531030001009,"Block 1009, Block Group 1, Census Tract 1030, Hennepin County, Minnesota",0,0,0,0,0,0,0,0,0,0,0,0,0,0,0,0,0,0,0,0,0,0,0,0,0
270531030002001,64,St. Anthony West,21,21,1000000US270531030002001,"Block 2001, Block Group 2, Census Tract 1030, Hennepin County, Minnesota",65,62,0,0,0,0,0,3,65,61,59,0,0,0,0,0,2,4,3,0,0,0,0,0,1
270531036001012,64,St. Anthony West,21,21,1000000US270531036001012,"Block 1012, Block Group 1, Census Tract 1036, Hennepin County, Minnesota",36,28,4,0,4,0,0,0,36,36,28,4,0,4,0,0,0,0,0,0,0,0,0,0,0
270531030002007,64,St. Anthony West,21,21,1000000US270531030002007,"Block 2007, Block Group 2, Census Tract 1030, Hennepin County, Minnesota",18,18,0,0,0,0,0,0,18,18,18,0,0,0,0,0,0,0,0,0,0,0,0,0,0
270531030001015,64,St. Anthony West,21,21,1000000US270531030001015,"Block 1015, Block Group 1, Census Tract 1030, Hennepin County, Minnesota",210,201,4,0,1,1,1,2,210,206,200,4,0,1,1,0,0,4,1,0,0,0,0,1,2
270531030001003,64,St. Anthony West,21,21,1000000US270531030001003,"Block 1003, Block Group 1, Census Tract 1030, Hennepin County, Minnesota",0,0,0,0,0,0,0,0,0,0,0,0,0,0,0,0,0,0,0,0,0,0,0,0,0
270531030002012,64,St. Anthony West,21,21,1000000US270531030002012,"Block 2012, Block Group 2, Census Tract 1030, Hennepin County, Minnesota",32,27,0,0,5,0,0,0,32,32,27,0,0,5,0,0,0,0,0,0,0,0,0,0,0
270531036001003,64,St. Anthony West,21,21,1000000US270531036001003,"Block 1003, Block Group 1, Census Tract 1036, Hennepin County, Minnesota",39,38,0,0,1,0,0,0,39,39,38,0,0,1,0,0,0,0,0,0,0,0,0,0,0
270531030002014,64,St. Anthony West,21,21,1000000US270531030002014,"Block 2014, Block Group 2, Census Tract 1030, Hennepin County, Minnesota",13,13,0,0,0,0,0,0,13,13,13,0,0,0,0,0,0,0,0,0,0,0,0,0,0
270531030001012,64,St. Anthony West,21,21,1000000US270531030001012,"Block 1012, Block Group 1, Census Tract 1030, Hennepin County, Minnesota",0,0,0,0,0,0,0,0,0,0,0,0,0,0,0,0,0,0,0,0,0,0,0,0,0
270531030001019,64,St. Anthony West,21,21,1000000US270531030001019,"Block 1019, Block Group 1, Census Tract 1030, Hennepin County, Minnesota",0,0,0,0,0,0,0,0,0,0,0,0,0,0,0,0,0,0,0,0,0,0,0,0,0
270531030001008,64,St. Anthony West,21,21,1000000US270531030001008,"Block 1008, Block Group 1, Census Tract 1030, Hennepin County, Minnesota",0,0,0,0,0,0,0,0,0,0,0,0,0,0,0,0,0,0,0,0,0,0,0,0,0
270531030001014,64,St. Anthony West,21,21,1000000US270531030001014,"Block 1014, Block Group 1, Census Tract 1030, Hennepin County, Minnesota",38,33,1,0,0,0,0,4,38,36,31,1,0,0,0,0,4,2,2,0,0,0,0,0,0
270531030001016,64,St. Anthony West,21,21,1000000US270531030001016,"Block 1016, Block Group 1, Census Tract 1030, Hennepin County, Minnesota",61,27,0,0,2,0,25,7,61,25,22,0,0,2,0,0,1,36,5,0,0,0,0,25,6
270531030002003,64,St. Anthony West,21,21,1000000US270531030002003,"Block 2003, Block Group 2, Census Tract 1030, Hennepin County, Minnesota",68,65,1,0,1,0,0,1,68,67,64,1,0,1,0,0,1,1,1,0,0,0,0,0,0
270531036001006,64,St. Anthony West,21,21,1000000US270531036001006,"Block 1006, Block Group 1, Census Tract 1036, Hennepin County, Minnesota",61,47,4,1,9,0,0,0,61,57,45,2,1,9,0,0,0,4,2,2,0,0,0,0,0
270531030002002,64,St. Anthony West,21,21,1000000US270531030002002,"Block 2002, Block Group 2, Census Tract 1030, Hennepin County, Minnesota",0,0,0,0,0,0,0,0,0,0,0,0,0,0,0,0,0,0,0,0,0,0,0,0,0
270531030002020,64,St. Anthony West,21,21,1000000US270531030002020,"Block 2020, Block Group 2, Census Tract 1030, Hennepin County, Minnesota",0,0,0,0,0,0,0,0,0,0,0,0,0,0,0,0,0,0,0,0,0,0,0,0,0
270531030001018,64,St. Anthony West,21,21,1000000US270531030001018,"Block 1018, Block Group 1, Census Tract 1030, Hennepin County, Minnesota",76,62,1,1,4,0,1,7,76,71,59,1,1,4,0,0,6,5,3,0,0,0,0,1,1
270531030002006,64,St. Anthony West,21,21,1000000US270531030002006,"Block 2006, Block Group 2, Census Tract 1030, Hennepin County, Minnesota",56,33,14,0,2,0,1,6,56,54,33,14,0,2,0,0,5,2,0,0,0,0,0,1,1
270531030001011,64,St. Anthony West,21,21,1000000US270531030001011,"Block 1011, Block Group 1, Census Tract 1030, Hennepin County, Minnesota",0,0,0,0,0,0,0,0,0,0,0,0,0,0,0,0,0,0,0,0,0,0,0,0,0
270531036001004,64,St. Anthony West,21,21,1000000US270531036001004,"Block 1004, Block Group 1, Census Tract 1036, Hennepin County, Minnesota",12,12,0,0,0,0,0,0,12,12,12,0,0,0,0,0,0,0,0,0,0,0,0,0,0
270531030001010,64,St. Anthony West,21,21,1000000US270531030001010,"Block 1010, Block Group 1, Census Tract 1030, Hennepin County, Minnesota",0,0,0,0,0,0,0,0,0,0,0,0,0,0,0,0,0,0,0,0,0,0,0,0,0
270531036001005,64,St. Anthony West,21,21,1000000US270531036001005,"Block 1005, Block Group 1, Census Tract 1036, Hennepin County, Minnesota",68,61,0,0,4,1,0,2,68,64,59,0,0,4,0,0,1,4,2,0,0,0,1,0,1
270531030002016,64,St. Anthony West,21,21,1000000US270531030002016,"Block 2016, Block Group 2, Census Tract 1030, Hennepin County, Minnesota",94,89,3,0,0,0,0,2,94,93,88,3,0,0,0,0,2,1,1,0,0,0,0,0,0
270531036001001,64,St. Anthony West,21,21,1000000US270531036001001,"Block 1001, Block Group 1, Census Tract 1036, Hennepin County, Minnesota",27,23,0,1,1,0,0,2,27,27,23,0,1,1,0,0,2,0,0,0,0,0,0,0,0
270531036001000,64,St. Anthony West,21,21,1000000US270531036001000,"Block 1000, Block Group 1, Census Tract 1036, Hennepin County, Minnesota",52,50,0,0,0,0,0,2,52,51,50,0,0,0,0,0,1,1,0,0,0,0,0,0,1
270531031001019,64,St. Anthony West,21,21,1000000US270531031001019,"Block 1019, Block Group 1, Census Tract 1031, Hennepin County, Minnesota",0,0,0,0,0,0,0,0,0,0,0,0,0,0,0,0,0,0,0,0,0,0,0,0,0
270531030001000,64,St. Anthony West,21,21,1000000US270531030001000,"Block 1000, Block Group 1, Census Tract 1030, Hennepin County, Minnesota",46,39,3,0,3,0,0,1,46,46,39,3,0,3,0,0,1,0,0,0,0,0,0,0,0
270531030002017,64,St. Anthony West,21,21,1000000US270531030002017,"Block 2017, Block Group 2, Census Tract 1030, Hennepin County, Minnesota",55,29,20,5,0,0,0,1,55,52,29,19,3,0,0,0,1,3,0,1,2,0,0,0,0
270531036001007,64,St. Anthony West,21,21,1000000US270531036001007,"Block 1007, Block Group 1, Census Tract 1036, Hennepin County, Minnesota",54,38,0,0,2,0,10,4,54,44,38,0,0,2,0,0,4,10,0,0,0,0,0,10,0
270531036001010,64,St. Anthony West,21,21,1000000US270531036001010,"Block 1010, Block Group 1, Census Tract 1036, Hennepin County, Minnesota",97,57,30,3,2,0,2,3,97,95,57,30,3,2,0,0,3,2,0,0,0,0,0,2,0
270531036001008,64,St. Anthony West,21,21,1000000US270531036001008,"Block 1008, Block Group 1, Census Tract 1036, Hennepin County, Minnesota",60,44,5,2,0,0,8,1,60,50,42,5,2,0,0,0,1,10,2,0,0,0,0,8,0
270531030001007,64,St. Anthony West,21,21,1000000US270531030001007,"Block 1007, Block Group 1, Census Tract 1030, Hennepin County, Minnesota",0,0,0,0,0,0,0,0,0,0,0,0,0,0,0,0,0,0,0,0,0,0,0,0,0
270531036001013,64,St. Anthony West,21,21,1000000US270531036001013,"Block 1013, Block Group 1, Census Tract 1036, Hennepin County, Minnesota",83,75,3,0,2,0,2,1,83,80,74,3,0,2,0,0,1,3,1,0,0,0,0,2,0
270531030001013,64,St. Anthony West,21,21,1000000US270531030001013,"Block 1013, Block Group 1, Census Tract 1030, Hennepin County, Minnesota",67,53,4,1,2,0,1,6,67,61,51,4,1,2,0,0,3,6,2,0,0,0,0,1,3
270531030002009,64,St. Anthony West,21,21,1000000US270531030002009,"Block 2009, Block Group 2, Census Tract 1030, Hennepin County, Minnesota",31,12,2,1,14,0,0,2,31,31,12,2,1,14,0,0,2,0,0,0,0,0,0,0,0
270531030002004,64,St. Anthony West,21,21,1000000US270531030002004,"Block 2004, Block Group 2, Census Tract 1030, Hennepin County, Minnesota",48,42,0,0,0,0,6,0,48,42,41,0,0,0,0,1,0,6,1,0,0,0,0,5,0
270531030002005,64,St. Anthony West,21,21,1000000US270531030002005,"Block 2005, Block Group 2, Census Tract 1030, Hennepin County, Minnesota",72,68,0,0,2,0,0,2,72,71,67,0,0,2,0,0,2,1,1,0,0,0,0,0,0
270531030002010,64,St. Anthony West,21,21,1000000US270531030002010,"Block 2010, Block Group 2, Census Tract 1030, Hennepin County, Minnesota",13,10,0,0,3,0,0,0,13,13,10,0,0,3,0,0,0,0,0,0,0,0,0,0,0
270531036001002,64,St. Anthony West,21,21,1000000US270531036001002,"Block 1002, Block Group 1, Census Tract 1036, Hennepin County, Minnesota",33,25,3,0,2,0,3,0,33,30,25,3,0,2,0,0,0,3,0,0,0,0,0,3,0
270531030002015,64,St. Anthony West,21,21,1000000US270531030002015,"Block 2015, Block Group 2, Census Tract 1030, Hennepin County, Minnesota",63,55,2,0,1,0,0,5,63,56,48,2,0,1,0,0,5,7,7,0,0,0,0,0,0
270531036001011,64,St. Anthony West,21,21,1000000US270531036001011,"Block 1011, Block Group 1, Census Tract 1036, Hennepin County, Minnesota",51,42,0,0,4,0,4,1,51,45,41,0,0,4,0,0,0,6,1,0,0,0,0,4,1
270531036001009,64,St. Anthony West,21,21,1000000US270531036001009,"Block 1009, Block Group 1, Census Tract 1036, Hennepin County, Minnesota",51,43,2,0,2,0,0,4,51,47,40,2,0,2,0,0,3,4,3,0,0,0,0,0,1
270531030001006,64,St. Anthony West,21,21,1000000US270531030001006,"Block 1006, Block Group 1, Census Tract 1030, Hennepin County, Minnesota",0,0,0,0,0,0,0,0,0,0,0,0,0,0,0,0,0,0,0,0,0,0,0,0,0
270531030001020,64,St. Anthony West,21,21,1000000US270531030001020,"Block 1020, Block Group 1, Census Tract 1030, Hennepin County, Minnesota",47,38,2,1,2,0,0,4,47,46,37,2,1,2,0,0,4,1,1,0,0,0,0,0,0
270531036001014,64,St. Anthony West,21,21,1000000US270531036001014,"Block 1014, Block Group 1, Census Tract 1036, Hennepin County, Minnesota",51,49,0,0,1,0,0,1,51,50,48,0,0,1,0,0,1,1,1,0,0,0,0,0,0
270531030002018,64,St. Anthony West,21,21,1000000US270531030002018,"Block 2018, Block Group 2, Census Tract 1030, Hennepin County, Minnesota",0,0,0,0,0,0,0,0,0,0,0,0,0,0,0,0,0,0,0,0,0,0,0,0,0
270531030001017,64,St. Anthony West,21,21,1000000US270531030001017,"Block 1017, Block Group 1, Census Tract 1030, Hennepin County, Minnesota",56,48,8,0,0,0,0,0,56,54,46,8,0,0,0,0,0,2,2,0,0,0,0,0,0
270531030002000,64,St. Anthony West,21,21,1000000US270531030002000,"Block 2000, Block Group 2, Census Tract 1030, Hennepin County, Minnesota",0,0,0,0,0,0,0,0,0,0,0,0,0,0,0,0,0,0,0,0,0,0,0,0,0
270531031001002,65,St. Anthony East,22,22,1000000US270531031001002,"Block 1002, Block Group 1, Census Tract 1031, Hennepin County, Minnesota",60,57,2,0,0,0,0,1,60,59,56,2,0,0,0,0,1,1,1,0,0,0,0,0,0
270531031001001,65,St. Anthony East,22,22,1000000US270531031001001,"Block 1001, Block Group 1, Census Tract 1031, Hennepin County, Minnesota",131,65,23,3,8,0,10,22,131,104,60,23,3,8,0,0,10,27,5,0,0,0,0,10,12
270531031001000,65,St. Anthony East,22,22,1000000US270531031001000,"Block 1000, Block Group 1, Census Tract 1031, Hennepin County, Minnesota",53,37,8,0,4,0,4,0,53,49,37,8,0,4,0,0,0,4,0,0,0,0,0,4,0
270531031001020,65,St. Anthony East,22,22,1000000US270531031001020,"Block 1020, Block Group 1, Census Tract 1031, Hennepin County, Minnesota",146,123,13,1,5,0,2,2,146,139,119,12,1,5,0,0,2,7,4,1,0,0,0,2,0
270531031001012,65,St. Anthony East,22,22,1000000US270531031001012,"Block 1012, Block Group 1, Census Tract 1031, Hennepin County, Minnesota",100,69,8,5,0,0,8,10,100,87,68,8,5,0,0,0,6,13,1,0,0,0,0,8,4
270531031001022,65,St. Anthony East,22,22,1000000US270531031001022,"Block 1022, Block Group 1, Census Tract 1031, Hennepin County, Minnesota",57,50,3,1,1,0,1,1,57,54,48,3,1,1,0,0,1,3,2,0,0,0,0,1,0
270531031001005,65,St. Anthony East,22,22,1000000US270531031001005,"Block 1005, Block Group 1, Census Tract 1031, Hennepin County, Minnesota",93,62,8,6,1,0,13,3,93,87,62,8,6,1,0,7,3,6,0,0,0,0,0,6,0
270531031001017,65,St. Anthony East,22,22,1000000US270531031001017,"Block 1017, Block Group 1, Census Tract 1031, Hennepin County, Minnesota",62,51,8,0,0,0,2,1,62,56,45,8,0,0,0,2,1,6,6,0,0,0,0,0,0
270531031001010,65,St. Anthony East,22,22,1000000US270531031001010,"Block 1010, Block Group 1, Census Tract 1031, Hennepin County, Minnesota",94,73,14,1,4,0,0,2,94,93,73,14,1,4,0,0,1,1,0,0,0,0,0,0,1
270531031001021,65,St. Anthony East,22,22,1000000US270531031001021,"Block 1021, Block Group 1, Census Tract 1031, Hennepin County, Minnesota",45,42,2,0,1,0,0,0,45,45,42,2,0,1,0,0,0,0,0,0,0,0,0,0,0
270531031001016,65,St. Anthony East,22,22,1000000US270531031001016,"Block 1016, Block Group 1, Census Tract 1031, Hennepin County, Minnesota",68,51,11,0,0,0,0,6,68,60,43,11,0,0,0,0,6,8,8,0,0,0,0,0,0
270531031001008,65,St. Anthony East,22,22,1000000US270531031001008,"Block 1008, Block Group 1, Census Tract 1031, Hennepin County, Minnesota",42,30,1,7,0,0,1,3,42,40,29,1,6,0,0,1,3,2,1,0,1,0,0,0,0
270531031001013,65,St. Anthony East,22,22,1000000US270531031001013,"Block 1013, Block Group 1, Census Tract 1031, Hennepin County, Minnesota",96,65,10,0,0,0,16,5,96,78,64,9,0,0,0,2,3,18,1,1,0,0,0,14,2
270531031001011,65,St. Anthony East,22,22,1000000US270531031001011,"Block 1011, Block Group 1, Census Tract 1031, Hennepin County, Minnesota",86,73,2,2,0,0,4,5,86,77,65,2,2,0,0,3,5,9,8,0,0,0,0,1,0
270531031001009,65,St. Anthony East,22,22,1000000US270531031001009,"Block 1009, Block Group 1, Census Tract 1031, Hennepin County, Minnesota",94,69,9,1,1,0,10,4,94,82,67,9,1,1,0,0,4,12,2,0,0,0,0,10,0
270531031001004,65,St. Anthony East,22,22,1000000US270531031001004,"Block 1004, Block Group 1, Census Tract 1031, Hennepin County, Minnesota",98,77,10,4,4,0,0,3,98,86,67,10,2,4,0,0,3,12,10,0,2,0,0,0,0
270531031001015,65,St. Anthony East,22,22,1000000US270531031001015,"Block 1015, Block Group 1, Census Tract 1031, Hennepin County, Minnesota",225,111,93,3,10,0,0,8,225,220,111,89,2,10,0,0,8,5,0,4,1,0,0,0,0
270531031001014,65,St. Anthony East,22,22,1000000US270531031001014,"Block 1014, Block Group 1, Census Tract 1031, Hennepin County, Minnesota",225,155,34,7,17,0,0,12,225,217,148,34,7,17,0,0,11,8,7,0,0,0,0,0,1
270531031001007,65,St. Anthony East,22,22,1000000US270531031001007,"Block 1007, Block Group 1, Census Tract 1031, Hennepin County, Minnesota",43,23,4,0,1,0,9,6,43,15,8,4,0,1,0,0,2,28,15,0,0,0,0,9,4
270531031001003,65,St. Anthony East,22,22,1000000US270531031001003,"Block 1003, Block Group 1, Census Tract 1031, Hennepin County, Minnesota",77,60,8,3,0,0,6,0,77,65,54,8,3,0,0,0,0,12,6,0,0,0,0,6,0
270531031001018,65,St. Anthony East,22,22,1000000US270531031001018,"Block 1018, Block Group 1, Census Tract 1031, Hennepin County, Minnesota",51,42,7,1,0,0,0,1,51,44,36,7,1,0,0,0,0,7,6,0,0,0,0,0,1
270531031001006,65,St. Anthony East,22,22,1000000US270531031001006,"Block 1006, Block Group 1, Census Tract 1031, Hennepin County, Minnesota",92,59,0,1,1,0,22,9,92,61,58,0,1,1,0,0,1,31,1,0,0,0,0,22,8
270530095002006,66,Central,54,54,1000000US270530095002006,"Block 2006, Block Group 2, Census Tract 95, Hennepin County, Minnesota",47,22,6,1,10,0,0,8,47,44,22,6,1,10,0,0,5,3,0,0,0,0,0,0,3
270530084002010,66,Central,54,54,1000000US270530084002010,"Block 2010, Block Group 2, Census Tract 84, Hennepin County, Minnesota",55,24,8,1,0,0,14,8,55,30,15,7,1,0,0,0,7,25,9,1,0,0,0,14,1
270530083001001,66,Central,54,54,1000000US270530083001001,"Block 1001, Block Group 1, Census Tract 83, Hennepin County, Minnesota",109,18,19,0,0,0,68,4,109,27,8,19,0,0,0,0,0,82,10,0,0,0,0,68,4
270530083001011,66,Central,54,54,1000000US270530083001011,"Block 1011, Block Group 1, Census Tract 83, Hennepin County, Minnesota",145,48,33,0,1,0,52,11,145,65,28,33,0,1,0,0,3,80,20,0,0,0,0,52,8
270531094001000,66,Central,54,54,1000000US270531094001000,"Block 1000, Block Group 1, Census Tract 1094, Hennepin County, Minnesota",101,18,48,9,0,0,17,9,101,65,9,48,1,0,0,0,7,36,9,0,8,0,0,17,2
270530084002015,66,Central,54,54,1000000US270530084002015,"Block 2015, Block Group 2, Census Tract 84, Hennepin County, Minnesota",56,33,0,1,0,0,17,5,56,26,21,0,1,0,0,0,4,30,12,0,0,0,0,17,1
270530095002004,66,Central,54,54,1000000US270530095002004,"Block 2004, Block Group 2, Census Tract 95, Hennepin County, Minnesota",110,39,33,3,2,0,27,6,110,48,7,32,2,2,0,0,5,62,32,1,1,0,0,27,1
270530095002002,66,Central,54,54,1000000US270530095002002,"Block 2002, Block Group 2, Census Tract 95, Hennepin County, Minnesota",131,48,18,5,9,0,48,3,131,73,40,17,5,9,0,0,2,58,8,1,0,0,0,48,1
270531094001010,66,Central,54,54,1000000US270531094001010,"Block 1010, Block Group 1, Census Tract 1094, Hennepin County, Minnesota",103,44,34,1,0,0,20,4,103,56,24,28,1,0,0,0,3,47,20,6,0,0,0,20,1
270530095001003,66,Central,54,54,1000000US270530095001003,"Block 1003, Block Group 1, Census Tract 95, Hennepin County, Minnesota",139,57,38,3,0,0,30,11,139,97,52,32,3,0,0,0,10,42,5,6,0,0,0,30,1
270530084001006,66,Central,54,54,1000000US270530084001006,"Block 1006, Block Group 1, Census Tract 84, Hennepin County, Minnesota",134,70,22,0,0,0,30,12,134,86,58,22,0,0,0,1,5,48,12,0,0,0,0,29,7
270530083001003,66,Central,54,54,1000000US270530083001003,"Block 1003, Block Group 1, Census Tract 83, Hennepin County, Minnesota",0,0,0,0,0,0,0,0,0,0,0,0,0,0,0,0,0,0,0,0,0,0,0,0,0
270530083001010,66,Central,54,54,1000000US270530083001010,"Block 1010, Block Group 1, Census Tract 83, Hennepin County, Minnesota",132,41,25,0,8,0,34,24,132,80,30,24,0,8,0,0,18,52,11,1,0,0,0,34,6
270531094001005,66,Central,54,54,1000000US270531094001005,"Block 1005, Block Group 1, Census Tract 1094, Hennepin County, Minnesota",0,0,0,0,0,0,0,0,0,0,0,0,0,0,0,0,0,0,0,0,0,0,0,0,0
270531094002005,66,Central,54,54,1000000US270531094002005,"Block 2005, Block Group 2, Census Tract 1094, Hennepin County, Minnesota",0,0,0,0,0,0,0,0,0,0,0,0,0,0,0,0,0,0,0,0,0,0,0,0,0
270530083001000,66,Central,54,54,1000000US270530083001000,"Block 1000, Block Group 1, Census Tract 83, Hennepin County, Minnesota",70,23,12,0,0,1,31,3,70,23,8,12,0,0,1,0,2,47,15,0,0,0,0,31,1
270530084002003,66,Central,54,54,1000000US270530084002003,"Block 2003, Block Group 2, Census Tract 84, Hennepin County, Minnesota",47,12,29,2,0,0,4,0,47,37,6,29,2,0,0,0,0,10,6,0,0,0,0,4,0
270530084002004,66,Central,54,54,1000000US270530084002004,"Block 2004, Block Group 2, Census Tract 84, Hennepin County, Minnesota",94,39,41,1,3,0,3,7,94,67,25,39,0,3,0,0,0,27,14,2,1,0,0,3,7
270530084002006,66,Central,54,54,1000000US270530084002006,"Block 2006, Block Group 2, Census Tract 84, Hennepin County, Minnesota",108,43,14,2,0,0,40,9,108,39,28,8,0,0,0,0,3,69,15,6,2,0,0,40,6
270530084002012,66,Central,54,54,1000000US270530084002012,"Block 2012, Block Group 2, Census Tract 84, Hennepin County, Minnesota",110,22,36,9,16,0,15,12,110,61,6,36,1,16,0,0,2,49,16,0,8,0,0,15,10
270530084002014,66,Central,54,54,1000000US270530084002014,"Block 2014, Block Group 2, Census Tract 84, Hennepin County, Minnesota",109,12,22,0,0,0,69,6,109,33,5,22,0,0,0,0,6,76,7,0,0,0,0,69,0
270531094001011,66,Central,54,54,1000000US270531094001011,"Block 1011, Block Group 1, Census Tract 1094, Hennepin County, Minnesota",162,57,29,5,18,0,46,7,162,71,17,29,5,18,0,0,2,91,40,0,0,0,0,46,5
270530095002003,66,Central,54,54,1000000US270530095002003,"Block 2003, Block Group 2, Census Tract 95, Hennepin County, Minnesota",85,23,20,2,1,0,35,4,85,41,16,20,2,1,0,0,2,44,7,0,0,0,0,35,2
270531094001001,66,Central,54,54,1000000US270531094001001,"Block 1001, Block Group 1, Census Tract 1094, Hennepin County, Minnesota",55,29,13,0,0,0,13,0,55,37,24,13,0,0,0,0,0,18,5,0,0,0,0,13,0
270531094002006,66,Central,54,54,1000000US270531094002006,"Block 2006, Block Group 2, Census Tract 1094, Hennepin County, Minnesota",0,0,0,0,0,0,0,0,0,0,0,0,0,0,0,0,0,0,0,0,0,0,0,0,0
270531094002008,66,Central,54,54,1000000US270531094002008,"Block 2008, Block Group 2, Census Tract 1094, Hennepin County, Minnesota",65,18,24,0,3,0,20,0,65,34,7,24,0,3,0,0,0,31,11,0,0,0,0,20,0
270531094002003,66,Central,54,54,1000000US270531094002003,"Block 2003, Block Group 2, Census Tract 1094, Hennepin County, Minnesota",120,16,42,3,5,0,45,9,120,64,13,42,1,5,0,0,3,56,3,0,2,0,0,45,6
270530083001006,66,Central,54,54,1000000US270530083001006,"Block 1006, Block Group 1, Census Tract 83, Hennepin County, Minnesota",150,46,52,4,0,0,31,17,150,82,19,52,4,0,0,4,3,68,27,0,0,0,0,27,14
270530084002005,66,Central,54,54,1000000US270530084002005,"Block 2005, Block Group 2, Census Tract 84, Hennepin County, Minnesota",97,24,35,0,12,0,17,9,97,72,24,35,0,12,0,0,1,25,0,0,0,0,0,17,8
270530083001009,66,Central,54,54,1000000US270530083001009,"Block 1009, Block Group 1, Census Tract 83, Hennepin County, Minnesota",111,34,40,1,2,0,30,4,111,73,26,40,1,2,0,0,4,38,8,0,0,0,0,30,0
270530083001008,66,Central,54,54,1000000US270530083001008,"Block 1008, Block Group 1, Census Tract 83, Hennepin County, Minnesota",161,37,59,12,0,0,43,10,161,85,13,59,12,0,0,0,1,76,24,0,0,0,0,43,9
270530083001013,66,Central,54,54,1000000US270530083001013,"Block 1013, Block Group 1, Census Tract 83, Hennepin County, Minnesota",221,27,81,5,30,0,66,12,221,128,11,81,5,30,0,0,1,93,16,0,0,0,0,66,11
270531094001003,66,Central,54,54,1000000US270531094001003,"Block 1003, Block Group 1, Census Tract 1094, Hennepin County, Minnesota",0,0,0,0,0,0,0,0,0,0,0,0,0,0,0,0,0,0,0,0,0,0,0,0,0
270531094001008,66,Central,54,54,1000000US270531094001008,"Block 1008, Block Group 1, Census Tract 1094, Hennepin County, Minnesota",118,33,46,1,0,0,31,7,118,69,19,43,1,0,0,0,6,49,14,3,0,0,0,31,1
270530084002013,66,Central,54,54,1000000US270530084002013,"Block 2013, Block Group 2, Census Tract 84, Hennepin County, Minnesota",105,28,28,2,8,0,34,5,105,57,14,28,2,8,0,0,5,48,14,0,0,0,0,34,0
270530095001005,66,Central,54,54,1000000US270530095001005,"Block 1005, Block Group 1, Census Tract 95, Hennepin County, Minnesota",206,75,24,0,0,0,95,12,206,59,33,24,0,0,0,0,2,147,42,0,0,0,0,95,10
270530095001000,66,Central,54,54,1000000US270530095001000,"Block 1000, Block Group 1, Census Tract 95, Hennepin County, Minnesota",124,35,13,2,1,1,53,19,124,68,32,13,2,1,1,0,19,56,3,0,0,0,0,53,0
270530095001007,66,Central,54,54,1000000US270530095001007,"Block 1007, Block Group 1, Census Tract 95, Hennepin County, Minnesota",64,33,6,3,0,0,9,13,64,38,17,5,3,0,0,1,12,26,16,1,0,0,0,8,1
270530083001002,66,Central,54,54,1000000US270530083001002,"Block 1002, Block Group 1, Census Tract 83, Hennepin County, Minnesota",61,22,11,9,6,0,10,3,61,41,22,11,0,6,0,0,2,20,0,0,9,0,0,10,1
270531094001006,66,Central,54,54,1000000US270531094001006,"Block 1006, Block Group 1, Census Tract 1094, Hennepin County, Minnesota",0,0,0,0,0,0,0,0,0,0,0,0,0,0,0,0,0,0,0,0,0,0,0,0,0
270530084002011,66,Central,54,54,1000000US270530084002011,"Block 2011, Block Group 2, Census Tract 84, Hennepin County, Minnesota",70,27,13,0,0,0,27,3,70,26,11,13,0,0,0,0,2,44,16,0,0,0,0,27,1
270531094001002,66,Central,54,54,1000000US270531094001002,"Block 1002, Block Group 1, Census Tract 1094, Hennepin County, Minnesota",77,21,28,1,2,0,10,15,77,45,14,28,1,2,0,0,0,32,7,0,0,0,0,10,15
270530084002000,66,Central,54,54,1000000US270530084002000,"Block 2000, Block Group 2, Census Tract 84, Hennepin County, Minnesota",131,60,23,0,0,0,33,15,131,52,26,23,0,0,0,0,3,79,34,0,0,0,0,33,12
270530084002007,66,Central,54,54,1000000US270530084002007,"Block 2007, Block Group 2, Census Tract 84, Hennepin County, Minnesota",70,44,11,0,3,0,0,12,70,60,44,11,0,3,0,0,2,10,0,0,0,0,0,0,10
270530084001002,66,Central,54,54,1000000US270530084001002,"Block 1002, Block Group 1, Census Tract 84, Hennepin County, Minnesota",111,75,24,3,1,0,6,2,111,89,62,24,1,1,0,0,1,22,13,0,2,0,0,6,1
270530084001003,66,Central,54,54,1000000US270530084001003,"Block 1003, Block Group 1, Census Tract 84, Hennepin County, Minnesota",170,48,58,5,0,0,44,15,170,100,30,54,4,0,0,0,12,70,18,4,1,0,0,44,3
270530084002008,66,Central,54,54,1000000US270530084002008,"Block 2008, Block Group 2, Census Tract 84, Hennepin County, Minnesota",152,63,26,2,5,0,46,10,152,98,58,26,2,5,0,0,7,54,5,0,0,0,0,46,3
270530084001004,66,Central,54,54,1000000US270530084001004,"Block 1004, Block Group 1, Census Tract 84, Hennepin County, Minnesota",121,43,39,0,5,0,28,6,121,79,30,39,0,5,0,5,0,42,13,0,0,0,0,23,6
270531094002001,66,Central,54,54,1000000US270531094002001,"Block 2001, Block Group 2, Census Tract 1094, Hennepin County, Minnesota",122,12,47,4,14,0,41,4,122,72,4,47,3,14,0,0,4,50,8,0,1,0,0,41,0
270531094002004,66,Central,54,54,1000000US270531094002004,"Block 2004, Block Group 2, Census Tract 1094, Hennepin County, Minnesota",106,46,28,0,9,0,20,3,106,68,31,28,0,8,0,0,1,38,15,0,0,1,0,20,2
270530083001012,66,Central,54,54,1000000US270530083001012,"Block 1012, Block Group 1, Census Tract 83, Hennepin County, Minnesota",128,56,12,0,6,0,45,9,128,47,24,12,0,6,0,0,5,81,32,0,0,0,0,45,4
270531094002009,66,Central,54,54,1000000US270531094002009,"Block 2009, Block Group 2, Census Tract 1094, Hennepin County, Minnesota",150,27,46,2,15,0,52,8,150,78,14,45,2,15,0,0,2,72,13,1,0,0,0,52,6
270530095002000,66,Central,54,54,1000000US270530095002000,"Block 2000, Block Group 2, Census Tract 95, Hennepin County, Minnesota",132,27,50,2,0,0,41,12,132,74,17,49,2,0,0,0,6,58,10,1,0,0,0,41,6
270531094002002,66,Central,54,54,1000000US270531094002002,"Block 2002, Block Group 2, Census Tract 1094, Hennepin County, Minnesota",107,26,26,4,3,0,40,8,107,61,20,26,4,3,0,0,8,46,6,0,0,0,0,40,0
270530095002005,66,Central,54,54,1000000US270530095002005,"Block 2005, Block Group 2, Census Tract 95, Hennepin County, Minnesota",122,36,20,0,24,0,31,11,122,77,29,20,0,24,0,0,4,45,7,0,0,0,0,31,7
270531094002010,66,Central,54,54,1000000US270531094002010,"Block 2010, Block Group 2, Census Tract 1094, Hennepin County, Minnesota",108,47,26,0,7,0,22,6,108,78,40,26,0,7,0,1,4,30,7,0,0,0,0,21,2
270530095002007,66,Central,54,54,1000000US270530095002007,"Block 2007, Block Group 2, Census Tract 95, Hennepin County, Minnesota",100,46,20,11,1,0,14,8,100,85,46,20,11,1,0,0,7,15,0,0,0,0,0,14,1
270530083001005,66,Central,54,54,1000000US270530083001005,"Block 1005, Block Group 1, Census Tract 83, Hennepin County, Minnesota",81,36,26,0,1,0,18,0,81,63,36,26,0,1,0,0,0,18,0,0,0,0,0,18,0
270531094001007,66,Central,54,54,1000000US270531094001007,"Block 1007, Block Group 1, Census Tract 1094, Hennepin County, Minnesota",200,18,84,18,3,0,73,4,200,112,11,83,13,2,0,0,3,88,7,1,5,1,0,73,1
270530084002002,66,Central,54,54,1000000US270530084002002,"Block 2002, Block Group 2, Census Tract 84, Hennepin County, Minnesota",124,34,14,5,0,0,52,19,124,31,20,5,5,0,0,0,1,93,14,9,0,0,0,52,18
270530084002001,66,Central,54,54,1000000US270530084002001,"Block 2001, Block Group 2, Census Tract 84, Hennepin County, Minnesota",143,70,18,3,0,0,52,0,143,47,34,11,2,0,0,0,0,96,36,7,1,0,0,52,0
270530084002009,66,Central,54,54,1000000US270530084002009,"Block 2009, Block Group 2, Census Tract 84, Hennepin County, Minnesota",146,52,27,1,0,0,39,27,146,63,30,19,1,0,0,0,13,83,22,8,0,0,0,39,14
270531094001009,66,Central,54,54,1000000US270531094001009,"Block 1009, Block Group 1, Census Tract 1094, Hennepin County, Minnesota",139,41,34,1,2,0,50,11,139,69,29,34,1,2,0,0,3,70,12,0,0,0,0,50,8
270530084001001,66,Central,54,54,1000000US270530084001001,"Block 1001, Block Group 1, Census Tract 84, Hennepin County, Minnesota",110,46,11,9,0,0,44,0,110,36,15,11,9,0,0,1,0,74,31,0,0,0,0,43,0
270530095001002,66,Central,54,54,1000000US270530095001002,"Block 1002, Block Group 1, Census Tract 95, Hennepin County, Minnesota",68,29,24,4,1,0,3,7,68,58,28,24,4,1,0,0,1,10,1,0,0,0,0,3,6
270530095001006,66,Central,54,54,1000000US270530095001006,"Block 1006, Block Group 1, Census Tract 95, Hennepin County, Minnesota",134,30,29,4,0,0,55,16,134,61,23,29,4,0,0,0,5,73,7,0,0,0,0,55,11
270530084001000,66,Central,54,54,1000000US270530084001000,"Block 1000, Block Group 1, Census Tract 84, Hennepin County, Minnesota",85,23,33,4,0,0,18,7,85,59,20,33,2,0,0,0,4,26,3,0,2,0,0,18,3
270530084002017,66,Central,54,54,1000000US270530084002017,"Block 2017, Block Group 2, Census Tract 84, Hennepin County, Minnesota",108,39,20,2,9,0,32,6,108,71,36,19,2,9,0,0,5,37,3,1,0,0,0,32,1
270530084001005,66,Central,54,54,1000000US270530084001005,"Block 1005, Block Group 1, Census Tract 84, Hennepin County, Minnesota",82,29,27,0,16,0,10,0,82,66,23,27,0,16,0,0,0,16,6,0,0,0,0,10,0
270530095001001,66,Central,54,54,1000000US270530095001001,"Block 1001, Block Group 1, Census Tract 95, Hennepin County, Minnesota",121,52,30,1,0,0,35,3,121,60,29,28,0,0,0,0,3,61,23,2,1,0,0,35,0
270530084001007,66,Central,54,54,1000000US270530084001007,"Block 1007, Block Group 1, Census Tract 84, Hennepin County, Minnesota",101,34,21,10,0,0,29,7,101,57,27,21,8,0,0,0,1,44,7,0,2,0,0,29,6
270531094002000,66,Central,54,54,1000000US270531094002000,"Block 2000, Block Group 2, Census Tract 1094, Hennepin County, Minnesota",130,49,28,1,6,0,30,16,130,72,32,27,1,6,0,0,6,58,17,1,0,0,0,30,10
270530083001004,66,Central,54,54,1000000US270530083001004,"Block 1004, Block Group 1, Census Tract 83, Hennepin County, Minnesota",0,0,0,0,0,0,0,0,0,0,0,0,0,0,0,0,0,0,0,0,0,0,0,0,0
270531094002007,66,Central,54,54,1000000US270531094002007,"Block 2007, Block Group 2, Census Tract 1094, Hennepin County, Minnesota",129,40,45,1,5,0,27,11,129,83,28,45,1,5,0,0,4,46,12,0,0,0,0,27,7
270531094001004,66,Central,54,54,1000000US270531094001004,"Block 1004, Block Group 1, Census Tract 1094, Hennepin County, Minnesota",169,13,73,13,19,0,45,6,169,123,13,73,12,19,0,0,6,46,0,0,1,0,0,45,0
270530083001007,66,Central,54,54,1000000US270530083001007,"Block 1007, Block Group 1, Census Tract 83, Hennepin County, Minnesota",134,13,57,0,6,0,50,8,134,77,12,57,0,6,0,0,2,57,1,0,0,0,0,50,6
270530095002001,66,Central,54,54,1000000US270530095002001,"Block 2001, Block Group 2, Census Tract 95, Hennepin County, Minnesota",165,67,49,11,0,0,35,3,165,97,38,43,11,0,0,2,3,68,29,6,0,0,0,33,0
270530084002016,66,Central,54,54,1000000US270530084002016,"Block 2016, Block Group 2, Census Tract 84, Hennepin County, Minnesota",81,36,18,0,1,0,22,4,81,56,34,17,0,1,0,0,4,25,2,1,0,0,0,22,0
270530095001004,66,Central,54,54,1000000US270530095001004,"Block 1004, Block Group 1, Census Tract 95, Hennepin County, Minnesota",175,61,33,22,4,0,38,17,175,99,32,32,22,4,0,0,9,76,29,1,0,0,0,38,8
270530096002005,67,Powderhorn Park,55,55,1000000US270530096002005,"Block 2005, Block Group 2, Census Tract 96, Hennepin County, Minnesota",64,30,25,0,3,0,0,6,64,61,27,25,0,3,0,0,6,3,3,0,0,0,0,0,0
270530085005009,67,Powderhorn Park,55,55,1000000US270530085005009,"Block 5009, Block Group 5, Census Tract 85, Hennepin County, Minnesota",110,86,10,0,0,0,3,11,110,99,81,10,0,0,0,0,8,11,5,0,0,0,0,3,3
270530085003001,67,Powderhorn Park,55,55,1000000US270530085003001,"Block 3001, Block Group 3, Census Tract 85, Hennepin County, Minnesota",193,125,4,5,7,0,40,12,193,103,79,4,5,7,0,0,8,90,46,0,0,0,0,40,4
270530085002003,67,Powderhorn Park,55,55,1000000US270530085002003,"Block 2003, Block Group 2, Census Tract 85, Hennepin County, Minnesota",304,82,86,3,0,0,101,32,304,141,47,84,3,0,0,0,7,163,35,2,0,0,0,101,25
270530085004004,67,Powderhorn Park,55,55,1000000US270530085004004,"Block 4004, Block Group 4, Census Tract 85, Hennepin County, Minnesota",0,0,0,0,0,0,0,0,0,0,0,0,0,0,0,0,0,0,0,0,0,0,0,0,0
270531086003003,67,Powderhorn Park,55,55,1000000US270531086003003,"Block 3003, Block Group 3, Census Tract 1086, Hennepin County, Minnesota",161,56,8,17,7,0,60,13,161,75,35,8,13,7,0,0,12,86,21,0,4,0,0,60,1
270531086003007,67,Powderhorn Park,55,55,1000000US270531086003007,"Block 3007, Block Group 3, Census Tract 1086, Hennepin County, Minnesota",84,47,5,6,10,0,11,5,84,62,47,5,0,7,0,3,0,22,0,0,6,3,0,8,5
270531086003001,67,Powderhorn Park,55,55,1000000US270531086003001,"Block 3001, Block Group 3, Census Tract 1086, Hennepin County, Minnesota",89,33,5,7,8,0,31,5,89,55,29,4,7,8,0,2,5,34,4,1,0,0,0,29,0
270531086003006,67,Powderhorn Park,55,55,1000000US270531086003006,"Block 3006, Block Group 3, Census Tract 1086, Hennepin County, Minnesota",62,50,4,1,0,0,1,6,62,57,47,4,1,0,0,0,5,5,3,0,0,0,0,1,1
270531097003000,67,Powderhorn Park,55,55,1000000US270531097003000,"Block 3000, Block Group 3, Census Tract 1097, Hennepin County, Minnesota",79,53,9,6,0,0,7,4,79,64,46,9,6,0,0,0,3,15,7,0,0,0,0,7,1
270530085001005,67,Powderhorn Park,55,55,1000000US270530085001005,"Block 1005, Block Group 1, Census Tract 85, Hennepin County, Minnesota",114,66,7,0,8,0,25,8,114,69,53,7,0,1,0,0,8,45,13,0,0,7,0,25,0
270531086003009,67,Powderhorn Park,55,55,1000000US270531086003009,"Block 3009, Block Group 3, Census Tract 1086, Hennepin County, Minnesota",82,55,2,10,0,0,9,6,82,63,48,2,10,0,0,0,3,19,7,0,0,0,0,9,3
270531097002009,67,Powderhorn Park,55,55,1000000US270531097002009,"Block 2009, Block Group 2, Census Tract 1097, Hennepin County, Minnesota",61,45,3,5,0,0,4,4,61,54,45,2,5,0,0,0,2,7,0,1,0,0,0,4,2
270531097002007,67,Powderhorn Park,55,55,1000000US270531097002007,"Block 2007, Block Group 2, Census Tract 1097, Hennepin County, Minnesota",69,63,4,1,0,0,0,1,69,62,56,4,1,0,0,0,1,7,7,0,0,0,0,0,0
270530085002005,67,Powderhorn Park,55,55,1000000US270530085002005,"Block 2005, Block Group 2, Census Tract 85, Hennepin County, Minnesota",96,57,15,10,0,0,8,6,96,77,51,15,10,0,0,0,1,19,6,0,0,0,0,8,5
270531097002010,67,Powderhorn Park,55,55,1000000US270531097002010,"Block 2010, Block Group 2, Census Tract 1097, Hennepin County, Minnesota",87,32,4,22,3,0,16,10,87,61,29,4,21,3,0,0,4,26,3,0,1,0,0,16,6
270531086003002,67,Powderhorn Park,55,55,1000000US270531086003002,"Block 3002, Block Group 3, Census Tract 1086, Hennepin County, Minnesota",98,49,15,9,8,0,10,7,98,84,48,15,8,8,0,1,4,14,1,0,1,0,0,9,3
270531097003002,67,Powderhorn Park,55,55,1000000US270531097003002,"Block 3002, Block Group 3, Census Tract 1097, Hennepin County, Minnesota",115,70,16,6,1,1,10,11,115,89,59,16,6,1,1,1,5,26,11,0,0,0,0,9,6
270531086003005,67,Powderhorn Park,55,55,1000000US270531086003005,"Block 3005, Block Group 3, Census Tract 1086, Hennepin County, Minnesota",105,64,10,9,0,0,12,10,105,82,52,10,8,0,0,2,10,23,12,0,1,0,0,10,0
270531097003001,67,Powderhorn Park,55,55,1000000US270531097003001,"Block 3001, Block Group 3, Census Tract 1097, Hennepin County, Minnesota",113,52,20,6,4,0,25,6,113,86,52,20,6,3,0,0,5,27,0,0,0,1,0,25,1
270531097002001,67,Powderhorn Park,55,55,1000000US270531097002001,"Block 2001, Block Group 2, Census Tract 1097, Hennepin County, Minnesota",114,66,4,3,0,0,36,5,114,64,53,4,1,0,0,2,4,50,13,0,2,0,0,34,1
270530085003002,67,Powderhorn Park,55,55,1000000US270530085003002,"Block 3002, Block Group 3, Census Tract 85, Hennepin County, Minnesota",289,170,16,3,7,0,65,28,289,165,135,16,2,2,0,0,10,124,35,0,1,5,0,65,18
270530085005004,67,Powderhorn Park,55,55,1000000US270530085005004,"Block 5004, Block Group 5, Census Tract 85, Hennepin County, Minnesota",44,26,7,1,4,0,3,3,44,33,18,7,1,4,0,0,3,11,8,0,0,0,0,3,0
270530085003000,67,Powderhorn Park,55,55,1000000US270530085003000,"Block 3000, Block Group 3, Census Tract 85, Hennepin County, Minnesota",176,70,11,13,4,0,72,6,176,66,43,11,5,4,0,0,3,110,27,0,8,0,0,72,3
270530085002004,67,Powderhorn Park,55,55,1000000US270530085002004,"Block 2004, Block Group 2, Census Tract 85, Hennepin County, Minnesota",94,57,7,0,9,0,15,6,94,69,49,7,0,6,0,1,6,25,8,0,0,3,0,14,0
270530096001003,67,Powderhorn Park,55,55,1000000US270530096001003,"Block 1003, Block Group 1, Census Tract 96, Hennepin County, Minnesota",118,67,32,0,0,0,15,4,118,90,54,31,0,0,0,2,3,28,13,1,0,0,0,13,1
270530096001002,67,Powderhorn Park,55,55,1000000US270530096001002,"Block 1002, Block Group 1, Census Tract 96, Hennepin County, Minnesota",131,72,15,2,5,0,34,3,131,71,46,15,2,5,0,0,3,60,26,0,0,0,0,34,0
270530096001001,67,Powderhorn Park,55,55,1000000US270530096001001,"Block 1001, Block Group 1, Census Tract 96, Hennepin County, Minnesota",170,75,35,2,0,0,41,17,170,82,44,32,0,0,0,0,6,88,31,3,2,0,0,41,11
270530096001006,67,Powderhorn Park,55,55,1000000US270530096001006,"Block 1006, Block Group 1, Census Tract 96, Hennepin County, Minnesota",72,56,9,2,0,0,0,5,72,68,52,9,2,0,0,0,5,4,4,0,0,0,0,0,0
270530085005010,67,Powderhorn Park,55,55,1000000US270530085005010,"Block 5010, Block Group 5, Census Tract 85, Hennepin County, Minnesota",105,83,12,1,0,0,1,8,105,90,75,12,1,0,0,0,2,15,8,0,0,0,0,1,6
270530085001002,67,Powderhorn Park,55,55,1000000US270530085001002,"Block 1002, Block Group 1, Census Tract 85, Hennepin County, Minnesota",188,63,18,9,9,0,81,8,188,86,46,18,8,9,0,1,4,102,17,0,1,0,0,80,4
270530096002001,67,Powderhorn Park,55,55,1000000US270530096002001,"Block 2001, Block Group 2, Census Tract 96, Hennepin County, Minnesota",24,10,10,0,0,0,0,4,24,22,10,10,0,0,0,0,2,2,0,0,0,0,0,0,2
270530096002000,67,Powderhorn Park,55,55,1000000US270530096002000,"Block 2000, Block Group 2, Census Tract 96, Hennepin County, Minnesota",101,59,7,1,0,0,26,8,101,70,53,7,1,0,0,1,8,31,6,0,0,0,0,25,0
270531097002006,67,Powderhorn Park,55,55,1000000US270531097002006,"Block 2006, Block Group 2, Census Tract 1097, Hennepin County, Minnesota",53,37,7,3,2,0,1,3,53,51,36,7,3,2,0,0,3,2,1,0,0,0,0,1,0
270530085005006,67,Powderhorn Park,55,55,1000000US270530085005006,"Block 5006, Block Group 5, Census Tract 85, Hennepin County, Minnesota",106,62,10,0,2,0,24,8,106,58,48,6,0,2,0,0,2,48,14,4,0,0,0,24,6
270530085005005,67,Powderhorn Park,55,55,1000000US270530085005005,"Block 5005, Block Group 5, Census Tract 85, Hennepin County, Minnesota",95,48,30,0,0,0,17,0,95,64,34,30,0,0,0,0,0,31,14,0,0,0,0,17,0
270530085001001,67,Powderhorn Park,55,55,1000000US270530085001001,"Block 1001, Block Group 1, Census Tract 85, Hennepin County, Minnesota",128,66,22,7,6,0,19,8,128,81,44,19,7,6,0,0,5,47,22,3,0,0,0,19,3
270530085002002,67,Powderhorn Park,55,55,1000000US270530085002002,"Block 2002, Block Group 2, Census Tract 85, Hennepin County, Minnesota",158,87,4,0,0,0,62,5,158,52,45,4,0,0,0,0,3,106,42,0,0,0,0,62,2
270530096001000,67,Powderhorn Park,55,55,1000000US270530096001000,"Block 1000, Block Group 1, Census Tract 96, Hennepin County, Minnesota",105,73,12,8,3,1,4,4,105,96,68,12,8,3,1,0,4,9,5,0,0,0,0,4,0
270530096002009,67,Powderhorn Park,55,55,1000000US270530096002009,"Block 2009, Block Group 2, Census Tract 96, Hennepin County, Minnesota",74,63,6,0,1,0,0,4,74,74,63,6,0,1,0,0,4,0,0,0,0,0,0,0,0
270531097003006,67,Powderhorn Park,55,55,1000000US270531097003006,"Block 3006, Block Group 3, Census Tract 1097, Hennepin County, Minnesota",74,62,8,0,0,0,0,4,74,63,51,8,0,0,0,0,4,11,11,0,0,0,0,0,0
270530096002010,67,Powderhorn Park,55,55,1000000US270530096002010,"Block 2010, Block Group 2, Census Tract 96, Hennepin County, Minnesota",63,46,8,6,0,0,0,3,63,54,43,8,0,0,0,0,3,9,3,0,6,0,0,0,0
270530085001003,67,Powderhorn Park,55,55,1000000US270530085001003,"Block 1003, Block Group 1, Census Tract 85, Hennepin County, Minnesota",175,96,16,16,0,0,35,12,175,100,57,16,16,0,0,5,6,75,39,0,0,0,0,30,6
270531097003004,67,Powderhorn Park,55,55,1000000US270531097003004,"Block 3004, Block Group 3, Census Tract 1097, Hennepin County, Minnesota",91,71,3,0,3,0,5,9,91,69,58,3,0,3,0,0,5,22,13,0,0,0,0,5,4
270531097003005,67,Powderhorn Park,55,55,1000000US270531097003005,"Block 3005, Block Group 3, Census Tract 1097, Hennepin County, Minnesota",98,75,10,3,2,0,0,8,98,94,71,10,3,2,0,0,8,4,4,0,0,0,0,0,0
270530096002008,67,Powderhorn Park,55,55,1000000US270530096002008,"Block 2008, Block Group 2, Census Tract 96, Hennepin County, Minnesota",100,63,25,2,5,0,1,4,100,99,62,25,2,5,0,1,4,1,1,0,0,0,0,0,0
270530085004003,67,Powderhorn Park,55,55,1000000US270530085004003,"Block 4003, Block Group 4, Census Tract 85, Hennepin County, Minnesota",126,88,13,11,0,0,11,3,126,117,88,13,11,0,0,2,3,9,0,0,0,0,0,9,0
270530096002003,67,Powderhorn Park,55,55,1000000US270530096002003,"Block 2003, Block Group 2, Census Tract 96, Hennepin County, Minnesota",137,47,70,4,0,0,10,6,137,113,33,70,4,0,0,0,6,24,14,0,0,0,0,10,0
270530096002007,67,Powderhorn Park,55,55,1000000US270530096002007,"Block 2007, Block Group 2, Census Tract 96, Hennepin County, Minnesota",63,47,7,0,0,0,3,6,63,56,43,7,0,0,0,0,6,7,4,0,0,0,0,3,0
270531097002005,67,Powderhorn Park,55,55,1000000US270531097002005,"Block 2005, Block Group 2, Census Tract 1097, Hennepin County, Minnesota",74,48,4,1,1,0,20,0,74,40,34,4,1,1,0,0,0,34,14,0,0,0,0,20,0
270531097002003,67,Powderhorn Park,55,55,1000000US270531097002003,"Block 2003, Block Group 2, Census Tract 1097, Hennepin County, Minnesota",90,71,8,3,0,0,4,4,90,86,69,7,3,0,0,4,3,4,2,1,0,0,0,0,1
270531097002004,67,Powderhorn Park,55,55,1000000US270531097002004,"Block 2004, Block Group 2, Census Tract 1097, Hennepin County, Minnesota",78,54,2,0,1,0,12,9,78,63,51,2,0,1,0,0,9,15,3,0,0,0,0,12,0
270530085001000,67,Powderhorn Park,55,55,1000000US270530085001000,"Block 1000, Block Group 1, Census Tract 85, Hennepin County, Minnesota",142,72,18,2,2,0,30,18,142,74,50,18,1,2,0,0,3,68,22,0,1,0,0,30,15
270531086003000,67,Powderhorn Park,55,55,1000000US270531086003000,"Block 3000, Block Group 3, Census Tract 1086, Hennepin County, Minnesota",158,42,14,13,2,0,86,1,158,52,22,14,13,2,0,0,1,106,20,0,0,0,0,86,0
270530085002000,67,Powderhorn Park,55,55,1000000US270530085002000,"Block 2000, Block Group 2, Census Tract 85, Hennepin County, Minnesota",104,89,6,0,2,0,0,7,104,104,89,6,0,2,0,0,7,0,0,0,0,0,0,0,0
270531086003004,67,Powderhorn Park,55,55,1000000US270531086003004,"Block 3004, Block Group 3, Census Tract 1086, Hennepin County, Minnesota",98,54,21,0,0,0,20,3,98,68,44,21,0,0,0,0,3,30,10,0,0,0,0,20,0
270530085004000,67,Powderhorn Park,55,55,1000000US270530085004000,"Block 4000, Block Group 4, Census Tract 85, Hennepin County, Minnesota",236,85,26,7,11,0,100,7,236,100,60,26,3,11,0,0,0,136,25,0,4,0,0,100,7
270530096001004,67,Powderhorn Park,55,55,1000000US270530096001004,"Block 1004, Block Group 1, Census Tract 96, Hennepin County, Minnesota",131,52,21,2,0,0,51,5,131,68,41,21,2,0,0,0,4,63,11,0,0,0,0,51,1
270530085004001,67,Powderhorn Park,55,55,1000000US270530085004001,"Block 4001, Block Group 4, Census Tract 85, Hennepin County, Minnesota",127,75,21,3,8,0,8,12,127,81,44,21,3,8,0,0,5,46,31,0,0,0,0,8,7
270530085003003,67,Powderhorn Park,55,55,1000000US270530085003003,"Block 3003, Block Group 3, Census Tract 85, Hennepin County, Minnesota",45,43,1,1,0,0,0,0,45,45,43,1,1,0,0,0,0,0,0,0,0,0,0,0,0
270530085004006,67,Powderhorn Park,55,55,1000000US270530085004006,"Block 4006, Block Group 4, Census Tract 85, Hennepin County, Minnesota",167,70,13,2,0,0,74,8,167,83,61,13,0,0,0,3,6,84,9,0,2,0,0,71,2
270530085004002,67,Powderhorn Park,55,55,1000000US270530085004002,"Block 4002, Block Group 4, Census Tract 85, Hennepin County, Minnesota",105,46,24,1,5,0,16,13,105,88,45,24,1,5,0,0,13,17,1,0,0,0,0,16,0
270530085004005,67,Powderhorn Park,55,55,1000000US270530085004005,"Block 4005, Block Group 4, Census Tract 85, Hennepin County, Minnesota",59,38,4,2,1,0,8,6,59,52,38,4,2,1,0,1,6,7,0,0,0,0,0,7,0
270530085004007,67,Powderhorn Park,55,55,1000000US270530085004007,"Block 4007, Block Group 4, Census Tract 85, Hennepin County, Minnesota",96,31,45,2,0,0,8,10,96,81,24,45,2,0,0,0,10,15,7,0,0,0,0,8,0
270530096002006,67,Powderhorn Park,55,55,1000000US270530096002006,"Block 2006, Block Group 2, Census Tract 96, Hennepin County, Minnesota",114,47,26,6,10,0,14,11,114,93,40,26,6,10,0,0,11,21,7,0,0,0,0,14,0
270530096002004,67,Powderhorn Park,55,55,1000000US270530096002004,"Block 2004, Block Group 2, Census Tract 96, Hennepin County, Minnesota",95,41,26,1,0,0,20,7,95,61,35,23,1,0,0,0,2,34,6,3,0,0,0,20,5
270530085005002,67,Powderhorn Park,55,55,1000000US270530085005002,"Block 5002, Block Group 5, Census Tract 85, Hennepin County, Minnesota",101,25,18,4,3,0,45,6,101,42,13,18,4,3,0,0,4,59,12,0,0,0,0,45,2
270531097003003,67,Powderhorn Park,55,55,1000000US270531097003003,"Block 3003, Block Group 3, Census Tract 1097, Hennepin County, Minnesota",127,64,45,9,3,0,0,6,127,116,60,44,4,3,0,0,5,11,4,1,5,0,0,0,1
270530085005000,67,Powderhorn Park,55,55,1000000US270530085005000,"Block 5000, Block Group 5, Census Tract 85, Hennepin County, Minnesota",121,41,16,9,15,0,26,14,121,79,36,16,7,15,0,0,5,42,5,0,2,0,0,26,9
270531086003008,67,Powderhorn Park,55,55,1000000US270531086003008,"Block 3008, Block Group 3, Census Tract 1086, Hennepin County, Minnesota",73,44,14,0,0,0,7,8,73,57,42,11,0,0,0,0,4,16,2,3,0,0,0,7,4
270531097002002,67,Powderhorn Park,55,55,1000000US270531097002002,"Block 2002, Block Group 2, Census Tract 1097, Hennepin County, Minnesota",72,66,1,0,5,0,0,0,72,72,66,1,0,5,0,0,0,0,0,0,0,0,0,0,0
270531097002008,67,Powderhorn Park,55,55,1000000US270531097002008,"Block 2008, Block Group 2, Census Tract 1097, Hennepin County, Minnesota",103,63,15,10,4,0,3,8,103,92,62,15,10,4,0,0,1,11,1,0,0,0,0,3,7
270531097002000,67,Powderhorn Park,55,55,1000000US270531097002000,"Block 2000, Block Group 2, Census Tract 1097, Hennepin County, Minnesota",72,37,23,1,4,0,7,0,72,56,29,23,0,4,0,0,0,16,8,0,1,0,0,7,0
270530085005008,67,Powderhorn Park,55,55,1000000US270530085005008,"Block 5008, Block Group 5, Census Tract 85, Hennepin County, Minnesota",67,38,26,3,0,0,0,0,67,64,38,26,0,0,0,0,0,3,0,0,3,0,0,0,0
270530096001005,67,Powderhorn Park,55,55,1000000US270530096001005,"Block 1005, Block Group 1, Census Tract 96, Hennepin County, Minnesota",29,19,0,0,0,0,4,6,29,19,19,0,0,0,0,0,0,10,0,0,0,0,0,4,6
270530085005003,67,Powderhorn Park,55,55,1000000US270530085005003,"Block 5003, Block Group 5, Census Tract 85, Hennepin County, Minnesota",161,78,25,3,7,0,46,2,161,63,26,25,3,7,0,0,2,98,52,0,0,0,0,46,0
270530085005001,67,Powderhorn Park,55,55,1000000US270530085005001,"Block 5001, Block Group 5, Census Tract 85, Hennepin County, Minnesota",43,9,9,0,4,0,21,0,43,17,4,9,0,4,0,0,0,26,5,0,0,0,0,21,0
270530085001004,67,Powderhorn Park,55,55,1000000US270530085001004,"Block 1004, Block Group 1, Census Tract 85, Hennepin County, Minnesota",135,41,42,6,12,0,24,10,135,100,35,41,6,12,0,0,6,35,6,1,0,0,0,24,4
270530085002001,67,Powderhorn Park,55,55,1000000US270530085002001,"Block 2001, Block Group 2, Census Tract 85, Hennepin County, Minnesota",113,54,6,3,1,0,42,7,113,58,40,6,3,1,0,1,7,55,14,0,0,0,0,41,0
270530096002002,67,Powderhorn Park,55,55,1000000US270530096002002,"Block 2002, Block Group 2, Census Tract 96, Hennepin County, Minnesota",88,75,8,1,2,0,2,0,88,84,74,8,0,2,0,0,0,4,1,0,1,0,0,2,0
270530085005007,67,Powderhorn Park,55,55,1000000US270530085005007,"Block 5007, Block Group 5, Census Tract 85, Hennepin County, Minnesota",73,35,9,6,0,0,13,10,73,52,35,8,4,0,0,0,5,21,0,1,2,0,0,13,5
270531086002001,68,Corcoran,56,56,1000000US270531086002001,"Block 2001, Block Group 2, Census Tract 1086, Hennepin County, Minnesota",60,10,10,10,0,0,18,12,60,35,10,10,10,0,0,0,5,25,0,0,0,0,0,18,7
270531086002010,68,Corcoran,56,56,1000000US270531086002010,"Block 2010, Block Group 2, Census Tract 1086, Hennepin County, Minnesota",106,37,23,3,0,0,38,5,106,60,36,18,3,0,0,0,3,46,1,5,0,0,0,38,2
270531086002013,68,Corcoran,56,56,1000000US270531086002013,"Block 2013, Block Group 2, Census Tract 1086, Hennepin County, Minnesota",83,36,19,2,0,0,22,4,83,56,32,19,2,0,0,3,0,27,4,0,0,0,0,19,4
270531086001003,68,Corcoran,56,56,1000000US270531086001003,"Block 1003, Block Group 1, Census Tract 1086, Hennepin County, Minnesota",80,45,21,11,0,0,0,3,80,75,42,21,9,0,0,0,3,5,3,0,2,0,0,0,0
270531086002015,68,Corcoran,56,56,1000000US270531086002015,"Block 2015, Block Group 2, Census Tract 1086, Hennepin County, Minnesota",48,36,0,5,0,0,5,2,48,43,36,0,5,0,0,0,2,5,0,0,0,0,0,5,0
270531087001002,68,Corcoran,56,56,1000000US270531087001002,"Block 1002, Block Group 1, Census Tract 1087, Hennepin County, Minnesota",61,28,18,6,0,0,5,4,61,51,25,17,5,0,0,0,4,10,3,1,1,0,0,5,0
270531087002001,68,Corcoran,56,56,1000000US270531087002001,"Block 2001, Block Group 2, Census Tract 1087, Hennepin County, Minnesota",84,47,17,5,2,0,10,3,84,64,42,13,4,2,0,0,3,20,5,4,1,0,0,10,0
270531087002011,68,Corcoran,56,56,1000000US270531087002011,"Block 2011, Block Group 2, Census Tract 1087, Hennepin County, Minnesota",76,42,14,6,3,0,11,0,76,63,41,13,6,3,0,0,0,13,1,1,0,0,0,11,0
270531087002010,68,Corcoran,56,56,1000000US270531087002010,"Block 2010, Block Group 2, Census Tract 1087, Hennepin County, Minnesota",55,42,6,0,0,0,4,3,55,50,42,5,0,0,0,0,3,5,0,1,0,0,0,4,0
270531086002000,68,Corcoran,56,56,1000000US270531086002000,"Block 2000, Block Group 2, Census Tract 1086, Hennepin County, Minnesota",26,0,1,3,0,0,11,11,26,8,0,1,3,0,0,0,4,18,0,0,0,0,0,11,7
270531086002008,68,Corcoran,56,56,1000000US270531086002008,"Block 2008, Block Group 2, Census Tract 1086, Hennepin County, Minnesota",70,53,5,0,3,0,1,8,70,61,46,5,0,3,0,0,7,9,7,0,0,0,0,1,1
270531086001007,68,Corcoran,56,56,1000000US270531086001007,"Block 1007, Block Group 1, Census Tract 1086, Hennepin County, Minnesota",77,47,5,0,0,0,23,2,77,49,42,4,0,0,0,1,2,28,5,1,0,0,0,22,0
270531087001000,68,Corcoran,56,56,1000000US270531087001000,"Block 1000, Block Group 1, Census Tract 1087, Hennepin County, Minnesota",0,0,0,0,0,0,0,0,0,0,0,0,0,0,0,0,0,0,0,0,0,0,0,0,0
270531087001005,68,Corcoran,56,56,1000000US270531087001005,"Block 1005, Block Group 1, Census Tract 1087, Hennepin County, Minnesota",100,68,14,13,0,0,0,5,100,97,66,14,12,0,0,0,5,3,2,0,1,0,0,0,0
270531087001016,68,Corcoran,56,56,1000000US270531087001016,"Block 1016, Block Group 1, Census Tract 1087, Hennepin County, Minnesota",38,23,7,1,0,0,6,1,38,32,23,7,1,0,0,0,1,6,0,0,0,0,0,6,0
270531087002009,68,Corcoran,56,56,1000000US270531087002009,"Block 2009, Block Group 2, Census Tract 1087, Hennepin County, Minnesota",54,46,4,4,0,0,0,0,54,51,45,4,2,0,0,0,0,3,1,0,2,0,0,0,0
270531087002014,68,Corcoran,56,56,1000000US270531087002014,"Block 2014, Block Group 2, Census Tract 1087, Hennepin County, Minnesota",0,0,0,0,0,0,0,0,0,0,0,0,0,0,0,0,0,0,0,0,0,0,0,0,0
270531087001001,68,Corcoran,56,56,1000000US270531087001001,"Block 1001, Block Group 1, Census Tract 1087, Hennepin County, Minnesota",0,0,0,0,0,0,0,0,0,0,0,0,0,0,0,0,0,0,0,0,0,0,0,0,0
270531086002004,68,Corcoran,56,56,1000000US270531086002004,"Block 2004, Block Group 2, Census Tract 1086, Hennepin County, Minnesota",198,55,14,8,7,0,100,14,198,78,38,14,8,7,0,3,8,120,17,0,0,0,0,97,6
270531086002002,68,Corcoran,56,56,1000000US270531086002002,"Block 2002, Block Group 2, Census Tract 1086, Hennepin County, Minnesota",101,39,3,17,0,0,35,7,101,43,22,3,14,0,0,0,4,58,17,0,3,0,0,35,3
270531087001003,68,Corcoran,56,56,1000000US270531087001003,"Block 1003, Block Group 1, Census Tract 1087, Hennepin County, Minnesota",0,0,0,0,0,0,0,0,0,0,0,0,0,0,0,0,0,0,0,0,0,0,0,0,0
270531087001007,68,Corcoran,56,56,1000000US270531087001007,"Block 1007, Block Group 1, Census Tract 1087, Hennepin County, Minnesota",2,2,0,0,0,0,0,0,2,2,2,0,0,0,0,0,0,0,0,0,0,0,0,0,0
270531087001008,68,Corcoran,56,56,1000000US270531087001008,"Block 1008, Block Group 1, Census Tract 1087, Hennepin County, Minnesota",183,75,18,6,6,0,73,5,183,92,61,17,5,6,0,0,3,91,14,1,1,0,0,73,2
270531086002009,68,Corcoran,56,56,1000000US270531086002009,"Block 2009, Block Group 2, Census Tract 1086, Hennepin County, Minnesota",87,44,9,0,12,0,8,14,87,56,38,6,0,12,0,0,0,31,6,3,0,0,0,8,14
270531087001010,68,Corcoran,56,56,1000000US270531087001010,"Block 1010, Block Group 1, Census Tract 1087, Hennepin County, Minnesota",66,46,11,4,1,0,0,4,66,66,46,11,4,1,0,0,4,0,0,0,0,0,0,0,0
270531087002005,68,Corcoran,56,56,1000000US270531087002005,"Block 2005, Block Group 2, Census Tract 1087, Hennepin County, Minnesota",84,66,7,0,5,0,0,6,84,82,64,7,0,5,0,0,6,2,2,0,0,0,0,0,0
270531087002012,68,Corcoran,56,56,1000000US270531087002012,"Block 2012, Block Group 2, Census Tract 1087, Hennepin County, Minnesota",65,21,31,1,1,0,10,1,65,63,21,31,1,1,0,8,1,2,0,0,0,0,0,2,0
270531087001013,68,Corcoran,56,56,1000000US270531087001013,"Block 1013, Block Group 1, Census Tract 1087, Hennepin County, Minnesota",41,31,0,2,0,0,4,4,41,33,30,0,1,0,0,0,2,8,1,0,1,0,0,4,2
270531086002005,68,Corcoran,56,56,1000000US270531086002005,"Block 2005, Block Group 2, Census Tract 1086, Hennepin County, Minnesota",145,69,5,7,8,0,41,15,145,62,43,5,1,7,0,3,3,83,26,0,6,1,0,38,12
270531086002012,68,Corcoran,56,56,1000000US270531086002012,"Block 2012, Block Group 2, Census Tract 1086, Hennepin County, Minnesota",150,36,31,5,8,0,67,3,150,73,24,31,5,8,0,2,3,77,12,0,0,0,0,65,0
270531087001011,68,Corcoran,56,56,1000000US270531087001011,"Block 1011, Block Group 1, Census Tract 1087, Hennepin County, Minnesota",77,43,8,0,1,0,19,6,77,52,42,8,0,1,0,0,1,25,1,0,0,0,0,19,5
270531087002004,68,Corcoran,56,56,1000000US270531087002004,"Block 2004, Block Group 2, Census Tract 1087, Hennepin County, Minnesota",66,56,1,3,3,0,0,3,66,60,50,1,3,3,0,0,3,6,6,0,0,0,0,0,0
270531087001014,68,Corcoran,56,56,1000000US270531087001014,"Block 1014, Block Group 1, Census Tract 1087, Hennepin County, Minnesota",163,116,18,1,16,0,0,12,163,154,110,18,1,16,0,0,9,9,6,0,0,0,0,0,3
270531086001001,68,Corcoran,56,56,1000000US270531086001001,"Block 1001, Block Group 1, Census Tract 1086, Hennepin County, Minnesota",73,44,4,7,0,0,18,0,73,56,44,4,7,0,0,1,0,17,0,0,0,0,0,17,0
270531087002006,68,Corcoran,56,56,1000000US270531087002006,"Block 2006, Block Group 2, Census Tract 1087, Hennepin County, Minnesota",53,47,3,0,0,0,3,0,53,50,47,3,0,0,0,0,0,3,0,0,0,0,0,3,0
270531087001004,68,Corcoran,56,56,1000000US270531087001004,"Block 1004, Block Group 1, Census Tract 1087, Hennepin County, Minnesota",41,19,10,1,0,0,0,11,41,39,18,10,1,0,0,0,10,2,1,0,0,0,0,0,1
270531087001009,68,Corcoran,56,56,1000000US270531087001009,"Block 1009, Block Group 1, Census Tract 1087, Hennepin County, Minnesota",98,75,7,4,1,0,9,2,98,65,51,7,4,1,0,0,2,33,24,0,0,0,0,9,0
270531087001006,68,Corcoran,56,56,1000000US270531087001006,"Block 1006, Block Group 1, Census Tract 1087, Hennepin County, Minnesota",199,66,18,18,3,0,86,8,199,84,38,18,18,3,0,0,7,115,28,0,0,0,0,86,1
270531086001006,68,Corcoran,56,56,1000000US270531086001006,"Block 1006, Block Group 1, Census Tract 1086, Hennepin County, Minnesota",73,51,10,8,2,0,0,2,73,64,50,10,0,2,0,0,2,9,1,0,8,0,0,0,0
270531087002002,68,Corcoran,56,56,1000000US270531087002002,"Block 2002, Block Group 2, Census Tract 1087, Hennepin County, Minnesota",65,56,2,3,3,0,0,1,65,58,49,2,3,3,0,0,1,7,7,0,0,0,0,0,0
270531086002003,68,Corcoran,56,56,1000000US270531086002003,"Block 2003, Block Group 2, Census Tract 1086, Hennepin County, Minnesota",71,28,17,2,0,0,24,0,71,46,28,17,1,0,0,0,0,25,0,0,1,0,0,24,0
270531087002013,68,Corcoran,56,56,1000000US270531087002013,"Block 2013, Block Group 2, Census Tract 1087, Hennepin County, Minnesota",0,0,0,0,0,0,0,0,0,0,0,0,0,0,0,0,0,0,0,0,0,0,0,0,0
270531086002006,68,Corcoran,56,56,1000000US270531086002006,"Block 2006, Block Group 2, Census Tract 1086, Hennepin County, Minnesota",0,0,0,0,0,0,0,0,0,0,0,0,0,0,0,0,0,0,0,0,0,0,0,0,0
270531086001004,68,Corcoran,56,56,1000000US270531086001004,"Block 1004, Block Group 1, Census Tract 1086, Hennepin County, Minnesota",92,56,12,1,2,0,13,8,92,56,34,12,1,2,0,2,5,36,22,0,0,0,0,11,3
270531086001002,68,Corcoran,56,56,1000000US270531086001002,"Block 1002, Block Group 1, Census Tract 1086, Hennepin County, Minnesota",91,71,7,0,3,0,7,3,91,72,61,7,0,3,0,0,1,19,10,0,0,0,0,7,2
270531086002014,68,Corcoran,56,56,1000000US270531086002014,"Block 2014, Block Group 2, Census Tract 1086, Hennepin County, Minnesota",0,0,0,0,0,0,0,0,0,0,0,0,0,0,0,0,0,0,0,0,0,0,0,0,0
270531086001000,68,Corcoran,56,56,1000000US270531086001000,"Block 1000, Block Group 1, Census Tract 1086, Hennepin County, Minnesota",61,43,1,8,1,0,6,2,61,53,43,1,8,1,0,0,0,8,0,0,0,0,0,6,2
270531087001012,68,Corcoran,56,56,1000000US270531087001012,"Block 1012, Block Group 1, Census Tract 1087, Hennepin County, Minnesota",71,42,16,4,0,0,1,8,71,66,42,16,3,0,0,0,5,5,0,0,1,0,0,1,3
270531087002003,68,Corcoran,56,56,1000000US270531087002003,"Block 2003, Block Group 2, Census Tract 1087, Hennepin County, Minnesota",97,62,11,1,4,2,6,11,97,85,58,11,0,4,2,0,10,12,4,0,1,0,0,6,1
270531087002008,68,Corcoran,56,56,1000000US270531087002008,"Block 2008, Block Group 2, Census Tract 1087, Hennepin County, Minnesota",65,52,7,2,1,0,0,3,65,60,48,6,2,1,0,0,3,5,4,1,0,0,0,0,0
270531087002000,68,Corcoran,56,56,1000000US270531087002000,"Block 2000, Block Group 2, Census Tract 1087, Hennepin County, Minnesota",67,10,36,1,6,0,8,6,67,54,10,33,1,6,0,0,4,13,0,3,0,0,0,8,2
270531086002007,68,Corcoran,56,56,1000000US270531086002007,"Block 2007, Block Group 2, Census Tract 1086, Hennepin County, Minnesota",0,0,0,0,0,0,0,0,0,0,0,0,0,0,0,0,0,0,0,0,0,0,0,0,0
270531086002011,68,Corcoran,56,56,1000000US270531086002011,"Block 2011, Block Group 2, Census Tract 1086, Hennepin County, Minnesota",101,42,15,0,0,0,35,9,101,48,32,15,0,0,0,0,1,53,10,0,0,0,0,35,8
270531086001005,68,Corcoran,56,56,1000000US270531086001005,"Block 1005, Block Group 1, Census Tract 1086, Hennepin County, Minnesota",77,47,17,0,2,0,6,5,77,67,44,15,0,2,0,1,5,10,3,2,0,0,0,5,0
270531087002007,68,Corcoran,56,56,1000000US270531087002007,"Block 2007, Block Group 2, Census Tract 1087, Hennepin County, Minnesota",101,70,16,9,4,0,0,2,101,99,70,15,8,4,0,0,2,2,0,1,1,0,0,0,0
270531087001015,68,Corcoran,56,56,1000000US270531087001015,"Block 1015, Block Group 1, Census Tract 1087, Hennepin County, Minnesota",0,0,0,0,0,0,0,0,0,0,0,0,0,0,0,0,0,0,0,0,0,0,0,0,0
270531100002003,69,Bryant,57,57,1000000US270531100002003,"Block 2003, Block Group 2, Census Tract 1100, Hennepin County, Minnesota",125,18,45,0,0,0,49,13,125,64,14,45,0,0,0,0,5,61,4,0,0,0,0,49,8
270531100002010,69,Bryant,57,57,1000000US270531100002010,"Block 2010, Block Group 2, Census Tract 1100, Hennepin County, Minnesota",41,19,13,0,6,0,0,3,41,39,17,13,0,6,0,0,3,2,2,0,0,0,0,0,0
270530095003006,69,Bryant,57,57,1000000US270530095003006,"Block 3006, Block Group 3, Census Tract 95, Hennepin County, Minnesota",0,0,0,0,0,0,0,0,0,0,0,0,0,0,0,0,0,0,0,0,0,0,0,0,0
270531100001006,69,Bryant,57,57,1000000US270531100001006,"Block 1006, Block Group 1, Census Tract 1100, Hennepin County, Minnesota",63,15,27,0,2,0,18,1,63,42,12,27,0,2,0,0,1,21,3,0,0,0,0,18,0
270531100001007,69,Bryant,57,57,1000000US270531100001007,"Block 1007, Block Group 1, Census Tract 1100, Hennepin County, Minnesota",68,26,30,0,0,0,11,1,68,47,16,30,0,0,0,0,1,21,10,0,0,0,0,11,0
270530095003007,69,Bryant,57,57,1000000US270530095003007,"Block 3007, Block Group 3, Census Tract 95, Hennepin County, Minnesota",68,37,22,0,8,0,0,1,68,66,35,22,0,8,0,0,1,2,2,0,0,0,0,0,0
270531100002009,69,Bryant,57,57,1000000US270531100002009,"Block 2009, Block Group 2, Census Tract 1100, Hennepin County, Minnesota",61,27,22,0,0,0,10,2,61,35,16,19,0,0,0,0,0,26,11,3,0,0,0,10,2
270530095003014,69,Bryant,57,57,1000000US270530095003014,"Block 3014, Block Group 3, Census Tract 95, Hennepin County, Minnesota",79,51,21,0,4,0,0,3,79,65,37,21,0,4,0,0,3,14,14,0,0,0,0,0,0
270530095003002,69,Bryant,57,57,1000000US270530095003002,"Block 3002, Block Group 3, Census Tract 95, Hennepin County, Minnesota",76,33,24,0,0,0,15,4,76,56,28,24,0,0,0,1,3,20,5,0,0,0,0,14,1
270531100001003,69,Bryant,57,57,1000000US270531100001003,"Block 1003, Block Group 1, Census Tract 1100, Hennepin County, Minnesota",101,20,26,0,5,0,49,1,101,52,20,26,0,5,0,0,1,49,0,0,0,0,0,49,0
270530095003012,69,Bryant,57,57,1000000US270530095003012,"Block 3012, Block Group 3, Census Tract 95, Hennepin County, Minnesota",82,58,17,0,2,0,2,3,82,76,56,17,0,2,0,0,1,6,2,0,0,0,0,2,2
270531100001004,69,Bryant,57,57,1000000US270531100001004,"Block 1004, Block Group 1, Census Tract 1100, Hennepin County, Minnesota",122,22,81,1,0,0,16,2,122,94,12,81,1,0,0,0,0,28,10,0,0,0,0,16,2
270531100001001,69,Bryant,57,57,1000000US270531100001001,"Block 1001, Block Group 1, Census Tract 1100, Hennepin County, Minnesota",89,24,37,0,2,0,26,0,89,59,20,37,0,2,0,0,0,30,4,0,0,0,0,26,0
270531100002001,69,Bryant,57,57,1000000US270531100002001,"Block 2001, Block Group 2, Census Tract 1100, Hennepin County, Minnesota",110,19,54,3,6,0,15,13,110,86,18,54,3,6,0,0,5,24,1,0,0,0,0,15,8
270531100002007,69,Bryant,57,57,1000000US270531100002007,"Block 2007, Block Group 2, Census Tract 1100, Hennepin County, Minnesota",28,13,11,3,0,0,0,1,28,28,13,11,3,0,0,0,1,0,0,0,0,0,0,0,0
270531100001000,69,Bryant,57,57,1000000US270531100001000,"Block 1000, Block Group 1, Census Tract 1100, Hennepin County, Minnesota",115,17,26,3,0,0,47,22,115,56,15,26,2,0,0,0,13,59,2,0,1,0,0,47,9
270531100002004,69,Bryant,57,57,1000000US270531100002004,"Block 2004, Block Group 2, Census Tract 1100, Hennepin County, Minnesota",76,25,29,0,7,0,15,0,76,44,8,28,0,7,0,1,0,32,17,1,0,0,0,14,0
270531100001009,69,Bryant,57,57,1000000US270531100001009,"Block 1009, Block Group 1, Census Tract 1100, Hennepin County, Minnesota",120,28,36,0,1,0,51,4,120,64,26,36,0,0,0,0,2,56,2,0,0,1,0,51,2
270530095003004,69,Bryant,57,57,1000000US270530095003004,"Block 3004, Block Group 3, Census Tract 95, Hennepin County, Minnesota",95,47,32,1,10,0,2,3,95,66,21,32,1,10,0,0,2,29,26,0,0,0,0,2,1
270530095003001,69,Bryant,57,57,1000000US270530095003001,"Block 3001, Block Group 3, Census Tract 95, Hennepin County, Minnesota",79,46,30,2,1,0,0,0,79,68,35,30,2,1,0,0,0,11,11,0,0,0,0,0,0
270530095003013,69,Bryant,57,57,1000000US270530095003013,"Block 3013, Block Group 3, Census Tract 95, Hennepin County, Minnesota",92,55,29,2,1,0,0,5,92,80,45,29,1,1,0,0,4,12,10,0,1,0,0,0,1
270530095003010,69,Bryant,57,57,1000000US270530095003010,"Block 3010, Block Group 3, Census Tract 95, Hennepin County, Minnesota",75,48,4,0,6,0,6,11,75,69,48,4,0,6,0,1,10,6,0,0,0,0,0,5,1
270531100001002,69,Bryant,57,57,1000000US270531100001002,"Block 1002, Block Group 1, Census Tract 1100, Hennepin County, Minnesota",76,14,24,4,5,0,25,4,76,40,4,24,4,5,0,0,3,36,10,0,0,0,0,25,1
270531100001008,69,Bryant,57,57,1000000US270531100001008,"Block 1008, Block Group 1, Census Tract 1100, Hennepin County, Minnesota",99,26,28,1,1,0,36,7,99,56,21,28,0,1,0,0,6,43,5,0,1,0,0,36,1
270531100002008,69,Bryant,57,57,1000000US270531100002008,"Block 2008, Block Group 2, Census Tract 1100, Hennepin County, Minnesota",33,8,18,7,0,0,0,0,33,31,6,18,7,0,0,0,0,2,2,0,0,0,0,0,0
270530095003009,69,Bryant,57,57,1000000US270530095003009,"Block 3009, Block Group 3, Census Tract 95, Hennepin County, Minnesota",73,62,6,0,0,0,0,5,73,59,53,6,0,0,0,0,0,14,9,0,0,0,0,0,5
270531100002002,69,Bryant,57,57,1000000US270531100002002,"Block 2002, Block Group 2, Census Tract 1100, Hennepin County, Minnesota",85,25,30,1,11,0,15,3,85,64,19,30,1,11,0,2,1,21,6,0,0,0,0,13,2
270531100002005,69,Bryant,57,57,1000000US270531100002005,"Block 2005, Block Group 2, Census Tract 1100, Hennepin County, Minnesota",43,8,26,0,0,0,7,2,43,28,2,26,0,0,0,0,0,15,6,0,0,0,0,7,2
270530095003005,69,Bryant,57,57,1000000US270530095003005,"Block 3005, Block Group 3, Census Tract 95, Hennepin County, Minnesota",83,45,25,9,0,0,0,4,83,76,38,25,9,0,0,0,4,7,7,0,0,0,0,0,0
270530095003008,69,Bryant,57,57,1000000US270530095003008,"Block 3008, Block Group 3, Census Tract 95, Hennepin County, Minnesota",68,43,22,0,0,0,0,3,68,68,43,22,0,0,0,0,3,0,0,0,0,0,0,0,0
270530095003003,69,Bryant,57,57,1000000US270530095003003,"Block 3003, Block Group 3, Census Tract 95, Hennepin County, Minnesota",82,47,30,0,1,1,0,3,82,64,30,29,0,1,1,0,3,18,17,1,0,0,0,0,0
270530095003000,69,Bryant,57,57,1000000US270530095003000,"Block 3000, Block Group 3, Census Tract 95, Hennepin County, Minnesota",112,64,17,1,2,0,27,1,112,48,27,17,1,2,0,0,1,64,37,0,0,0,0,27,0
270531100002000,69,Bryant,57,57,1000000US270531100002000,"Block 2000, Block Group 2, Census Tract 1100, Hennepin County, Minnesota",0,0,0,0,0,0,0,0,0,0,0,0,0,0,0,0,0,0,0,0,0,0,0,0,0
270531100002006,69,Bryant,57,57,1000000US270531100002006,"Block 2006, Block Group 2, Census Tract 1100, Hennepin County, Minnesota",32,16,6,0,3,0,0,7,32,32,16,6,0,3,0,0,7,0,0,0,0,0,0,0,0
270531100001005,69,Bryant,57,57,1000000US270531100001005,"Block 1005, Block Group 1, Census Tract 1100, Hennepin County, Minnesota",119,43,54,4,0,0,14,4,119,63,9,49,2,0,0,0,3,56,34,5,2,0,0,14,1
270531100002011,69,Bryant,57,57,1000000US270531100002011,"Block 2011, Block Group 2, Census Tract 1100, Hennepin County, Minnesota",67,37,18,5,0,0,5,2,67,50,29,18,1,0,0,0,2,17,8,0,4,0,0,5,0
270530095003011,69,Bryant,57,57,1000000US270530095003011,"Block 3011, Block Group 3, Census Tract 95, Hennepin County, Minnesota",96,45,39,0,10,0,0,2,96,93,44,37,0,10,0,0,2,3,1,2,0,0,0,0,0
270530120012018,70,Kenny,67,67,1000000US270530120012018,"Block 2018, Block Group 2, Census Tract 120.01, Hennepin County, Minnesota",24,9,8,0,0,0,0,7,24,24,9,8,0,0,0,0,7,0,0,0,0,0,0,0,0
270531114004012,70,Kenny,67,67,1000000US270531114004012,"Block 4012, Block Group 4, Census Tract 1114, Hennepin County, Minnesota",49,45,0,2,2,0,0,0,49,49,45,0,2,2,0,0,0,0,0,0,0,0,0,0,0
270530120013002,70,Kenny,67,67,1000000US270530120013002,"Block 3002, Block Group 3, Census Tract 120.01, Hennepin County, Minnesota",55,55,0,0,0,0,0,0,55,55,55,0,0,0,0,0,0,0,0,0,0,0,0,0,0
270531114004020,70,Kenny,67,67,1000000US270531114004020,"Block 4020, Block Group 4, Census Tract 1114, Hennepin County, Minnesota",63,56,0,3,0,0,1,3,63,55,53,0,0,0,0,0,2,8,3,0,3,0,0,1,1
270530120013006,70,Kenny,67,67,1000000US270530120013006,"Block 3006, Block Group 3, Census Tract 120.01, Hennepin County, Minnesota",25,23,0,0,2,0,0,0,25,21,19,0,0,2,0,0,0,4,4,0,0,0,0,0,0
270530120012014,70,Kenny,67,67,1000000US270530120012014,"Block 2014, Block Group 2, Census Tract 120.01, Hennepin County, Minnesota",52,50,1,0,1,0,0,0,52,52,50,1,0,1,0,0,0,0,0,0,0,0,0,0,0
270530120012013,70,Kenny,67,67,1000000US270530120012013,"Block 2013, Block Group 2, Census Tract 120.01, Hennepin County, Minnesota",41,41,0,0,0,0,0,0,41,41,41,0,0,0,0,0,0,0,0,0,0,0,0,0,0
270530120012006,70,Kenny,67,67,1000000US270530120012006,"Block 2006, Block Group 2, Census Tract 120.01, Hennepin County, Minnesota",53,53,0,0,0,0,0,0,53,53,53,0,0,0,0,0,0,0,0,0,0,0,0,0,0
270531114004013,70,Kenny,67,67,1000000US270531114004013,"Block 4013, Block Group 4, Census Tract 1114, Hennepin County, Minnesota",53,44,0,1,6,0,2,0,53,50,41,0,1,6,0,2,0,3,3,0,0,0,0,0,0
270531114004015,70,Kenny,67,67,1000000US270531114004015,"Block 4015, Block Group 4, Census Tract 1114, Hennepin County, Minnesota",46,46,0,0,0,0,0,0,46,45,45,0,0,0,0,0,0,1,1,0,0,0,0,0,0
270531114004008,70,Kenny,67,67,1000000US270531114004008,"Block 4008, Block Group 4, Census Tract 1114, Hennepin County, Minnesota",63,51,5,0,7,0,0,0,63,61,49,5,0,7,0,0,0,2,2,0,0,0,0,0,0
270531114004011,70,Kenny,67,67,1000000US270531114004011,"Block 4011, Block Group 4, Census Tract 1114, Hennepin County, Minnesota",50,50,0,0,0,0,0,0,50,47,47,0,0,0,0,0,0,3,3,0,0,0,0,0,0
270531114004007,70,Kenny,67,67,1000000US270531114004007,"Block 4007, Block Group 4, Census Tract 1114, Hennepin County, Minnesota",79,72,3,0,3,0,0,1,79,76,69,3,0,3,0,0,1,3,3,0,0,0,0,0,0
270531114004014,70,Kenny,67,67,1000000US270531114004014,"Block 4014, Block Group 4, Census Tract 1114, Hennepin County, Minnesota",97,86,7,0,3,0,0,1,97,96,85,7,0,3,0,0,1,1,1,0,0,0,0,0,0
270530120011009,70,Kenny,67,67,1000000US270530120011009,"Block 1009, Block Group 1, Census Tract 120.01, Hennepin County, Minnesota",63,55,0,1,1,0,4,2,63,55,53,0,0,1,0,0,1,8,2,0,1,0,0,4,1
270531114004009,70,Kenny,67,67,1000000US270531114004009,"Block 4009, Block Group 4, Census Tract 1114, Hennepin County, Minnesota",55,50,0,0,4,0,0,1,55,55,50,0,0,4,0,0,1,0,0,0,0,0,0,0,0
270530120013000,70,Kenny,67,67,1000000US270530120013000,"Block 3000, Block Group 3, Census Tract 120.01, Hennepin County, Minnesota",60,55,2,0,3,0,0,0,60,60,55,2,0,3,0,0,0,0,0,0,0,0,0,0,0
270530120011008,70,Kenny,67,67,1000000US270530120011008,"Block 1008, Block Group 1, Census Tract 120.01, Hennepin County, Minnesota",66,63,2,0,0,0,0,1,66,64,61,2,0,0,0,0,1,2,2,0,0,0,0,0,0
270530120011004,70,Kenny,67,67,1000000US270530120011004,"Block 1004, Block Group 1, Census Tract 120.01, Hennepin County, Minnesota",68,65,0,0,0,0,0,3,68,64,61,0,0,0,0,0,3,4,4,0,0,0,0,0,0
270530120011000,70,Kenny,67,67,1000000US270530120011000,"Block 1000, Block Group 1, Census Tract 120.01, Hennepin County, Minnesota",51,46,0,1,0,0,3,1,51,46,46,0,0,0,0,0,0,5,0,0,1,0,0,3,1
270531114004006,70,Kenny,67,67,1000000US270531114004006,"Block 4006, Block Group 4, Census Tract 1114, Hennepin County, Minnesota",47,42,0,1,1,0,0,3,47,46,41,0,1,1,0,0,3,1,1,0,0,0,0,0,0
270530120011007,70,Kenny,67,67,1000000US270530120011007,"Block 1007, Block Group 1, Census Tract 120.01, Hennepin County, Minnesota",46,36,5,0,1,0,1,3,46,42,35,5,0,1,0,0,1,4,1,0,0,0,0,1,2
270531114004003,70,Kenny,67,67,1000000US270531114004003,"Block 4003, Block Group 4, Census Tract 1114, Hennepin County, Minnesota",64,64,0,0,0,0,0,0,64,64,64,0,0,0,0,0,0,0,0,0,0,0,0,0,0
270531114004002,70,Kenny,67,67,1000000US270531114004002,"Block 4002, Block Group 4, Census Tract 1114, Hennepin County, Minnesota",71,64,3,1,3,0,0,0,71,70,63,3,1,3,0,0,0,1,1,0,0,0,0,0,0
270530120011002,70,Kenny,67,67,1000000US270530120011002,"Block 1002, Block Group 1, Census Tract 120.01, Hennepin County, Minnesota",9,9,0,0,0,0,0,0,9,6,6,0,0,0,0,0,0,3,3,0,0,0,0,0,0
270531114004005,70,Kenny,67,67,1000000US270531114004005,"Block 4005, Block Group 4, Census Tract 1114, Hennepin County, Minnesota",51,45,0,0,2,0,0,4,51,51,45,0,0,2,0,0,4,0,0,0,0,0,0,0,0
270531114004017,70,Kenny,67,67,1000000US270531114004017,"Block 4017, Block Group 4, Census Tract 1114, Hennepin County, Minnesota",60,58,0,0,1,0,1,0,60,58,57,0,0,1,0,0,0,2,1,0,0,0,0,1,0
270530120011006,70,Kenny,67,67,1000000US270530120011006,"Block 1006, Block Group 1, Census Tract 120.01, Hennepin County, Minnesota",58,55,1,0,1,0,0,1,58,58,55,1,0,1,0,0,1,0,0,0,0,0,0,0,0
270531114004019,70,Kenny,67,67,1000000US270531114004019,"Block 4019, Block Group 4, Census Tract 1114, Hennepin County, Minnesota",53,51,0,0,2,0,0,0,53,53,51,0,0,2,0,0,0,0,0,0,0,0,0,0,0
270530120011005,70,Kenny,67,67,1000000US270530120011005,"Block 1005, Block Group 1, Census Tract 120.01, Hennepin County, Minnesota",61,60,0,0,0,0,0,1,61,61,60,0,0,0,0,0,1,0,0,0,0,0,0,0,0
270530120011003,70,Kenny,67,67,1000000US270530120011003,"Block 1003, Block Group 1, Census Tract 120.01, Hennepin County, Minnesota",55,49,1,0,3,0,0,2,55,49,43,1,0,3,0,0,2,6,6,0,0,0,0,0,0
270531114004021,70,Kenny,67,67,1000000US270531114004021,"Block 4021, Block Group 4, Census Tract 1114, Hennepin County, Minnesota",33,31,0,0,0,0,1,1,33,31,29,0,0,0,0,1,1,2,2,0,0,0,0,0,0
270531114004001,70,Kenny,67,67,1000000US270531114004001,"Block 4001, Block Group 4, Census Tract 1114, Hennepin County, Minnesota",50,47,0,0,2,0,0,1,50,49,47,0,0,2,0,0,0,1,0,0,0,0,0,0,1
270530120013005,70,Kenny,67,67,1000000US270530120013005,"Block 3005, Block Group 3, Census Tract 120.01, Hennepin County, Minnesota",67,51,3,0,6,0,1,6,67,63,51,3,0,6,0,0,3,4,0,0,0,0,0,1,3
270530120012008,70,Kenny,67,67,1000000US270530120012008,"Block 2008, Block Group 2, Census Tract 120.01, Hennepin County, Minnesota",56,47,0,0,3,0,2,4,56,51,46,0,0,3,0,0,2,5,1,0,0,0,0,2,2
270530120013009,70,Kenny,67,67,1000000US270530120013009,"Block 3009, Block Group 3, Census Tract 120.01, Hennepin County, Minnesota",87,77,1,0,8,0,0,1,87,87,77,1,0,8,0,0,1,0,0,0,0,0,0,0,0
270530120013003,70,Kenny,67,67,1000000US270530120013003,"Block 3003, Block Group 3, Census Tract 120.01, Hennepin County, Minnesota",60,56,0,0,0,0,0,4,60,58,55,0,0,0,0,0,3,2,1,0,0,0,0,0,1
270530120012009,70,Kenny,67,67,1000000US270530120012009,"Block 2009, Block Group 2, Census Tract 120.01, Hennepin County, Minnesota",162,145,0,1,7,0,7,2,162,155,145,0,1,7,0,0,2,7,0,0,0,0,0,7,0
270530120012016,70,Kenny,67,67,1000000US270530120012016,"Block 2016, Block Group 2, Census Tract 120.01, Hennepin County, Minnesota",71,60,6,0,0,0,0,5,71,71,60,6,0,0,0,0,5,0,0,0,0,0,0,0,0
270530120012015,70,Kenny,67,67,1000000US270530120012015,"Block 2015, Block Group 2, Census Tract 120.01, Hennepin County, Minnesota",87,78,0,0,6,0,0,3,87,81,74,0,0,6,0,0,1,6,4,0,0,0,0,0,2
270530120013004,70,Kenny,67,67,1000000US270530120013004,"Block 3004, Block Group 3, Census Tract 120.01, Hennepin County, Minnesota",45,40,2,0,2,0,0,1,45,45,40,2,0,2,0,0,1,0,0,0,0,0,0,0,0
270530120012007,70,Kenny,67,67,1000000US270530120012007,"Block 2007, Block Group 2, Census Tract 120.01, Hennepin County, Minnesota",59,56,1,0,1,0,0,1,59,56,53,1,0,1,0,0,1,3,3,0,0,0,0,0,0
270530120012002,70,Kenny,67,67,1000000US270530120012002,"Block 2002, Block Group 2, Census Tract 120.01, Hennepin County, Minnesota",64,62,0,1,1,0,0,0,64,58,57,0,0,1,0,0,0,6,5,0,1,0,0,0,0
270530120012017,70,Kenny,67,67,1000000US270530120012017,"Block 2017, Block Group 2, Census Tract 120.01, Hennepin County, Minnesota",12,12,0,0,0,0,0,0,12,11,11,0,0,0,0,0,0,1,1,0,0,0,0,0,0
270530120013007,70,Kenny,67,67,1000000US270530120013007,"Block 3007, Block Group 3, Census Tract 120.01, Hennepin County, Minnesota",43,37,0,0,5,0,1,0,43,42,37,0,0,5,0,0,0,1,0,0,0,0,0,1,0
270530120013010,70,Kenny,67,67,1000000US270530120013010,"Block 3010, Block Group 3, Census Tract 120.01, Hennepin County, Minnesota",69,56,7,1,0,0,2,3,69,61,54,5,1,0,0,0,1,8,2,2,0,0,0,2,2
270530120012011,70,Kenny,67,67,1000000US270530120012011,"Block 2011, Block Group 2, Census Tract 120.01, Hennepin County, Minnesota",13,13,0,0,0,0,0,0,13,13,13,0,0,0,0,0,0,0,0,0,0,0,0,0,0
270530120013008,70,Kenny,67,67,1000000US270530120013008,"Block 3008, Block Group 3, Census Tract 120.01, Hennepin County, Minnesota",39,31,3,0,2,0,0,3,39,39,31,3,0,2,0,0,3,0,0,0,0,0,0,0,0
270530120011013,70,Kenny,67,67,1000000US270530120011013,"Block 1013, Block Group 1, Census Tract 120.01, Hennepin County, Minnesota",60,56,0,0,0,0,0,4,60,59,56,0,0,0,0,0,3,1,0,0,0,0,0,0,1
270530120012010,70,Kenny,67,67,1000000US270530120012010,"Block 2010, Block Group 2, Census Tract 120.01, Hennepin County, Minnesota",42,40,1,0,1,0,0,0,42,42,40,1,0,1,0,0,0,0,0,0,0,0,0,0,0
270530120012019,70,Kenny,67,67,1000000US270530120012019,"Block 2019, Block Group 2, Census Tract 120.01, Hennepin County, Minnesota",48,42,4,0,0,0,0,2,48,47,41,4,0,0,0,0,2,1,1,0,0,0,0,0,0
270530120011011,70,Kenny,67,67,1000000US270530120011011,"Block 1011, Block Group 1, Census Tract 120.01, Hennepin County, Minnesota",67,63,1,0,1,0,2,0,67,64,60,1,0,1,0,2,0,3,3,0,0,0,0,0,0
270530120012004,70,Kenny,67,67,1000000US270530120012004,"Block 2004, Block Group 2, Census Tract 120.01, Hennepin County, Minnesota",7,7,0,0,0,0,0,0,7,7,7,0,0,0,0,0,0,0,0,0,0,0,0,0,0
270530120012000,70,Kenny,67,67,1000000US270530120012000,"Block 2000, Block Group 2, Census Tract 120.01, Hennepin County, Minnesota",59,46,6,0,0,0,0,7,59,56,46,5,0,0,0,0,5,3,0,1,0,0,0,0,2
270531114004004,70,Kenny,67,67,1000000US270531114004004,"Block 4004, Block Group 4, Census Tract 1114, Hennepin County, Minnesota",58,52,0,0,2,0,0,4,58,58,52,0,0,2,0,0,4,0,0,0,0,0,0,0,0
270531114004018,70,Kenny,67,67,1000000US270531114004018,"Block 4018, Block Group 4, Census Tract 1114, Hennepin County, Minnesota",67,59,3,0,0,0,0,5,67,66,58,3,0,0,0,0,5,1,1,0,0,0,0,0,0
270531114004000,70,Kenny,67,67,1000000US270531114004000,"Block 4000, Block Group 4, Census Tract 1114, Hennepin County, Minnesota",33,33,0,0,0,0,0,0,33,33,33,0,0,0,0,0,0,0,0,0,0,0,0,0,0
270530120011010,70,Kenny,67,67,1000000US270530120011010,"Block 1010, Block Group 1, Census Tract 120.01, Hennepin County, Minnesota",0,0,0,0,0,0,0,0,0,0,0,0,0,0,0,0,0,0,0,0,0,0,0,0,0
270530120012012,70,Kenny,67,67,1000000US270530120012012,"Block 2012, Block Group 2, Census Tract 120.01, Hennepin County, Minnesota",31,27,0,0,4,0,0,0,31,31,27,0,0,4,0,0,0,0,0,0,0,0,0,0,0
270530120011012,70,Kenny,67,67,1000000US270530120011012,"Block 1012, Block Group 1, Census Tract 120.01, Hennepin County, Minnesota",39,39,0,0,0,0,0,0,39,39,39,0,0,0,0,0,0,0,0,0,0,0,0,0,0
270530120013001,70,Kenny,67,67,1000000US270530120013001,"Block 3001, Block Group 3, Census Tract 120.01, Hennepin County, Minnesota",55,50,5,0,0,0,0,0,55,55,50,5,0,0,0,0,0,0,0,0,0,0,0,0,0
270530120012005,70,Kenny,67,67,1000000US270530120012005,"Block 2005, Block Group 2, Census Tract 120.01, Hennepin County, Minnesota",55,51,0,0,0,0,3,1,55,51,50,0,0,0,0,0,1,4,1,0,0,0,0,3,0
270531114004016,70,Kenny,67,67,1000000US270531114004016,"Block 4016, Block Group 4, Census Tract 1114, Hennepin County, Minnesota",60,49,3,0,7,0,0,1,60,60,49,3,0,7,0,0,1,0,0,0,0,0,0,0,0
270530120011001,70,Kenny,67,67,1000000US270530120011001,"Block 1001, Block Group 1, Census Tract 120.01, Hennepin County, Minnesota",29,24,5,0,0,0,0,0,29,29,24,5,0,0,0,0,0,0,0,0,0,0,0,0,0
270531114004010,70,Kenny,67,67,1000000US270531114004010,"Block 4010, Block Group 4, Census Tract 1114, Hennepin County, Minnesota",63,60,0,0,3,0,0,0,63,63,60,0,0,3,0,0,0,0,0,0,0,0,0,0,0
270530120012001,70,Kenny,67,67,1000000US270530120012001,"Block 2001, Block Group 2, Census Tract 120.01, Hennepin County, Minnesota",46,38,4,0,1,0,0,3,46,46,38,4,0,1,0,0,3,0,0,0,0,0,0,0,0
270530120012003,70,Kenny,67,67,1000000US270530120012003,"Block 2003, Block Group 2, Census Tract 120.01, Hennepin County, Minnesota",35,30,1,0,0,0,0,4,35,35,30,1,0,0,0,0,4,0,0,0,0,0,0,0,0
270531113005011,71,Armatage,66,66,1000000US270531113005011,"Block 5011, Block Group 5, Census Tract 1113, Hennepin County, Minnesota",62,60,0,0,0,0,0,2,62,60,60,0,0,0,0,0,0,2,0,0,0,0,0,0,2
270530120014002,71,Armatage,66,66,1000000US270530120014002,"Block 4002, Block Group 4, Census Tract 120.01, Hennepin County, Minnesota",43,40,0,2,0,0,0,1,43,41,38,0,2,0,0,0,1,2,2,0,0,0,0,0,0
270530120015004,71,Armatage,66,66,1000000US270530120015004,"Block 5004, Block Group 5, Census Tract 120.01, Hennepin County, Minnesota",46,45,0,0,1,0,0,0,46,46,45,0,0,1,0,0,0,0,0,0,0,0,0,0,0
270530120016012,71,Armatage,66,66,1000000US270530120016012,"Block 6012, Block Group 6, Census Tract 120.01, Hennepin County, Minnesota",47,43,4,0,0,0,0,0,47,47,43,4,0,0,0,0,0,0,0,0,0,0,0,0,0
270530120015003,71,Armatage,66,66,1000000US270530120015003,"Block 5003, Block Group 5, Census Tract 120.01, Hennepin County, Minnesota",48,46,0,0,0,0,1,1,48,47,46,0,0,0,0,0,1,1,0,0,0,0,0,1,0
270530120015009,71,Armatage,66,66,1000000US270530120015009,"Block 5009, Block Group 5, Census Tract 120.01, Hennepin County, Minnesota",63,41,16,0,6,0,0,0,63,62,40,16,0,6,0,0,0,1,1,0,0,0,0,0,0
270530120015000,71,Armatage,66,66,1000000US270530120015000,"Block 5000, Block Group 5, Census Tract 120.01, Hennepin County, Minnesota",36,30,6,0,0,0,0,0,36,35,29,6,0,0,0,0,0,1,1,0,0,0,0,0,0
270531113005004,71,Armatage,66,66,1000000US270531113005004,"Block 5004, Block Group 5, Census Tract 1113, Hennepin County, Minnesota",55,50,0,1,2,0,0,2,55,54,50,0,1,2,0,0,1,1,0,0,0,0,0,0,1
270531113005006,71,Armatage,66,66,1000000US270531113005006,"Block 5006, Block Group 5, Census Tract 1113, Hennepin County, Minnesota",67,56,0,0,9,0,0,2,67,64,53,0,0,9,0,0,2,3,3,0,0,0,0,0,0
270531113005005,71,Armatage,66,66,1000000US270531113005005,"Block 5005, Block Group 5, Census Tract 1113, Hennepin County, Minnesota",50,47,0,0,0,0,0,3,50,48,45,0,0,0,0,0,3,2,2,0,0,0,0,0,0
270530120017006,71,Armatage,66,66,1000000US270530120017006,"Block 7006, Block Group 7, Census Tract 120.01, Hennepin County, Minnesota",141,95,21,4,13,0,3,5,141,135,95,20,3,13,0,0,4,6,0,1,1,0,0,3,1
270530120014008,71,Armatage,66,66,1000000US270530120014008,"Block 4008, Block Group 4, Census Tract 120.01, Hennepin County, Minnesota",20,20,0,0,0,0,0,0,20,20,20,0,0,0,0,0,0,0,0,0,0,0,0,0,0
270530120014021,71,Armatage,66,66,1000000US270530120014021,"Block 4021, Block Group 4, Census Tract 120.01, Hennepin County, Minnesota",25,19,0,0,0,0,6,0,25,19,19,0,0,0,0,0,0,6,0,0,0,0,0,6,0
270531113005008,71,Armatage,66,66,1000000US270531113005008,"Block 5008, Block Group 5, Census Tract 1113, Hennepin County, Minnesota",30,30,0,0,0,0,0,0,30,29,29,0,0,0,0,0,0,1,1,0,0,0,0,0,0
270530120017000,71,Armatage,66,66,1000000US270530120017000,"Block 7000, Block Group 7, Census Tract 120.01, Hennepin County, Minnesota",0,0,0,0,0,0,0,0,0,0,0,0,0,0,0,0,0,0,0,0,0,0,0,0,0
270530120017005,71,Armatage,66,66,1000000US270530120017005,"Block 7005, Block Group 7, Census Tract 120.01, Hennepin County, Minnesota",44,44,0,0,0,0,0,0,44,44,44,0,0,0,0,0,0,0,0,0,0,0,0,0,0
270531113005010,71,Armatage,66,66,1000000US270531113005010,"Block 5010, Block Group 5, Census Tract 1113, Hennepin County, Minnesota",57,56,0,0,1,0,0,0,57,57,56,0,0,1,0,0,0,0,0,0,0,0,0,0,0
270531113005007,71,Armatage,66,66,1000000US270531113005007,"Block 5007, Block Group 5, Census Tract 1113, Hennepin County, Minnesota",59,57,0,0,1,0,0,1,59,56,54,0,0,1,0,0,1,3,3,0,0,0,0,0,0
270531113005001,71,Armatage,66,66,1000000US270531113005001,"Block 5001, Block Group 5, Census Tract 1113, Hennepin County, Minnesota",60,55,1,0,2,0,0,2,60,58,53,1,0,2,0,0,2,2,2,0,0,0,0,0,0
270531113005000,71,Armatage,66,66,1000000US270531113005000,"Block 5000, Block Group 5, Census Tract 1113, Hennepin County, Minnesota",65,58,1,0,1,0,2,3,65,63,58,1,0,1,0,0,3,2,0,0,0,0,0,2,0
270531113006004,71,Armatage,66,66,1000000US270531113006004,"Block 6004, Block Group 6, Census Tract 1113, Hennepin County, Minnesota",44,31,9,0,0,0,0,4,44,41,28,9,0,0,0,0,4,3,3,0,0,0,0,0,0
270531113006003,71,Armatage,66,66,1000000US270531113006003,"Block 6003, Block Group 6, Census Tract 1113, Hennepin County, Minnesota",59,45,4,0,0,0,2,8,59,51,44,4,0,0,0,0,3,8,1,0,0,0,0,2,5
270531113006005,71,Armatage,66,66,1000000US270531113006005,"Block 6005, Block Group 6, Census Tract 1113, Hennepin County, Minnesota",56,26,17,4,4,0,0,5,56,55,26,17,4,4,0,0,4,1,0,0,0,0,0,0,1
270531113006001,71,Armatage,66,66,1000000US270531113006001,"Block 6001, Block Group 6, Census Tract 1113, Hennepin County, Minnesota",53,47,0,1,4,0,0,1,53,52,47,0,1,4,0,0,0,1,0,0,0,0,0,0,1
270531113006007,71,Armatage,66,66,1000000US270531113006007,"Block 6007, Block Group 6, Census Tract 1113, Hennepin County, Minnesota",72,62,0,0,3,0,0,7,72,71,62,0,0,3,0,0,6,1,0,0,0,0,0,0,1
270531113006008,71,Armatage,66,66,1000000US270531113006008,"Block 6008, Block Group 6, Census Tract 1113, Hennepin County, Minnesota",60,60,0,0,0,0,0,0,60,58,58,0,0,0,0,0,0,2,2,0,0,0,0,0,0
270531113006006,71,Armatage,66,66,1000000US270531113006006,"Block 6006, Block Group 6, Census Tract 1113, Hennepin County, Minnesota",118,70,43,1,0,0,1,3,118,111,64,43,1,0,0,0,3,7,6,0,0,0,0,1,0
270531113006000,71,Armatage,66,66,1000000US270531113006000,"Block 6000, Block Group 6, Census Tract 1113, Hennepin County, Minnesota",69,65,0,0,1,0,0,3,69,69,65,0,0,1,0,0,3,0,0,0,0,0,0,0,0
270530120014001,71,Armatage,66,66,1000000US270530120014001,"Block 4001, Block Group 4, Census Tract 120.01, Hennepin County, Minnesota",61,46,5,0,7,0,0,3,61,61,46,5,0,7,0,0,3,0,0,0,0,0,0,0,0
270531113006002,71,Armatage,66,66,1000000US270531113006002,"Block 6002, Block Group 6, Census Tract 1113, Hennepin County, Minnesota",53,48,1,1,0,0,0,3,53,49,48,1,0,0,0,0,0,4,0,0,1,0,0,0,3
270530120014003,71,Armatage,66,66,1000000US270530120014003,"Block 4003, Block Group 4, Census Tract 120.01, Hennepin County, Minnesota",65,36,13,2,10,0,0,4,65,63,36,13,2,10,0,0,2,2,0,0,0,0,0,0,2
270530120017007,71,Armatage,66,66,1000000US270530120017007,"Block 7007, Block Group 7, Census Tract 120.01, Hennepin County, Minnesota",83,38,37,2,0,0,0,6,83,79,38,34,2,0,0,0,5,4,0,3,0,0,0,0,1
270530120016006,71,Armatage,66,66,1000000US270530120016006,"Block 6006, Block Group 6, Census Tract 120.01, Hennepin County, Minnesota",131,65,37,7,6,0,0,16,131,114,48,37,7,6,0,0,16,17,17,0,0,0,0,0,0
270530120016007,71,Armatage,66,66,1000000US270530120016007,"Block 6007, Block Group 6, Census Tract 120.01, Hennepin County, Minnesota",94,56,29,0,0,0,8,1,94,77,48,29,0,0,0,0,0,17,8,0,0,0,0,8,1
270530120016005,71,Armatage,66,66,1000000US270530120016005,"Block 6005, Block Group 6, Census Tract 120.01, Hennepin County, Minnesota",41,28,4,0,8,0,0,1,41,41,28,4,0,8,0,0,1,0,0,0,0,0,0,0,0
270530120015007,71,Armatage,66,66,1000000US270530120015007,"Block 5007, Block Group 5, Census Tract 120.01, Hennepin County, Minnesota",50,44,0,0,1,0,0,5,50,49,43,0,0,1,0,0,5,1,1,0,0,0,0,0,0
270530120016008,71,Armatage,66,66,1000000US270530120016008,"Block 6008, Block Group 6, Census Tract 120.01, Hennepin County, Minnesota",53,42,4,0,7,0,0,0,53,51,40,4,0,7,0,0,0,2,2,0,0,0,0,0,0
270530120015010,71,Armatage,66,66,1000000US270530120015010,"Block 5010, Block Group 5, Census Tract 120.01, Hennepin County, Minnesota",44,35,1,0,6,0,0,2,44,44,35,1,0,6,0,0,2,0,0,0,0,0,0,0,0
270530120017009,71,Armatage,66,66,1000000US270530120017009,"Block 7009, Block Group 7, Census Tract 120.01, Hennepin County, Minnesota",77,63,2,0,8,0,0,4,77,76,62,2,0,8,0,0,4,1,1,0,0,0,0,0,0
270530120015002,71,Armatage,66,66,1000000US270530120015002,"Block 5002, Block Group 5, Census Tract 120.01, Hennepin County, Minnesota",62,54,6,0,0,0,0,2,62,61,53,6,0,0,0,0,2,1,1,0,0,0,0,0,0
270530120016003,71,Armatage,66,66,1000000US270530120016003,"Block 6003, Block Group 6, Census Tract 120.01, Hennepin County, Minnesota",88,88,0,0,0,0,0,0,88,88,88,0,0,0,0,0,0,0,0,0,0,0,0,0,0
270530120015011,71,Armatage,66,66,1000000US270530120015011,"Block 5011, Block Group 5, Census Tract 120.01, Hennepin County, Minnesota",46,42,2,0,1,0,1,0,46,45,42,2,0,1,0,0,0,1,0,0,0,0,0,1,0
270530120014019,71,Armatage,66,66,1000000US270530120014019,"Block 4019, Block Group 4, Census Tract 120.01, Hennepin County, Minnesota",49,34,10,0,0,0,0,5,49,48,33,10,0,0,0,0,5,1,1,0,0,0,0,0,0
270530120015008,71,Armatage,66,66,1000000US270530120015008,"Block 5008, Block Group 5, Census Tract 120.01, Hennepin County, Minnesota",38,30,1,0,6,0,0,1,38,37,29,1,0,6,0,0,1,1,1,0,0,0,0,0,0
270530120014007,71,Armatage,66,66,1000000US270530120014007,"Block 4007, Block Group 4, Census Tract 120.01, Hennepin County, Minnesota",26,26,0,0,0,0,0,0,26,26,26,0,0,0,0,0,0,0,0,0,0,0,0,0,0
270530120014011,71,Armatage,66,66,1000000US270530120014011,"Block 4011, Block Group 4, Census Tract 120.01, Hennepin County, Minnesota",53,51,0,0,0,0,1,1,53,48,47,0,0,0,0,0,1,5,4,0,0,0,0,1,0
270530120014005,71,Armatage,66,66,1000000US270530120014005,"Block 4005, Block Group 4, Census Tract 120.01, Hennepin County, Minnesota",68,55,0,0,3,0,3,7,68,64,54,0,0,3,0,0,7,4,1,0,0,0,0,3,0
270530120014013,71,Armatage,66,66,1000000US270530120014013,"Block 4013, Block Group 4, Census Tract 120.01, Hennepin County, Minnesota",62,48,10,0,1,0,0,3,62,60,47,9,0,1,0,0,3,2,1,1,0,0,0,0,0
270530120015013,71,Armatage,66,66,1000000US270530120015013,"Block 5013, Block Group 5, Census Tract 120.01, Hennepin County, Minnesota",49,39,10,0,0,0,0,0,49,48,38,10,0,0,0,0,0,1,1,0,0,0,0,0,0
270530120016004,71,Armatage,66,66,1000000US270530120016004,"Block 6004, Block Group 6, Census Tract 120.01, Hennepin County, Minnesota",66,54,6,1,0,0,5,0,66,59,53,6,0,0,0,0,0,7,1,0,1,0,0,5,0
270530120016000,71,Armatage,66,66,1000000US270530120016000,"Block 6000, Block Group 6, Census Tract 120.01, Hennepin County, Minnesota",115,98,5,6,1,0,1,4,115,109,95,5,4,1,0,0,4,6,3,0,2,0,0,1,0
270530120015012,71,Armatage,66,66,1000000US270530120015012,"Block 5012, Block Group 5, Census Tract 120.01, Hennepin County, Minnesota",36,31,2,1,0,0,2,0,36,35,30,2,1,0,0,2,0,1,1,0,0,0,0,0,0
270530120014006,71,Armatage,66,66,1000000US270530120014006,"Block 4006, Block Group 4, Census Tract 120.01, Hennepin County, Minnesota",31,27,3,0,0,0,1,0,31,30,27,3,0,0,0,0,0,1,0,0,0,0,0,1,0
270530120014012,71,Armatage,66,66,1000000US270530120014012,"Block 4012, Block Group 4, Census Tract 120.01, Hennepin County, Minnesota",58,55,0,1,0,0,0,2,58,58,55,0,1,0,0,0,2,0,0,0,0,0,0,0,0
270530120016010,71,Armatage,66,66,1000000US270530120016010,"Block 6010, Block Group 6, Census Tract 120.01, Hennepin County, Minnesota",57,44,10,0,1,0,0,2,57,57,44,10,0,1,0,0,2,0,0,0,0,0,0,0,0
270530120014010,71,Armatage,66,66,1000000US270530120014010,"Block 4010, Block Group 4, Census Tract 120.01, Hennepin County, Minnesota",27,23,0,0,1,0,0,3,27,27,23,0,0,1,0,0,3,0,0,0,0,0,0,0,0
270530120014009,71,Armatage,66,66,1000000US270530120014009,"Block 4009, Block Group 4, Census Tract 120.01, Hennepin County, Minnesota",0,0,0,0,0,0,0,0,0,0,0,0,0,0,0,0,0,0,0,0,0,0,0,0,0
270530120014018,71,Armatage,66,66,1000000US270530120014018,"Block 4018, Block Group 4, Census Tract 120.01, Hennepin County, Minnesota",71,42,27,0,1,0,0,1,71,70,42,27,0,1,0,0,0,1,0,0,0,0,0,0,1
270530120014017,71,Armatage,66,66,1000000US270530120014017,"Block 4017, Block Group 4, Census Tract 120.01, Hennepin County, Minnesota",48,40,0,0,5,0,1,2,48,47,40,0,0,5,0,0,2,1,0,0,0,0,0,1,0
270530120014014,71,Armatage,66,66,1000000US270530120014014,"Block 4014, Block Group 4, Census Tract 120.01, Hennepin County, Minnesota",68,61,6,0,0,0,0,1,68,68,61,6,0,0,0,0,1,0,0,0,0,0,0,0,0
270530120014020,71,Armatage,66,66,1000000US270530120014020,"Block 4020, Block Group 4, Census Tract 120.01, Hennepin County, Minnesota",47,42,0,0,4,0,0,1,47,46,41,0,0,4,0,0,1,1,1,0,0,0,0,0,0
270530120016001,71,Armatage,66,66,1000000US270530120016001,"Block 6001, Block Group 6, Census Tract 120.01, Hennepin County, Minnesota",37,36,0,0,0,0,1,0,37,36,36,0,0,0,0,0,0,1,0,0,0,0,0,1,0
270530120014022,71,Armatage,66,66,1000000US270530120014022,"Block 4022, Block Group 4, Census Tract 120.01, Hennepin County, Minnesota",62,60,2,0,0,0,0,0,62,62,60,2,0,0,0,0,0,0,0,0,0,0,0,0,0
270530120016013,71,Armatage,66,66,1000000US270530120016013,"Block 6013, Block Group 6, Census Tract 120.01, Hennepin County, Minnesota",24,18,6,0,0,0,0,0,24,17,11,6,0,0,0,0,0,7,7,0,0,0,0,0,0
270530120017008,71,Armatage,66,66,1000000US270530120017008,"Block 7008, Block Group 7, Census Tract 120.01, Hennepin County, Minnesota",58,53,0,0,4,1,0,0,58,58,53,0,0,4,1,0,0,0,0,0,0,0,0,0,0
270530120017010,71,Armatage,66,66,1000000US270530120017010,"Block 7010, Block Group 7, Census Tract 120.01, Hennepin County, Minnesota",98,90,3,0,1,0,4,0,98,92,88,3,0,1,0,0,0,6,2,0,0,0,0,4,0
270530120017001,71,Armatage,66,66,1000000US270530120017001,"Block 7001, Block Group 7, Census Tract 120.01, Hennepin County, Minnesota",65,60,0,0,1,0,0,4,65,65,60,0,0,1,0,0,4,0,0,0,0,0,0,0,0
270530120016002,71,Armatage,66,66,1000000US270530120016002,"Block 6002, Block Group 6, Census Tract 120.01, Hennepin County, Minnesota",54,47,5,0,1,0,0,1,54,53,46,5,0,1,0,0,1,1,1,0,0,0,0,0,0
270530120016011,71,Armatage,66,66,1000000US270530120016011,"Block 6011, Block Group 6, Census Tract 120.01, Hennepin County, Minnesota",48,42,0,0,0,0,1,5,48,45,40,0,0,0,0,0,5,3,2,0,0,0,0,1,0
270530120015001,71,Armatage,66,66,1000000US270530120015001,"Block 5001, Block Group 5, Census Tract 120.01, Hennepin County, Minnesota",58,52,4,0,0,0,0,2,58,58,52,4,0,0,0,0,2,0,0,0,0,0,0,0,0
270531113005003,71,Armatage,66,66,1000000US270531113005003,"Block 5003, Block Group 5, Census Tract 1113, Hennepin County, Minnesota",45,43,0,0,1,0,1,0,45,44,42,0,0,1,0,1,0,1,1,0,0,0,0,0,0
270531113005002,71,Armatage,66,66,1000000US270531113005002,"Block 5002, Block Group 5, Census Tract 1113, Hennepin County, Minnesota",25,25,0,0,0,0,0,0,25,25,25,0,0,0,0,0,0,0,0,0,0,0,0,0,0
270531113005009,71,Armatage,66,66,1000000US270531113005009,"Block 5009, Block Group 5, Census Tract 1113, Hennepin County, Minnesota",45,45,0,0,0,0,0,0,45,43,43,0,0,0,0,0,0,2,2,0,0,0,0,0,0
270530120017004,71,Armatage,66,66,1000000US270530120017004,"Block 7004, Block Group 7, Census Tract 120.01, Hennepin County, Minnesota",49,46,1,0,1,0,0,1,49,45,43,1,0,1,0,0,0,4,3,0,0,0,0,0,1
270531113005012,71,Armatage,66,66,1000000US270531113005012,"Block 5012, Block Group 5, Census Tract 1113, Hennepin County, Minnesota",52,51,0,0,0,0,0,1,52,52,51,0,0,0,0,0,1,0,0,0,0,0,0,0,0
270531113006010,71,Armatage,66,66,1000000US270531113006010,"Block 6010, Block Group 6, Census Tract 1113, Hennepin County, Minnesota",32,31,0,0,0,0,0,1,32,32,31,0,0,0,0,0,1,0,0,0,0,0,0,0,0
270530120016009,71,Armatage,66,66,1000000US270530120016009,"Block 6009, Block Group 6, Census Tract 120.01, Hennepin County, Minnesota",72,69,2,0,0,0,1,0,72,66,64,2,0,0,0,0,0,6,5,0,0,0,0,1,0
270530120015005,71,Armatage,66,66,1000000US270530120015005,"Block 5005, Block Group 5, Census Tract 120.01, Hennepin County, Minnesota",57,46,0,0,0,0,4,7,57,48,46,0,0,0,0,0,2,9,0,0,0,0,0,4,5
270531113006009,71,Armatage,66,66,1000000US270531113006009,"Block 6009, Block Group 6, Census Tract 1113, Hennepin County, Minnesota",54,47,2,0,4,0,0,1,54,54,47,2,0,4,0,0,1,0,0,0,0,0,0,0,0
270530120014004,71,Armatage,66,66,1000000US270530120014004,"Block 4004, Block Group 4, Census Tract 120.01, Hennepin County, Minnesota",71,58,1,1,10,0,0,1,71,68,57,1,0,10,0,0,0,3,1,0,1,0,0,0,1
270530120014015,71,Armatage,66,66,1000000US270530120014015,"Block 4015, Block Group 4, Census Tract 120.01, Hennepin County, Minnesota",41,38,0,0,2,0,0,1,41,41,38,0,0,2,0,0,1,0,0,0,0,0,0,0,0
270530120014000,71,Armatage,66,66,1000000US270530120014000,"Block 4000, Block Group 4, Census Tract 120.01, Hennepin County, Minnesota",58,53,0,0,3,0,1,1,58,54,51,0,0,3,0,0,0,4,2,0,0,0,0,1,1
270530120014016,71,Armatage,66,66,1000000US270530120014016,"Block 4016, Block Group 4, Census Tract 120.01, Hennepin County, Minnesota",53,45,6,0,1,0,1,0,53,51,44,6,0,1,0,0,0,2,1,0,0,0,0,1,0
270530120017003,71,Armatage,66,66,1000000US270530120017003,"Block 7003, Block Group 7, Census Tract 120.01, Hennepin County, Minnesota",60,56,1,0,2,0,0,1,60,60,56,1,0,2,0,0,1,0,0,0,0,0,0,0,0
270530120017002,71,Armatage,66,66,1000000US270530120017002,"Block 7002, Block Group 7, Census Tract 120.01, Hennepin County, Minnesota",50,46,4,0,0,0,0,0,50,50,46,4,0,0,0,0,0,0,0,0,0,0,0,0,0
270531113005013,71,Armatage,66,66,1000000US270531113005013,"Block 5013, Block Group 5, Census Tract 1113, Hennepin County, Minnesota",79,78,0,0,1,0,0,0,79,79,78,0,0,1,0,0,0,0,0,0,0,0,0,0,0
270530120015006,71,Armatage,66,66,1000000US270530120015006,"Block 5006, Block Group 5, Census Tract 120.01, Hennepin County, Minnesota",46,45,0,0,1,0,0,0,46,46,45,0,0,1,0,0,0,0,0,0,0,0,0,0,0
270531026002020,72,Beltrami,23,23,1000000US270531026002020,"Block 2020, Block Group 2, Census Tract 1026, Hennepin County, Minnesota",0,0,0,0,0,0,0,0,0,0,0,0,0,0,0,0,0,0,0,0,0,0,0,0,0
270531026002019,72,Beltrami,23,23,1000000US270531026002019,"Block 2019, Block Group 2, Census Tract 1026, Hennepin County, Minnesota",0,0,0,0,0,0,0,0,0,0,0,0,0,0,0,0,0,0,0,0,0,0,0,0,0
270531026002021,72,Beltrami,23,23,1000000US270531026002021,"Block 2021, Block Group 2, Census Tract 1026, Hennepin County, Minnesota",45,16,13,0,9,0,5,2,45,32,8,13,0,9,0,0,2,13,8,0,0,0,0,5,0
270531026002002,72,Beltrami,23,23,1000000US270531026002002,"Block 2002, Block Group 2, Census Tract 1026, Hennepin County, Minnesota",98,72,2,5,5,0,6,8,98,70,58,2,1,5,0,0,4,28,14,0,4,0,0,6,4
270531026002018,72,Beltrami,23,23,1000000US270531026002018,"Block 2018, Block Group 2, Census Tract 1026, Hennepin County, Minnesota",4,4,0,0,0,0,0,0,4,4,4,0,0,0,0,0,0,0,0,0,0,0,0,0,0
270531026002007,72,Beltrami,23,23,1000000US270531026002007,"Block 2007, Block Group 2, Census Tract 1026, Hennepin County, Minnesota",0,0,0,0,0,0,0,0,0,0,0,0,0,0,0,0,0,0,0,0,0,0,0,0,0
270531026002008,72,Beltrami,23,23,1000000US270531026002008,"Block 2008, Block Group 2, Census Tract 1026, Hennepin County, Minnesota",34,21,4,0,6,0,0,3,34,34,21,4,0,6,0,0,3,0,0,0,0,0,0,0,0
270531026002016,72,Beltrami,23,23,1000000US270531026002016,"Block 2016, Block Group 2, Census Tract 1026, Hennepin County, Minnesota",0,0,0,0,0,0,0,0,0,0,0,0,0,0,0,0,0,0,0,0,0,0,0,0,0
270531026002001,72,Beltrami,23,23,1000000US270531026002001,"Block 2001, Block Group 2, Census Tract 1026, Hennepin County, Minnesota",107,64,10,13,9,0,2,9,107,88,57,9,4,9,0,0,9,19,7,1,9,0,0,2,0
270531026002017,72,Beltrami,23,23,1000000US270531026002017,"Block 2017, Block Group 2, Census Tract 1026, Hennepin County, Minnesota",0,0,0,0,0,0,0,0,0,0,0,0,0,0,0,0,0,0,0,0,0,0,0,0,0
270531026002009,72,Beltrami,23,23,1000000US270531026002009,"Block 2009, Block Group 2, Census Tract 1026, Hennepin County, Minnesota",83,38,27,3,3,0,5,7,83,67,31,27,1,3,0,0,5,16,7,0,2,0,0,5,2
270531026002014,72,Beltrami,23,23,1000000US270531026002014,"Block 2014, Block Group 2, Census Tract 1026, Hennepin County, Minnesota",80,40,7,1,9,0,20,3,80,59,39,7,1,9,0,0,3,21,1,0,0,0,0,20,0
270531026002015,72,Beltrami,23,23,1000000US270531026002015,"Block 2015, Block Group 2, Census Tract 1026, Hennepin County, Minnesota",92,62,12,3,0,0,7,8,92,75,53,12,2,0,0,0,8,17,9,0,1,0,0,7,0
270531026002004,72,Beltrami,23,23,1000000US270531026002004,"Block 2004, Block Group 2, Census Tract 1026, Hennepin County, Minnesota",120,40,54,18,0,0,0,8,120,107,37,52,13,0,0,0,5,13,3,2,5,0,0,0,3
270531026002011,72,Beltrami,23,23,1000000US270531026002011,"Block 2011, Block Group 2, Census Tract 1026, Hennepin County, Minnesota",89,56,16,4,1,0,6,6,89,81,54,16,4,1,0,0,6,8,2,0,0,0,0,6,0
270531026002010,72,Beltrami,23,23,1000000US270531026002010,"Block 2010, Block Group 2, Census Tract 1026, Hennepin County, Minnesota",89,53,11,1,0,0,24,0,89,65,53,11,1,0,0,0,0,24,0,0,0,0,0,24,0
270531026002005,72,Beltrami,23,23,1000000US270531026002005,"Block 2005, Block Group 2, Census Tract 1026, Hennepin County, Minnesota",51,25,18,1,0,0,0,7,51,44,21,18,0,0,0,0,5,7,4,0,1,0,0,0,2
270531026002012,72,Beltrami,23,23,1000000US270531026002012,"Block 2012, Block Group 2, Census Tract 1026, Hennepin County, Minnesota",118,71,9,3,12,0,20,3,118,95,68,9,3,12,0,0,3,23,3,0,0,0,0,20,0
270531026002000,72,Beltrami,23,23,1000000US270531026002000,"Block 2000, Block Group 2, Census Tract 1026, Hennepin County, Minnesota",128,61,30,7,3,0,19,8,128,103,56,30,7,3,0,0,7,25,5,0,0,0,0,19,1
270531026002013,72,Beltrami,23,23,1000000US270531026002013,"Block 2013, Block Group 2, Census Tract 1026, Hennepin County, Minnesota",86,45,20,0,12,0,4,5,86,79,44,20,0,12,0,0,3,7,1,0,0,0,0,4,2
270531026002022,72,Beltrami,23,23,1000000US270531026002022,"Block 2022, Block Group 2, Census Tract 1026, Hennepin County, Minnesota",24,10,2,0,3,0,9,0,24,15,10,2,0,3,0,0,0,9,0,0,0,0,0,9,0
270531026002006,72,Beltrami,23,23,1000000US270531026002006,"Block 2006, Block Group 2, Census Tract 1026, Hennepin County, Minnesota",0,0,0,0,0,0,0,0,0,0,0,0,0,0,0,0,0,0,0,0,0,0,0,0,0
270531026002003,72,Beltrami,23,23,1000000US270531026002003,"Block 2003, Block Group 2, Census Tract 1026, Hennepin County, Minnesota",0,0,0,0,0,0,0,0,0,0,0,0,0,0,0,0,0,0,0,0,0,0,0,0,0
270531065001019,73,Cedar - Isles - Dean,41,41,1000000US270531065001019,"Block 1019, Block Group 1, Census Tract 1065, Hennepin County, Minnesota",15,15,0,0,0,0,0,0,15,15,15,0,0,0,0,0,0,0,0,0,0,0,0,0,0
270531065003006,73,Cedar - Isles - Dean,41,41,1000000US270531065003006,"Block 3006, Block Group 3, Census Tract 1065, Hennepin County, Minnesota",0,0,0,0,0,0,0,0,0,0,0,0,0,0,0,0,0,0,0,0,0,0,0,0,0
270531065001018,73,Cedar - Isles - Dean,41,41,1000000US270531065001018,"Block 1018, Block Group 1, Census Tract 1065, Hennepin County, Minnesota",210,207,2,1,0,0,0,0,210,210,207,2,1,0,0,0,0,0,0,0,0,0,0,0,0
270531065001023,73,Cedar - Isles - Dean,41,41,1000000US270531065001023,"Block 1023, Block Group 1, Census Tract 1065, Hennepin County, Minnesota",77,64,0,0,9,0,0,4,77,73,60,0,0,9,0,0,4,4,4,0,0,0,0,0,0
270531065001017,73,Cedar - Isles - Dean,41,41,1000000US270531065001017,"Block 1017, Block Group 1, Census Tract 1065, Hennepin County, Minnesota",71,60,1,1,2,0,0,7,71,69,58,1,1,2,0,0,7,2,2,0,0,0,0,0,0
270531065003010,73,Cedar - Isles - Dean,41,41,1000000US270531065003010,"Block 3010, Block Group 3, Census Tract 1065, Hennepin County, Minnesota",152,138,8,0,6,0,0,0,152,151,137,8,0,6,0,0,0,1,1,0,0,0,0,0,0
270531065001021,73,Cedar - Isles - Dean,41,41,1000000US270531065001021,"Block 1021, Block Group 1, Census Tract 1065, Hennepin County, Minnesota",37,37,0,0,0,0,0,0,37,36,36,0,0,0,0,0,0,1,1,0,0,0,0,0,0
270531065001011,73,Cedar - Isles - Dean,41,41,1000000US270531065001011,"Block 1011, Block Group 1, Census Tract 1065, Hennepin County, Minnesota",116,110,5,0,1,0,0,0,116,114,108,5,0,1,0,0,0,2,2,0,0,0,0,0,0
270531065001014,73,Cedar - Isles - Dean,41,41,1000000US270531065001014,"Block 1014, Block Group 1, Census Tract 1065, Hennepin County, Minnesota",0,0,0,0,0,0,0,0,0,0,0,0,0,0,0,0,0,0,0,0,0,0,0,0,0
270531065001006,73,Cedar - Isles - Dean,41,41,1000000US270531065001006,"Block 1006, Block Group 1, Census Tract 1065, Hennepin County, Minnesota",27,26,0,0,0,0,0,1,27,27,26,0,0,0,0,0,1,0,0,0,0,0,0,0,0
270531065003011,73,Cedar - Isles - Dean,41,41,1000000US270531065003011,"Block 3011, Block Group 3, Census Tract 1065, Hennepin County, Minnesota",0,0,0,0,0,0,0,0,0,0,0,0,0,0,0,0,0,0,0,0,0,0,0,0,0
270531065001002,73,Cedar - Isles - Dean,41,41,1000000US270531065001002,"Block 1002, Block Group 1, Census Tract 1065, Hennepin County, Minnesota",0,0,0,0,0,0,0,0,0,0,0,0,0,0,0,0,0,0,0,0,0,0,0,0,0
270531065001003,73,Cedar - Isles - Dean,41,41,1000000US270531065001003,"Block 1003, Block Group 1, Census Tract 1065, Hennepin County, Minnesota",78,73,1,0,2,0,0,2,78,78,73,1,0,2,0,0,2,0,0,0,0,0,0,0,0
270531065001004,73,Cedar - Isles - Dean,41,41,1000000US270531065001004,"Block 1004, Block Group 1, Census Tract 1065, Hennepin County, Minnesota",10,10,0,0,0,0,0,0,10,10,10,0,0,0,0,0,0,0,0,0,0,0,0,0,0
270531065003009,73,Cedar - Isles - Dean,41,41,1000000US270531065003009,"Block 3009, Block Group 3, Census Tract 1065, Hennepin County, Minnesota",8,8,0,0,0,0,0,0,8,8,8,0,0,0,0,0,0,0,0,0,0,0,0,0,0
270531065003027,73,Cedar - Isles - Dean,41,41,1000000US270531065003027,"Block 3027, Block Group 3, Census Tract 1065, Hennepin County, Minnesota",547,468,14,0,34,0,15,16,547,510,454,10,0,34,0,1,11,37,14,4,0,0,0,14,5
270531065003015,73,Cedar - Isles - Dean,41,41,1000000US270531065003015,"Block 3015, Block Group 3, Census Tract 1065, Hennepin County, Minnesota",100,81,4,0,11,0,2,2,100,95,78,4,0,11,0,0,2,5,3,0,0,0,0,2,0
270531065003013,73,Cedar - Isles - Dean,41,41,1000000US270531065003013,"Block 3013, Block Group 3, Census Tract 1065, Hennepin County, Minnesota",40,40,0,0,0,0,0,0,40,35,35,0,0,0,0,0,0,5,5,0,0,0,0,0,0
270531065003018,73,Cedar - Isles - Dean,41,41,1000000US270531065003018,"Block 3018, Block Group 3, Census Tract 1065, Hennepin County, Minnesota",0,0,0,0,0,0,0,0,0,0,0,0,0,0,0,0,0,0,0,0,0,0,0,0,0
270531065001028,73,Cedar - Isles - Dean,41,41,1000000US270531065001028,"Block 1028, Block Group 1, Census Tract 1065, Hennepin County, Minnesota",42,42,0,0,0,0,0,0,42,41,41,0,0,0,0,0,0,1,1,0,0,0,0,0,0
270531065003021,73,Cedar - Isles - Dean,41,41,1000000US270531065003021,"Block 3021, Block Group 3, Census Tract 1065, Hennepin County, Minnesota",0,0,0,0,0,0,0,0,0,0,0,0,0,0,0,0,0,0,0,0,0,0,0,0,0
270531065003025,73,Cedar - Isles - Dean,41,41,1000000US270531065003025,"Block 3025, Block Group 3, Census Tract 1065, Hennepin County, Minnesota",90,85,3,0,2,0,0,0,90,88,83,3,0,2,0,0,0,2,2,0,0,0,0,0,0
270531065001015,73,Cedar - Isles - Dean,41,41,1000000US270531065001015,"Block 1015, Block Group 1, Census Tract 1065, Hennepin County, Minnesota",51,46,0,0,0,0,0,5,51,47,42,0,0,0,0,0,5,4,4,0,0,0,0,0,0
270531065001025,73,Cedar - Isles - Dean,41,41,1000000US270531065001025,"Block 1025, Block Group 1, Census Tract 1065, Hennepin County, Minnesota",0,0,0,0,0,0,0,0,0,0,0,0,0,0,0,0,0,0,0,0,0,0,0,0,0
270531065001026,73,Cedar - Isles - Dean,41,41,1000000US270531065001026,"Block 1026, Block Group 1, Census Tract 1065, Hennepin County, Minnesota",39,37,0,0,2,0,0,0,39,39,37,0,0,2,0,0,0,0,0,0,0,0,0,0,0
270531065001012,73,Cedar - Isles - Dean,41,41,1000000US270531065001012,"Block 1012, Block Group 1, Census Tract 1065, Hennepin County, Minnesota",76,72,2,0,0,0,0,2,76,75,71,2,0,0,0,0,2,1,1,0,0,0,0,0,0
270531065001013,73,Cedar - Isles - Dean,41,41,1000000US270531065001013,"Block 1013, Block Group 1, Census Tract 1065, Hennepin County, Minnesota",47,45,0,0,0,0,2,0,47,47,45,0,0,0,0,2,0,0,0,0,0,0,0,0,0
270531065003014,73,Cedar - Isles - Dean,41,41,1000000US270531065003014,"Block 3014, Block Group 3, Census Tract 1065, Hennepin County, Minnesota",0,0,0,0,0,0,0,0,0,0,0,0,0,0,0,0,0,0,0,0,0,0,0,0,0
270531065003002,73,Cedar - Isles - Dean,41,41,1000000US270531065003002,"Block 3002, Block Group 3, Census Tract 1065, Hennepin County, Minnesota",30,26,0,0,4,0,0,0,30,30,26,0,0,4,0,0,0,0,0,0,0,0,0,0,0
270531065003012,73,Cedar - Isles - Dean,41,41,1000000US270531065003012,"Block 3012, Block Group 3, Census Tract 1065, Hennepin County, Minnesota",36,35,0,1,0,0,0,0,36,36,35,0,1,0,0,0,0,0,0,0,0,0,0,0,0
270531065002028,73,Cedar - Isles - Dean,41,41,1000000US270531065002028,"Block 2028, Block Group 2, Census Tract 1065, Hennepin County, Minnesota",0,0,0,0,0,0,0,0,0,0,0,0,0,0,0,0,0,0,0,0,0,0,0,0,0
270531065003001,73,Cedar - Isles - Dean,41,41,1000000US270531065003001,"Block 3001, Block Group 3, Census Tract 1065, Hennepin County, Minnesota",0,0,0,0,0,0,0,0,0,0,0,0,0,0,0,0,0,0,0,0,0,0,0,0,0
270531091001001,73,Cedar - Isles - Dean,41,41,1000000US270531091001001,"Block 1001, Block Group 1, Census Tract 1091, Hennepin County, Minnesota",0,0,0,0,0,0,0,0,0,0,0,0,0,0,0,0,0,0,0,0,0,0,0,0,0
270531065003017,73,Cedar - Isles - Dean,41,41,1000000US270531065003017,"Block 3017, Block Group 3, Census Tract 1065, Hennepin County, Minnesota",0,0,0,0,0,0,0,0,0,0,0,0,0,0,0,0,0,0,0,0,0,0,0,0,0
270531065003019,73,Cedar - Isles - Dean,41,41,1000000US270531065003019,"Block 3019, Block Group 3, Census Tract 1065, Hennepin County, Minnesota",0,0,0,0,0,0,0,0,0,0,0,0,0,0,0,0,0,0,0,0,0,0,0,0,0
270531065002040,73,Cedar - Isles - Dean,41,41,1000000US270531065002040,"Block 2040, Block Group 2, Census Tract 1065, Hennepin County, Minnesota",0,0,0,0,0,0,0,0,0,0,0,0,0,0,0,0,0,0,0,0,0,0,0,0,0
270531065003023,73,Cedar - Isles - Dean,41,41,1000000US270531065003023,"Block 3023, Block Group 3, Census Tract 1065, Hennepin County, Minnesota",0,0,0,0,0,0,0,0,0,0,0,0,0,0,0,0,0,0,0,0,0,0,0,0,0
270531065003022,73,Cedar - Isles - Dean,41,41,1000000US270531065003022,"Block 3022, Block Group 3, Census Tract 1065, Hennepin County, Minnesota",0,0,0,0,0,0,0,0,0,0,0,0,0,0,0,0,0,0,0,0,0,0,0,0,0
270531080001013,73,Cedar - Isles - Dean,41,41,1000000US270531080001013,"Block 1013, Block Group 1, Census Tract 1080, Hennepin County, Minnesota",0,0,0,0,0,0,0,0,0,0,0,0,0,0,0,0,0,0,0,0,0,0,0,0,0
270531065001024,73,Cedar - Isles - Dean,41,41,1000000US270531065001024,"Block 1024, Block Group 1, Census Tract 1065, Hennepin County, Minnesota",77,74,0,0,0,0,0,3,77,75,73,0,0,0,0,0,2,2,1,0,0,0,0,0,1
270531065001016,73,Cedar - Isles - Dean,41,41,1000000US270531065001016,"Block 1016, Block Group 1, Census Tract 1065, Hennepin County, Minnesota",74,66,3,0,0,0,1,4,74,71,64,3,0,0,0,0,4,3,2,0,0,0,0,1,0
270531065001009,73,Cedar - Isles - Dean,41,41,1000000US270531065001009,"Block 1009, Block Group 1, Census Tract 1065, Hennepin County, Minnesota",21,18,0,0,1,0,0,2,21,21,18,0,0,1,0,0,2,0,0,0,0,0,0,0,0
270531065003008,73,Cedar - Isles - Dean,41,41,1000000US270531065003008,"Block 3008, Block Group 3, Census Tract 1065, Hennepin County, Minnesota",54,48,2,0,1,0,0,3,54,53,47,2,0,1,0,0,3,1,1,0,0,0,0,0,0
270531065001007,73,Cedar - Isles - Dean,41,41,1000000US270531065001007,"Block 1007, Block Group 1, Census Tract 1065, Hennepin County, Minnesota",33,32,1,0,0,0,0,0,33,31,30,1,0,0,0,0,0,2,2,0,0,0,0,0,0
270531065003004,73,Cedar - Isles - Dean,41,41,1000000US270531065003004,"Block 3004, Block Group 3, Census Tract 1065, Hennepin County, Minnesota",56,52,3,0,0,0,0,1,56,55,51,3,0,0,0,0,1,1,1,0,0,0,0,0,0
270531065003003,73,Cedar - Isles - Dean,41,41,1000000US270531065003003,"Block 3003, Block Group 3, Census Tract 1065, Hennepin County, Minnesota",28,27,0,0,1,0,0,0,28,28,27,0,0,1,0,0,0,0,0,0,0,0,0,0,0
270531065003026,73,Cedar - Isles - Dean,41,41,1000000US270531065003026,"Block 3026, Block Group 3, Census Tract 1065, Hennepin County, Minnesota",46,45,0,0,0,0,0,1,46,45,44,0,0,0,0,0,1,1,1,0,0,0,0,0,0
270531065003024,73,Cedar - Isles - Dean,41,41,1000000US270531065003024,"Block 3024, Block Group 3, Census Tract 1065, Hennepin County, Minnesota",350,286,11,0,43,0,1,9,350,340,276,11,0,43,0,1,9,10,10,0,0,0,0,0,0
270531080001012,73,Cedar - Isles - Dean,41,41,1000000US270531080001012,"Block 1012, Block Group 1, Census Tract 1080, Hennepin County, Minnesota",0,0,0,0,0,0,0,0,0,0,0,0,0,0,0,0,0,0,0,0,0,0,0,0,0
270531065003020,73,Cedar - Isles - Dean,41,41,1000000US270531065003020,"Block 3020, Block Group 3, Census Tract 1065, Hennepin County, Minnesota",0,0,0,0,0,0,0,0,0,0,0,0,0,0,0,0,0,0,0,0,0,0,0,0,0
270531065002041,73,Cedar - Isles - Dean,41,41,1000000US270531065002041,"Block 2041, Block Group 2, Census Tract 1065, Hennepin County, Minnesota",0,0,0,0,0,0,0,0,0,0,0,0,0,0,0,0,0,0,0,0,0,0,0,0,0
270531065001005,73,Cedar - Isles - Dean,41,41,1000000US270531065001005,"Block 1005, Block Group 1, Census Tract 1065, Hennepin County, Minnesota",0,0,0,0,0,0,0,0,0,0,0,0,0,0,0,0,0,0,0,0,0,0,0,0,0
270531080001018,73,Cedar - Isles - Dean,41,41,1000000US270531080001018,"Block 1018, Block Group 1, Census Tract 1080, Hennepin County, Minnesota",0,0,0,0,0,0,0,0,0,0,0,0,0,0,0,0,0,0,0,0,0,0,0,0,0
270531065003007,73,Cedar - Isles - Dean,41,41,1000000US270531065003007,"Block 3007, Block Group 3, Census Tract 1065, Hennepin County, Minnesota",78,70,0,0,8,0,0,0,78,78,70,0,0,8,0,0,0,0,0,0,0,0,0,0,0
270531065003005,73,Cedar - Isles - Dean,41,41,1000000US270531065003005,"Block 3005, Block Group 3, Census Tract 1065, Hennepin County, Minnesota",45,45,0,0,0,0,0,0,45,45,45,0,0,0,0,0,0,0,0,0,0,0,0,0,0
270531065003016,73,Cedar - Isles - Dean,41,41,1000000US270531065003016,"Block 3016, Block Group 3, Census Tract 1065, Hennepin County, Minnesota",0,0,0,0,0,0,0,0,0,0,0,0,0,0,0,0,0,0,0,0,0,0,0,0,0
270531065001020,73,Cedar - Isles - Dean,41,41,1000000US270531065001020,"Block 1020, Block Group 1, Census Tract 1065, Hennepin County, Minnesota",29,28,0,0,1,0,0,0,29,29,28,0,0,1,0,0,0,0,0,0,0,0,0,0,0
270531065001022,73,Cedar - Isles - Dean,41,41,1000000US270531065001022,"Block 1022, Block Group 1, Census Tract 1065, Hennepin County, Minnesota",32,30,0,0,2,0,0,0,32,32,30,0,0,2,0,0,0,0,0,0,0,0,0,0,0
270531065001010,73,Cedar - Isles - Dean,41,41,1000000US270531065001010,"Block 1010, Block Group 1, Census Tract 1065, Hennepin County, Minnesota",22,20,1,0,1,0,0,0,22,21,19,1,0,1,0,0,0,1,1,0,0,0,0,0,0
270531065001027,73,Cedar - Isles - Dean,41,41,1000000US270531065001027,"Block 1027, Block Group 1, Census Tract 1065, Hennepin County, Minnesota",81,67,1,2,4,0,3,4,81,79,66,1,2,4,0,3,3,2,1,0,0,0,0,0,1
270531065002027,74,Kenwood,42,42,1000000US270531065002027,"Block 2027, Block Group 2, Census Tract 1065, Hennepin County, Minnesota",0,0,0,0,0,0,0,0,0,0,0,0,0,0,0,0,0,0,0,0,0,0,0,0,0
270531065002003,74,Kenwood,42,42,1000000US270531065002003,"Block 2003, Block Group 2, Census Tract 1065, Hennepin County, Minnesota",0,0,0,0,0,0,0,0,0,0,0,0,0,0,0,0,0,0,0,0,0,0,0,0,0
270531065002016,74,Kenwood,42,42,1000000US270531065002016,"Block 2016, Block Group 2, Census Tract 1065, Hennepin County, Minnesota",83,77,1,3,0,0,0,2,83,80,77,1,1,0,0,0,1,3,0,0,2,0,0,0,1
270531065002035,74,Kenwood,42,42,1000000US270531065002035,"Block 2035, Block Group 2, Census Tract 1065, Hennepin County, Minnesota",0,0,0,0,0,0,0,0,0,0,0,0,0,0,0,0,0,0,0,0,0,0,0,0,0
270531065002030,74,Kenwood,42,42,1000000US270531065002030,"Block 2030, Block Group 2, Census Tract 1065, Hennepin County, Minnesota",59,48,2,0,2,0,0,7,59,59,48,2,0,2,0,0,7,0,0,0,0,0,0,0,0
270531065001000,74,Kenwood,42,42,1000000US270531065001000,"Block 1000, Block Group 1, Census Tract 1065, Hennepin County, Minnesota",0,0,0,0,0,0,0,0,0,0,0,0,0,0,0,0,0,0,0,0,0,0,0,0,0
270531065001008,74,Kenwood,42,42,1000000US270531065001008,"Block 1008, Block Group 1, Census Tract 1065, Hennepin County, Minnesota",0,0,0,0,0,0,0,0,0,0,0,0,0,0,0,0,0,0,0,0,0,0,0,0,0
270531065002025,74,Kenwood,42,42,1000000US270531065002025,"Block 2025, Block Group 2, Census Tract 1065, Hennepin County, Minnesota",79,72,1,0,3,0,1,2,79,76,70,1,0,3,0,0,2,3,2,0,0,0,0,1,0
270531065002015,74,Kenwood,42,42,1000000US270531065002015,"Block 2015, Block Group 2, Census Tract 1065, Hennepin County, Minnesota",72,64,4,0,0,0,0,4,72,69,64,4,0,0,0,0,1,3,0,0,0,0,0,0,3
270531065002023,74,Kenwood,42,42,1000000US270531065002023,"Block 2023, Block Group 2, Census Tract 1065, Hennepin County, Minnesota",31,27,0,0,3,0,0,1,31,31,27,0,0,3,0,0,1,0,0,0,0,0,0,0,0
270531065002017,74,Kenwood,42,42,1000000US270531065002017,"Block 2017, Block Group 2, Census Tract 1065, Hennepin County, Minnesota",0,0,0,0,0,0,0,0,0,0,0,0,0,0,0,0,0,0,0,0,0,0,0,0,0
270531065002005,74,Kenwood,42,42,1000000US270531065002005,"Block 2005, Block Group 2, Census Tract 1065, Hennepin County, Minnesota",0,0,0,0,0,0,0,0,0,0,0,0,0,0,0,0,0,0,0,0,0,0,0,0,0
270531065002029,74,Kenwood,42,42,1000000US270531065002029,"Block 2029, Block Group 2, Census Tract 1065, Hennepin County, Minnesota",42,39,0,1,2,0,0,0,42,41,39,0,0,2,0,0,0,1,0,0,1,0,0,0,0
270531065003000,74,Kenwood,42,42,1000000US270531065003000,"Block 3000, Block Group 3, Census Tract 1065, Hennepin County, Minnesota",0,0,0,0,0,0,0,0,0,0,0,0,0,0,0,0,0,0,0,0,0,0,0,0,0
270531065002014,74,Kenwood,42,42,1000000US270531065002014,"Block 2014, Block Group 2, Census Tract 1065, Hennepin County, Minnesota",0,0,0,0,0,0,0,0,0,0,0,0,0,0,0,0,0,0,0,0,0,0,0,0,0
270531065002012,74,Kenwood,42,42,1000000US270531065002012,"Block 2012, Block Group 2, Census Tract 1065, Hennepin County, Minnesota",108,97,1,2,3,0,1,4,108,102,92,1,2,3,0,0,4,6,5,0,0,0,0,1,0
270531065002001,74,Kenwood,42,42,1000000US270531065002001,"Block 2001, Block Group 2, Census Tract 1065, Hennepin County, Minnesota",41,35,0,0,6,0,0,0,41,36,30,0,0,6,0,0,0,5,5,0,0,0,0,0,0
270531065002013,74,Kenwood,42,42,1000000US270531065002013,"Block 2013, Block Group 2, Census Tract 1065, Hennepin County, Minnesota",33,33,0,0,0,0,0,0,33,33,33,0,0,0,0,0,0,0,0,0,0,0,0,0,0
270531065002008,74,Kenwood,42,42,1000000US270531065002008,"Block 2008, Block Group 2, Census Tract 1065, Hennepin County, Minnesota",0,0,0,0,0,0,0,0,0,0,0,0,0,0,0,0,0,0,0,0,0,0,0,0,0
270531065002022,74,Kenwood,42,42,1000000US270531065002022,"Block 2022, Block Group 2, Census Tract 1065, Hennepin County, Minnesota",0,0,0,0,0,0,0,0,0,0,0,0,0,0,0,0,0,0,0,0,0,0,0,0,0
270531065002036,74,Kenwood,42,42,1000000US270531065002036,"Block 2036, Block Group 2, Census Tract 1065, Hennepin County, Minnesota",0,0,0,0,0,0,0,0,0,0,0,0,0,0,0,0,0,0,0,0,0,0,0,0,0
270531065002024,74,Kenwood,42,42,1000000US270531065002024,"Block 2024, Block Group 2, Census Tract 1065, Hennepin County, Minnesota",99,97,0,1,1,0,0,0,99,97,95,0,1,1,0,0,0,2,2,0,0,0,0,0,0
270531065002020,74,Kenwood,42,42,1000000US270531065002020,"Block 2020, Block Group 2, Census Tract 1065, Hennepin County, Minnesota",38,36,2,0,0,0,0,0,38,38,36,2,0,0,0,0,0,0,0,0,0,0,0,0,0
270531065002042,74,Kenwood,42,42,1000000US270531065002042,"Block 2042, Block Group 2, Census Tract 1065, Hennepin County, Minnesota",88,82,0,4,0,0,0,2,88,85,81,0,4,0,0,0,0,3,1,0,0,0,0,0,2
270531065002019,74,Kenwood,42,42,1000000US270531065002019,"Block 2019, Block Group 2, Census Tract 1065, Hennepin County, Minnesota",103,100,1,0,1,0,1,0,103,101,99,1,0,1,0,0,0,2,1,0,0,0,0,1,0
270531065002000,74,Kenwood,42,42,1000000US270531065002000,"Block 2000, Block Group 2, Census Tract 1065, Hennepin County, Minnesota",141,129,0,1,3,0,3,5,141,133,124,0,1,3,0,0,5,8,5,0,0,0,0,3,0
270531065002010,74,Kenwood,42,42,1000000US270531065002010,"Block 2010, Block Group 2, Census Tract 1065, Hennepin County, Minnesota",57,52,0,0,5,0,0,0,57,56,51,0,0,5,0,0,0,1,1,0,0,0,0,0,0
270531065002034,74,Kenwood,42,42,1000000US270531065002034,"Block 2034, Block Group 2, Census Tract 1065, Hennepin County, Minnesota",25,22,1,0,0,0,1,1,25,22,20,1,0,0,0,0,1,3,2,0,0,0,0,1,0
270531065002021,74,Kenwood,42,42,1000000US270531065002021,"Block 2021, Block Group 2, Census Tract 1065, Hennepin County, Minnesota",0,0,0,0,0,0,0,0,0,0,0,0,0,0,0,0,0,0,0,0,0,0,0,0,0
270531065002004,74,Kenwood,42,42,1000000US270531065002004,"Block 2004, Block Group 2, Census Tract 1065, Hennepin County, Minnesota",0,0,0,0,0,0,0,0,0,0,0,0,0,0,0,0,0,0,0,0,0,0,0,0,0
270531065002009,74,Kenwood,42,42,1000000US270531065002009,"Block 2009, Block Group 2, Census Tract 1065, Hennepin County, Minnesota",4,4,0,0,0,0,0,0,4,4,4,0,0,0,0,0,0,0,0,0,0,0,0,0,0
270531065002032,74,Kenwood,42,42,1000000US270531065002032,"Block 2032, Block Group 2, Census Tract 1065, Hennepin County, Minnesota",20,17,0,0,1,0,0,2,20,20,17,0,0,1,0,0,2,0,0,0,0,0,0,0,0
270531065002031,74,Kenwood,42,42,1000000US270531065002031,"Block 2031, Block Group 2, Census Tract 1065, Hennepin County, Minnesota",83,78,1,0,0,0,0,4,83,82,77,1,0,0,0,0,4,1,1,0,0,0,0,0,0
270531065002033,74,Kenwood,42,42,1000000US270531065002033,"Block 2033, Block Group 2, Census Tract 1065, Hennepin County, Minnesota",46,45,0,0,0,0,0,1,46,45,44,0,0,0,0,0,1,1,1,0,0,0,0,0,0
270531065002007,74,Kenwood,42,42,1000000US270531065002007,"Block 2007, Block Group 2, Census Tract 1065, Hennepin County, Minnesota",13,12,0,0,0,0,0,1,13,13,12,0,0,0,0,0,1,0,0,0,0,0,0,0,0
270531065002006,74,Kenwood,42,42,1000000US270531065002006,"Block 2006, Block Group 2, Census Tract 1065, Hennepin County, Minnesota",0,0,0,0,0,0,0,0,0,0,0,0,0,0,0,0,0,0,0,0,0,0,0,0,0
270531065002018,74,Kenwood,42,42,1000000US270531065002018,"Block 2018, Block Group 2, Census Tract 1065, Hennepin County, Minnesota",45,42,0,0,3,0,0,0,45,43,40,0,0,3,0,0,0,2,2,0,0,0,0,0,0
270531065002026,74,Kenwood,42,42,1000000US270531065002026,"Block 2026, Block Group 2, Census Tract 1065, Hennepin County, Minnesota",25,25,0,0,0,0,0,0,25,25,25,0,0,0,0,0,0,0,0,0,0,0,0,0,0
270531065002011,74,Kenwood,42,42,1000000US270531065002011,"Block 2011, Block Group 2, Census Tract 1065, Hennepin County, Minnesota",106,102,0,1,0,0,0,3,106,106,102,0,1,0,0,0,3,0,0,0,0,0,0,0,0
270531065002002,74,Kenwood,42,42,1000000US270531065002002,"Block 2002, Block Group 2, Census Tract 1065, Hennepin County, Minnesota",0,0,0,0,0,0,0,0,0,0,0,0,0,0,0,0,0,0,0,0,0,0,0,0,0
270531055003021,75,Lowry Hill,43,43,1000000US270531055003021,"Block 3021, Block Group 3, Census Tract 1055, Hennepin County, Minnesota",46,45,0,0,0,0,0,1,46,44,43,0,0,0,0,0,1,2,2,0,0,0,0,0,0
270531055003002,75,Lowry Hill,43,43,1000000US270531055003002,"Block 3002, Block Group 3, Census Tract 1055, Hennepin County, Minnesota",0,0,0,0,0,0,0,0,0,0,0,0,0,0,0,0,0,0,0,0,0,0,0,0,0
270531055004001,75,Lowry Hill,43,43,1000000US270531055004001,"Block 4001, Block Group 4, Census Tract 1055, Hennepin County, Minnesota",5,3,2,0,0,0,0,0,5,5,3,2,0,0,0,0,0,0,0,0,0,0,0,0,0
270531055003025,75,Lowry Hill,43,43,1000000US270531055003025,"Block 3025, Block Group 3, Census Tract 1055, Hennepin County, Minnesota",3,2,0,0,1,0,0,0,3,3,2,0,0,1,0,0,0,0,0,0,0,0,0,0,0
270531055002010,75,Lowry Hill,43,43,1000000US270531055002010,"Block 2010, Block Group 2, Census Tract 1055, Hennepin County, Minnesota",41,36,5,0,0,0,0,0,41,40,35,5,0,0,0,0,0,1,1,0,0,0,0,0,0
270531055002009,75,Lowry Hill,43,43,1000000US270531055002009,"Block 2009, Block Group 2, Census Tract 1055, Hennepin County, Minnesota",31,30,0,0,1,0,0,0,31,31,30,0,0,1,0,0,0,0,0,0,0,0,0,0,0
270531055001001,75,Lowry Hill,43,43,1000000US270531055001001,"Block 1001, Block Group 1, Census Tract 1055, Hennepin County, Minnesota",71,64,0,0,6,0,0,1,71,69,62,0,0,6,0,0,1,2,2,0,0,0,0,0,0
270531055001006,75,Lowry Hill,43,43,1000000US270531055001006,"Block 1006, Block Group 1, Census Tract 1055, Hennepin County, Minnesota",119,111,2,0,4,0,1,1,119,118,111,2,0,4,0,0,1,1,0,0,0,0,0,1,0
270531055001002,75,Lowry Hill,43,43,1000000US270531055001002,"Block 1002, Block Group 1, Census Tract 1055, Hennepin County, Minnesota",174,144,9,0,14,0,1,6,174,169,141,9,0,14,0,0,5,5,3,0,0,0,0,1,1
270531051002014,75,Lowry Hill,43,43,1000000US270531051002014,"Block 2014, Block Group 2, Census Tract 1051, Hennepin County, Minnesota",0,0,0,0,0,0,0,0,0,0,0,0,0,0,0,0,0,0,0,0,0,0,0,0,0
270531055003016,75,Lowry Hill,43,43,1000000US270531055003016,"Block 3016, Block Group 3, Census Tract 1055, Hennepin County, Minnesota",24,21,0,0,3,0,0,0,24,22,19,0,0,3,0,0,0,2,2,0,0,0,0,0,0
270531055003001,75,Lowry Hill,43,43,1000000US270531055003001,"Block 3001, Block Group 3, Census Tract 1055, Hennepin County, Minnesota",0,0,0,0,0,0,0,0,0,0,0,0,0,0,0,0,0,0,0,0,0,0,0,0,0
270531055003008,75,Lowry Hill,43,43,1000000US270531055003008,"Block 3008, Block Group 3, Census Tract 1055, Hennepin County, Minnesota",58,58,0,0,0,0,0,0,58,57,57,0,0,0,0,0,0,1,1,0,0,0,0,0,0
270531055003011,75,Lowry Hill,43,43,1000000US270531055003011,"Block 3011, Block Group 3, Census Tract 1055, Hennepin County, Minnesota",39,36,1,0,2,0,0,0,39,39,36,1,0,2,0,0,0,0,0,0,0,0,0,0,0
270531055003004,75,Lowry Hill,43,43,1000000US270531055003004,"Block 3004, Block Group 3, Census Tract 1055, Hennepin County, Minnesota",21,21,0,0,0,0,0,0,21,21,21,0,0,0,0,0,0,0,0,0,0,0,0,0,0
270531055003014,75,Lowry Hill,43,43,1000000US270531055003014,"Block 3014, Block Group 3, Census Tract 1055, Hennepin County, Minnesota",33,33,0,0,0,0,0,0,33,33,33,0,0,0,0,0,0,0,0,0,0,0,0,0,0
270531055003003,75,Lowry Hill,43,43,1000000US270531055003003,"Block 3003, Block Group 3, Census Tract 1055, Hennepin County, Minnesota",0,0,0,0,0,0,0,0,0,0,0,0,0,0,0,0,0,0,0,0,0,0,0,0,0
270531055003012,75,Lowry Hill,43,43,1000000US270531055003012,"Block 3012, Block Group 3, Census Tract 1055, Hennepin County, Minnesota",32,26,2,1,2,0,1,0,32,31,26,2,1,2,0,0,0,1,0,0,0,0,0,1,0
270531055004004,75,Lowry Hill,43,43,1000000US270531055004004,"Block 4004, Block Group 4, Census Tract 1055, Hennepin County, Minnesota",44,41,0,0,0,0,0,3,44,44,41,0,0,0,0,0,3,0,0,0,0,0,0,0,0
270531055001004,75,Lowry Hill,43,43,1000000US270531055001004,"Block 1004, Block Group 1, Census Tract 1055, Hennepin County, Minnesota",0,0,0,0,0,0,0,0,0,0,0,0,0,0,0,0,0,0,0,0,0,0,0,0,0
270531055002002,75,Lowry Hill,43,43,1000000US270531055002002,"Block 2002, Block Group 2, Census Tract 1055, Hennepin County, Minnesota",28,28,0,0,0,0,0,0,28,28,28,0,0,0,0,0,0,0,0,0,0,0,0,0,0
270531055003006,75,Lowry Hill,43,43,1000000US270531055003006,"Block 3006, Block Group 3, Census Tract 1055, Hennepin County, Minnesota",0,0,0,0,0,0,0,0,0,0,0,0,0,0,0,0,0,0,0,0,0,0,0,0,0
270531055003013,75,Lowry Hill,43,43,1000000US270531055003013,"Block 3013, Block Group 3, Census Tract 1055, Hennepin County, Minnesota",51,42,6,0,1,1,0,1,51,49,41,6,0,0,1,0,1,2,1,0,0,1,0,0,0
270531055003019,75,Lowry Hill,43,43,1000000US270531055003019,"Block 3019, Block Group 3, Census Tract 1055, Hennepin County, Minnesota",26,26,0,0,0,0,0,0,26,24,24,0,0,0,0,0,0,2,2,0,0,0,0,0,0
270531055002006,75,Lowry Hill,43,43,1000000US270531055002006,"Block 2006, Block Group 2, Census Tract 1055, Hennepin County, Minnesota",23,18,2,0,1,0,0,2,23,23,18,2,0,1,0,0,2,0,0,0,0,0,0,0,0
270531055004015,75,Lowry Hill,43,43,1000000US270531055004015,"Block 4015, Block Group 4, Census Tract 1055, Hennepin County, Minnesota",71,60,0,0,0,0,5,6,71,68,60,0,0,0,0,5,3,3,0,0,0,0,0,0,3
270531055002011,75,Lowry Hill,43,43,1000000US270531055002011,"Block 2011, Block Group 2, Census Tract 1055, Hennepin County, Minnesota",198,186,3,0,7,0,2,0,198,190,180,3,0,7,0,0,0,8,6,0,0,0,0,2,0
270531055003024,75,Lowry Hill,43,43,1000000US270531055003024,"Block 3024, Block Group 3, Census Tract 1055, Hennepin County, Minnesota",49,48,0,0,1,0,0,0,49,49,48,0,0,1,0,0,0,0,0,0,0,0,0,0,0
270531055004010,75,Lowry Hill,43,43,1000000US270531055004010,"Block 4010, Block Group 4, Census Tract 1055, Hennepin County, Minnesota",47,42,0,1,4,0,0,0,47,46,42,0,0,4,0,0,0,1,0,0,1,0,0,0,0
270531055004002,75,Lowry Hill,43,43,1000000US270531055004002,"Block 4002, Block Group 4, Census Tract 1055, Hennepin County, Minnesota",64,59,5,0,0,0,0,0,64,64,59,5,0,0,0,0,0,0,0,0,0,0,0,0,0
270531055004008,75,Lowry Hill,43,43,1000000US270531055004008,"Block 4008, Block Group 4, Census Tract 1055, Hennepin County, Minnesota",25,25,0,0,0,0,0,0,25,25,25,0,0,0,0,0,0,0,0,0,0,0,0,0,0
270531055001000,75,Lowry Hill,43,43,1000000US270531055001000,"Block 1000, Block Group 1, Census Tract 1055, Hennepin County, Minnesota",0,0,0,0,0,0,0,0,0,0,0,0,0,0,0,0,0,0,0,0,0,0,0,0,0
270531055001003,75,Lowry Hill,43,43,1000000US270531055001003,"Block 1003, Block Group 1, Census Tract 1055, Hennepin County, Minnesota",0,0,0,0,0,0,0,0,0,0,0,0,0,0,0,0,0,0,0,0,0,0,0,0,0
270531055004000,75,Lowry Hill,43,43,1000000US270531055004000,"Block 4000, Block Group 4, Census Tract 1055, Hennepin County, Minnesota",96,92,4,0,0,0,0,0,96,96,92,4,0,0,0,0,0,0,0,0,0,0,0,0,0
270531055002005,75,Lowry Hill,43,43,1000000US270531055002005,"Block 2005, Block Group 2, Census Tract 1055, Hennepin County, Minnesota",24,21,2,0,0,0,1,0,24,22,20,2,0,0,0,0,0,2,1,0,0,0,0,1,0
270531055002008,75,Lowry Hill,43,43,1000000US270531055002008,"Block 2008, Block Group 2, Census Tract 1055, Hennepin County, Minnesota",45,45,0,0,0,0,0,0,45,44,44,0,0,0,0,0,0,1,1,0,0,0,0,0,0
270531055001005,75,Lowry Hill,43,43,1000000US270531055001005,"Block 1005, Block Group 1, Census Tract 1055, Hennepin County, Minnesota",286,246,14,4,8,0,3,11,286,270,235,14,4,8,0,1,8,16,11,0,0,0,0,2,3
270531055004014,75,Lowry Hill,43,43,1000000US270531055004014,"Block 4014, Block Group 4, Census Tract 1055, Hennepin County, Minnesota",71,56,1,0,7,0,0,7,71,70,56,1,0,7,0,0,6,1,0,0,0,0,0,0,1
270531055003020,75,Lowry Hill,43,43,1000000US270531055003020,"Block 3020, Block Group 3, Census Tract 1055, Hennepin County, Minnesota",70,61,0,0,2,0,5,2,70,65,61,0,0,2,0,0,2,5,0,0,0,0,0,5,0
270531055003022,75,Lowry Hill,43,43,1000000US270531055003022,"Block 3022, Block Group 3, Census Tract 1055, Hennepin County, Minnesota",33,31,0,0,0,1,0,1,33,32,30,0,0,0,1,0,1,1,1,0,0,0,0,0,0
270531055004009,75,Lowry Hill,43,43,1000000US270531055004009,"Block 4009, Block Group 4, Census Tract 1055, Hennepin County, Minnesota",36,31,1,0,1,0,0,3,36,36,31,1,0,1,0,0,3,0,0,0,0,0,0,0,0
270531055004013,75,Lowry Hill,43,43,1000000US270531055004013,"Block 4013, Block Group 4, Census Tract 1055, Hennepin County, Minnesota",80,72,2,0,6,0,0,0,80,80,72,2,0,6,0,0,0,0,0,0,0,0,0,0,0
270531055002004,75,Lowry Hill,43,43,1000000US270531055002004,"Block 2004, Block Group 2, Census Tract 1055, Hennepin County, Minnesota",34,30,0,0,1,0,1,2,34,33,30,0,0,1,0,0,2,1,0,0,0,0,0,1,0
270531055004007,75,Lowry Hill,43,43,1000000US270531055004007,"Block 4007, Block Group 4, Census Tract 1055, Hennepin County, Minnesota",39,39,0,0,0,0,0,0,39,36,36,0,0,0,0,0,0,3,3,0,0,0,0,0,0
270531055002003,75,Lowry Hill,43,43,1000000US270531055002003,"Block 2003, Block Group 2, Census Tract 1055, Hennepin County, Minnesota",33,32,0,0,0,0,0,1,33,32,32,0,0,0,0,0,0,1,0,0,0,0,0,0,1
270531055001010,75,Lowry Hill,43,43,1000000US270531055001010,"Block 1010, Block Group 1, Census Tract 1055, Hennepin County, Minnesota",0,0,0,0,0,0,0,0,0,0,0,0,0,0,0,0,0,0,0,0,0,0,0,0,0
270531055001009,75,Lowry Hill,43,43,1000000US270531055001009,"Block 1009, Block Group 1, Census Tract 1055, Hennepin County, Minnesota",102,85,6,1,4,0,2,4,102,98,85,6,0,4,0,0,3,4,0,0,1,0,0,2,1
270531055002012,75,Lowry Hill,43,43,1000000US270531055002012,"Block 2012, Block Group 2, Census Tract 1055, Hennepin County, Minnesota",152,138,6,0,5,0,1,2,152,150,137,6,0,5,0,0,2,2,1,0,0,0,0,1,0
270531055002015,75,Lowry Hill,43,43,1000000US270531055002015,"Block 2015, Block Group 2, Census Tract 1055, Hennepin County, Minnesota",96,91,3,0,1,0,1,0,96,95,91,3,0,1,0,0,0,1,0,0,0,0,0,1,0
270531055002013,75,Lowry Hill,43,43,1000000US270531055002013,"Block 2013, Block Group 2, Census Tract 1055, Hennepin County, Minnesota",208,173,19,1,3,0,3,9,208,196,168,18,1,2,0,1,6,12,5,1,0,1,0,2,3
270531055003007,75,Lowry Hill,43,43,1000000US270531055003007,"Block 3007, Block Group 3, Census Tract 1055, Hennepin County, Minnesota",15,13,0,0,2,0,0,0,15,15,13,0,0,2,0,0,0,0,0,0,0,0,0,0,0
270531055003010,75,Lowry Hill,43,43,1000000US270531055003010,"Block 3010, Block Group 3, Census Tract 1055, Hennepin County, Minnesota",34,34,0,0,0,0,0,0,34,34,34,0,0,0,0,0,0,0,0,0,0,0,0,0,0
270531055003000,75,Lowry Hill,43,43,1000000US270531055003000,"Block 3000, Block Group 3, Census Tract 1055, Hennepin County, Minnesota",0,0,0,0,0,0,0,0,0,0,0,0,0,0,0,0,0,0,0,0,0,0,0,0,0
270531055003017,75,Lowry Hill,43,43,1000000US270531055003017,"Block 3017, Block Group 3, Census Tract 1055, Hennepin County, Minnesota",22,22,0,0,0,0,0,0,22,22,22,0,0,0,0,0,0,0,0,0,0,0,0,0,0
270531055004005,75,Lowry Hill,43,43,1000000US270531055004005,"Block 4005, Block Group 4, Census Tract 1055, Hennepin County, Minnesota",50,47,0,0,1,0,0,2,50,50,47,0,0,1,0,0,2,0,0,0,0,0,0,0,0
270531055003005,75,Lowry Hill,43,43,1000000US270531055003005,"Block 3005, Block Group 3, Census Tract 1055, Hennepin County, Minnesota",0,0,0,0,0,0,0,0,0,0,0,0,0,0,0,0,0,0,0,0,0,0,0,0,0
270531055002007,75,Lowry Hill,43,43,1000000US270531055002007,"Block 2007, Block Group 2, Census Tract 1055, Hennepin County, Minnesota",23,20,0,1,0,0,0,2,23,23,20,0,1,0,0,0,2,0,0,0,0,0,0,0,0
270531055001007,75,Lowry Hill,43,43,1000000US270531055001007,"Block 1007, Block Group 1, Census Tract 1055, Hennepin County, Minnesota",118,108,0,1,7,0,1,1,118,117,107,0,1,7,0,1,1,1,1,0,0,0,0,0,0
270531055002014,75,Lowry Hill,43,43,1000000US270531055002014,"Block 2014, Block Group 2, Census Tract 1055, Hennepin County, Minnesota",153,138,3,4,5,0,3,0,153,148,136,3,4,5,0,0,0,5,2,0,0,0,0,3,0
270531055003018,75,Lowry Hill,43,43,1000000US270531055003018,"Block 3018, Block Group 3, Census Tract 1055, Hennepin County, Minnesota",26,25,0,0,1,0,0,0,26,26,25,0,0,1,0,0,0,0,0,0,0,0,0,0,0
270531055004003,75,Lowry Hill,43,43,1000000US270531055004003,"Block 4003, Block Group 4, Census Tract 1055, Hennepin County, Minnesota",50,50,0,0,0,0,0,0,50,48,48,0,0,0,0,0,0,2,2,0,0,0,0,0,0
270531055003023,75,Lowry Hill,43,43,1000000US270531055003023,"Block 3023, Block Group 3, Census Tract 1055, Hennepin County, Minnesota",15,12,0,0,3,0,0,0,15,15,12,0,0,3,0,0,0,0,0,0,0,0,0,0,0
270531055004011,75,Lowry Hill,43,43,1000000US270531055004011,"Block 4011, Block Group 4, Census Tract 1055, Hennepin County, Minnesota",69,62,0,0,2,0,5,0,69,64,62,0,0,2,0,0,0,5,0,0,0,0,0,5,0
270531055004012,75,Lowry Hill,43,43,1000000US270531055004012,"Block 4012, Block Group 4, Census Tract 1055, Hennepin County, Minnesota",46,39,2,0,2,0,0,3,46,45,38,2,0,2,0,0,3,1,1,0,0,0,0,0,0
270531055004006,75,Lowry Hill,43,43,1000000US270531055004006,"Block 4006, Block Group 4, Census Tract 1055, Hennepin County, Minnesota",37,35,0,0,0,0,0,2,37,37,35,0,0,0,0,0,2,0,0,0,0,0,0,0,0
270531055002000,75,Lowry Hill,43,43,1000000US270531055002000,"Block 2000, Block Group 2, Census Tract 1055, Hennepin County, Minnesota",133,120,4,1,2,0,1,5,133,128,117,4,1,2,0,0,4,5,3,0,0,0,0,1,1
270531055002001,75,Lowry Hill,43,43,1000000US270531055002001,"Block 2001, Block Group 2, Census Tract 1055, Hennepin County, Minnesota",16,16,0,0,0,0,0,0,16,16,16,0,0,0,0,0,0,0,0,0,0,0,0,0,0
270531055001008,75,Lowry Hill,43,43,1000000US270531055001008,"Block 1008, Block Group 1, Census Tract 1055, Hennepin County, Minnesota",155,151,2,0,2,0,0,0,155,155,151,2,0,2,0,0,0,0,0,0,0,0,0,0,0
270531055003015,75,Lowry Hill,43,43,1000000US270531055003015,"Block 3015, Block Group 3, Census Tract 1055, Hennepin County, Minnesota",25,24,1,0,0,0,0,0,25,23,22,1,0,0,0,0,0,2,2,0,0,0,0,0,0
270531055003009,75,Lowry Hill,43,43,1000000US270531055003009,"Block 3009, Block Group 3, Census Tract 1055, Hennepin County, Minnesota",18,17,0,1,0,0,0,0,18,18,17,0,1,0,0,0,0,0,0,0,0,0,0,0,0
270531066001007,76,East Isles,44,44,1000000US270531066001007,"Block 1007, Block Group 1, Census Tract 1066, Hennepin County, Minnesota",28,28,0,0,0,0,0,0,28,27,27,0,0,0,0,0,0,1,1,0,0,0,0,0,0
270531066003009,76,East Isles,44,44,1000000US270531066003009,"Block 3009, Block Group 3, Census Tract 1066, Hennepin County, Minnesota",29,25,0,0,4,0,0,0,29,29,25,0,0,4,0,0,0,0,0,0,0,0,0,0,0
270531080001001,76,East Isles,44,44,1000000US270531080001001,"Block 1001, Block Group 1, Census Tract 1080, Hennepin County, Minnesota",0,0,0,0,0,0,0,0,0,0,0,0,0,0,0,0,0,0,0,0,0,0,0,0,0
270531066003012,76,East Isles,44,44,1000000US270531066003012,"Block 3012, Block Group 3, Census Tract 1066, Hennepin County, Minnesota",0,0,0,0,0,0,0,0,0,0,0,0,0,0,0,0,0,0,0,0,0,0,0,0,0
270531066002006,76,East Isles,44,44,1000000US270531066002006,"Block 2006, Block Group 2, Census Tract 1066, Hennepin County, Minnesota",0,0,0,0,0,0,0,0,0,0,0,0,0,0,0,0,0,0,0,0,0,0,0,0,0
270531080001006,76,East Isles,44,44,1000000US270531080001006,"Block 1006, Block Group 1, Census Tract 1080, Hennepin County, Minnesota",0,0,0,0,0,0,0,0,0,0,0,0,0,0,0,0,0,0,0,0,0,0,0,0,0
270531066001001,76,East Isles,44,44,1000000US270531066001001,"Block 1001, Block Group 1, Census Tract 1066, Hennepin County, Minnesota",62,51,5,0,2,0,1,3,62,60,50,5,0,2,0,0,3,2,1,0,0,0,0,1,0
270531066003001,76,East Isles,44,44,1000000US270531066003001,"Block 3001, Block Group 3, Census Tract 1066, Hennepin County, Minnesota",81,70,1,0,3,0,1,6,81,80,70,1,0,3,0,0,6,1,0,0,0,0,0,1,0
270531066003003,76,East Isles,44,44,1000000US270531066003003,"Block 3003, Block Group 3, Census Tract 1066, Hennepin County, Minnesota",72,58,0,0,5,0,0,9,72,69,55,0,0,5,0,0,9,3,3,0,0,0,0,0,0
270531066003008,76,East Isles,44,44,1000000US270531066003008,"Block 3008, Block Group 3, Census Tract 1066, Hennepin County, Minnesota",72,72,0,0,0,0,0,0,72,71,71,0,0,0,0,0,0,1,1,0,0,0,0,0,0
270531066003007,76,East Isles,44,44,1000000US270531066003007,"Block 3007, Block Group 3, Census Tract 1066, Hennepin County, Minnesota",0,0,0,0,0,0,0,0,0,0,0,0,0,0,0,0,0,0,0,0,0,0,0,0,0
270531066001008,76,East Isles,44,44,1000000US270531066001008,"Block 1008, Block Group 1, Census Tract 1066, Hennepin County, Minnesota",76,64,0,0,6,0,1,5,76,76,64,0,0,6,0,1,5,0,0,0,0,0,0,0,0
270531066002005,76,East Isles,44,44,1000000US270531066002005,"Block 2005, Block Group 2, Census Tract 1066, Hennepin County, Minnesota",143,134,1,0,3,1,0,4,143,140,131,1,0,3,1,0,4,3,3,0,0,0,0,0,0
270531066003004,76,East Isles,44,44,1000000US270531066003004,"Block 3004, Block Group 3, Census Tract 1066, Hennepin County, Minnesota",10,10,0,0,0,0,0,0,10,10,10,0,0,0,0,0,0,0,0,0,0,0,0,0,0
270531066003002,76,East Isles,44,44,1000000US270531066003002,"Block 3002, Block Group 3, Census Tract 1066, Hennepin County, Minnesota",59,56,0,0,2,0,0,1,59,58,55,0,0,2,0,0,1,1,1,0,0,0,0,0,0
270531066001009,76,East Isles,44,44,1000000US270531066001009,"Block 1009, Block Group 1, Census Tract 1066, Hennepin County, Minnesota",91,86,2,0,2,0,0,1,91,91,86,2,0,2,0,0,1,0,0,0,0,0,0,0,0
270531080001003,76,East Isles,44,44,1000000US270531080001003,"Block 1003, Block Group 1, Census Tract 1080, Hennepin County, Minnesota",0,0,0,0,0,0,0,0,0,0,0,0,0,0,0,0,0,0,0,0,0,0,0,0,0
270531080001005,76,East Isles,44,44,1000000US270531080001005,"Block 1005, Block Group 1, Census Tract 1080, Hennepin County, Minnesota",0,0,0,0,0,0,0,0,0,0,0,0,0,0,0,0,0,0,0,0,0,0,0,0,0
270531080001004,76,East Isles,44,44,1000000US270531080001004,"Block 1004, Block Group 1, Census Tract 1080, Hennepin County, Minnesota",0,0,0,0,0,0,0,0,0,0,0,0,0,0,0,0,0,0,0,0,0,0,0,0,0
270531080001009,76,East Isles,44,44,1000000US270531080001009,"Block 1009, Block Group 1, Census Tract 1080, Hennepin County, Minnesota",146,136,3,1,2,0,1,3,146,138,129,3,1,2,0,1,2,8,7,0,0,0,0,0,1
270531080001008,76,East Isles,44,44,1000000US270531080001008,"Block 1008, Block Group 1, Census Tract 1080, Hennepin County, Minnesota",115,102,1,1,6,1,0,4,115,109,99,1,0,5,1,0,3,6,3,0,1,1,0,0,1
270531066003006,76,East Isles,44,44,1000000US270531066003006,"Block 3006, Block Group 3, Census Tract 1066, Hennepin County, Minnesota",55,51,0,0,3,0,0,1,55,54,50,0,0,3,0,0,1,1,1,0,0,0,0,0,0
270531066001003,76,East Isles,44,44,1000000US270531066001003,"Block 1003, Block Group 1, Census Tract 1066, Hennepin County, Minnesota",155,144,2,0,6,0,1,2,155,151,142,1,0,6,0,0,2,4,2,1,0,0,0,1,0
270531066002001,76,East Isles,44,44,1000000US270531066002001,"Block 2001, Block Group 2, Census Tract 1066, Hennepin County, Minnesota",92,83,3,1,3,0,1,1,92,92,83,3,1,3,0,1,1,0,0,0,0,0,0,0,0
270531066002000,76,East Isles,44,44,1000000US270531066002000,"Block 2000, Block Group 2, Census Tract 1066, Hennepin County, Minnesota",96,93,2,0,1,0,0,0,96,94,91,2,0,1,0,0,0,2,2,0,0,0,0,0,0
270531080001014,76,East Isles,44,44,1000000US270531080001014,"Block 1014, Block Group 1, Census Tract 1080, Hennepin County, Minnesota",112,105,1,0,2,0,1,3,112,109,103,1,0,2,0,0,3,3,2,0,0,0,0,1,0
270531080001011,76,East Isles,44,44,1000000US270531080001011,"Block 1011, Block Group 1, Census Tract 1080, Hennepin County, Minnesota",265,230,11,0,15,0,3,6,265,254,222,11,0,15,0,0,6,11,8,0,0,0,0,3,0
270531080001016,76,East Isles,44,44,1000000US270531080001016,"Block 1016, Block Group 1, Census Tract 1080, Hennepin County, Minnesota",43,39,1,1,1,0,1,0,43,42,39,1,1,1,0,0,0,1,0,0,0,0,0,1,0
270531080001015,76,East Isles,44,44,1000000US270531080001015,"Block 1015, Block Group 1, Census Tract 1080, Hennepin County, Minnesota",101,94,0,0,5,0,0,2,101,98,91,0,0,5,0,0,2,3,3,0,0,0,0,0,0
270531080001017,76,East Isles,44,44,1000000US270531080001017,"Block 1017, Block Group 1, Census Tract 1080, Hennepin County, Minnesota",0,0,0,0,0,0,0,0,0,0,0,0,0,0,0,0,0,0,0,0,0,0,0,0,0
270531066002003,76,East Isles,44,44,1000000US270531066002003,"Block 2003, Block Group 2, Census Tract 1066, Hennepin County, Minnesota",146,123,6,0,5,0,7,5,146,137,122,6,0,5,0,0,4,9,1,0,0,0,0,7,1
270531066002004,76,East Isles,44,44,1000000US270531066002004,"Block 2004, Block Group 2, Census Tract 1066, Hennepin County, Minnesota",213,206,0,0,4,0,2,1,213,210,204,0,0,4,0,1,1,3,2,0,0,0,0,1,0
270531080001007,76,East Isles,44,44,1000000US270531080001007,"Block 1007, Block Group 1, Census Tract 1080, Hennepin County, Minnesota",0,0,0,0,0,0,0,0,0,0,0,0,0,0,0,0,0,0,0,0,0,0,0,0,0
270531066001010,76,East Isles,44,44,1000000US270531066001010,"Block 1010, Block Group 1, Census Tract 1066, Hennepin County, Minnesota",56,47,0,0,7,0,0,2,56,56,47,0,0,7,0,0,2,0,0,0,0,0,0,0,0
270531066001002,76,East Isles,44,44,1000000US270531066001002,"Block 1002, Block Group 1, Census Tract 1066, Hennepin County, Minnesota",84,78,0,3,0,0,0,3,84,82,76,0,3,0,0,0,3,2,2,0,0,0,0,0,0
270531066001000,76,East Isles,44,44,1000000US270531066001000,"Block 1000, Block Group 1, Census Tract 1066, Hennepin County, Minnesota",28,16,9,0,1,0,1,1,28,25,15,8,0,1,0,0,1,3,1,1,0,0,0,1,0
270531066001006,76,East Isles,44,44,1000000US270531066001006,"Block 1006, Block Group 1, Census Tract 1066, Hennepin County, Minnesota",44,44,0,0,0,0,0,0,44,41,41,0,0,0,0,0,0,3,3,0,0,0,0,0,0
270531066001005,76,East Isles,44,44,1000000US270531066001005,"Block 1005, Block Group 1, Census Tract 1066, Hennepin County, Minnesota",111,101,2,0,3,0,1,4,111,105,96,2,0,3,0,0,4,6,5,0,0,0,0,1,0
270531066003013,76,East Isles,44,44,1000000US270531066003013,"Block 3013, Block Group 3, Census Tract 1066, Hennepin County, Minnesota",0,0,0,0,0,0,0,0,0,0,0,0,0,0,0,0,0,0,0,0,0,0,0,0,0
270531066001004,76,East Isles,44,44,1000000US270531066001004,"Block 1004, Block Group 1, Census Tract 1066, Hennepin County, Minnesota",86,77,1,0,2,0,2,4,86,83,76,1,0,2,0,0,4,3,1,0,0,0,0,2,0
270531066002002,76,East Isles,44,44,1000000US270531066002002,"Block 2002, Block Group 2, Census Tract 1066, Hennepin County, Minnesota",174,154,3,0,9,0,0,8,174,169,150,3,0,9,0,0,7,5,4,0,0,0,0,0,1
270531066003010,76,East Isles,44,44,1000000US270531066003010,"Block 3010, Block Group 3, Census Tract 1066, Hennepin County, Minnesota",91,87,0,0,0,0,1,3,91,90,87,0,0,0,0,0,3,1,0,0,0,0,0,1,0
270531080001010,76,East Isles,44,44,1000000US270531080001010,"Block 1010, Block Group 1, Census Tract 1080, Hennepin County, Minnesota",55,50,3,0,2,0,0,0,55,55,50,3,0,2,0,0,0,0,0,0,0,0,0,0,0
270531080001000,76,East Isles,44,44,1000000US270531080001000,"Block 1000, Block Group 1, Census Tract 1080, Hennepin County, Minnesota",0,0,0,0,0,0,0,0,0,0,0,0,0,0,0,0,0,0,0,0,0,0,0,0,0
270531066002007,76,East Isles,44,44,1000000US270531066002007,"Block 2007, Block Group 2, Census Tract 1066, Hennepin County, Minnesota",0,0,0,0,0,0,0,0,0,0,0,0,0,0,0,0,0,0,0,0,0,0,0,0,0
270531066003000,76,East Isles,44,44,1000000US270531066003000,"Block 3000, Block Group 3, Census Tract 1066, Hennepin County, Minnesota",105,94,2,0,4,0,2,3,105,101,91,2,0,4,0,2,2,4,3,0,0,0,0,0,1
270531066003005,76,East Isles,44,44,1000000US270531066003005,"Block 3005, Block Group 3, Census Tract 1066, Hennepin County, Minnesota",39,34,1,0,3,1,0,0,39,35,31,1,0,3,0,0,0,4,3,0,0,0,1,0,0
270531066003011,76,East Isles,44,44,1000000US270531066003011,"Block 3011, Block Group 3, Census Tract 1066, Hennepin County, Minnesota",34,34,0,0,0,0,0,0,34,33,33,0,0,0,0,0,0,1,1,0,0,0,0,0,0
270531080001002,76,East Isles,44,44,1000000US270531080001002,"Block 1002, Block Group 1, Census Tract 1080, Hennepin County, Minnesota",0,0,0,0,0,0,0,0,0,0,0,0,0,0,0,0,0,0,0,0,0,0,0,0,0
270531054001020,77,Elliot Park,33,33,1000000US270531054001020,"Block 1020, Block Group 1, Census Tract 1054, Hennepin County, Minnesota",361,293,6,0,49,0,0,13,361,352,287,6,0,49,0,0,10,9,6,0,0,0,0,0,3
270531054002006,77,Elliot Park,33,33,1000000US270531054002006,"Block 2006, Block Group 2, Census Tract 1054, Hennepin County, Minnesota",94,38,47,2,1,0,1,5,94,91,37,47,2,1,0,0,4,3,1,0,0,0,0,1,1
270530059012007,77,Elliot Park,33,33,1000000US270530059012007,"Block 2007, Block Group 2, Census Tract 59.01, Hennepin County, Minnesota",571,127,400,7,21,0,1,15,571,564,126,398,6,21,0,0,13,7,1,2,1,0,0,1,2
270530059012008,77,Elliot Park,33,33,1000000US270530059012008,"Block 2008, Block Group 2, Census Tract 59.01, Hennepin County, Minnesota",329,271,40,8,2,0,0,8,329,327,270,39,8,2,0,0,8,2,1,1,0,0,0,0,0
270531054001001,77,Elliot Park,33,33,1000000US270531054001001,"Block 1001, Block Group 1, Census Tract 1054, Hennepin County, Minnesota",0,0,0,0,0,0,0,0,0,0,0,0,0,0,0,0,0,0,0,0,0,0,0,0,0
270531054002005,77,Elliot Park,33,33,1000000US270531054002005,"Block 2005, Block Group 2, Census Tract 1054, Hennepin County, Minnesota",178,62,100,1,4,1,3,7,178,168,58,99,1,4,1,0,5,10,4,1,0,0,0,3,2
270530059011013,77,Elliot Park,33,33,1000000US270530059011013,"Block 1013, Block Group 1, Census Tract 59.01, Hennepin County, Minnesota",0,0,0,0,0,0,0,0,0,0,0,0,0,0,0,0,0,0,0,0,0,0,0,0,0
270531054001007,77,Elliot Park,33,33,1000000US270531054001007,"Block 1007, Block Group 1, Census Tract 1054, Hennepin County, Minnesota",255,69,108,24,25,1,4,24,255,243,67,106,24,25,1,0,20,12,2,2,0,0,0,4,4
270531054001016,77,Elliot Park,33,33,1000000US270531054001016,"Block 1016, Block Group 1, Census Tract 1054, Hennepin County, Minnesota",88,41,35,1,3,0,4,4,88,82,40,35,0,3,0,0,4,6,1,0,1,0,0,4,0
270531054001021,77,Elliot Park,33,33,1000000US270531054001021,"Block 1021, Block Group 1, Census Tract 1054, Hennepin County, Minnesota",465,391,20,1,33,1,1,18,465,452,379,20,1,33,1,0,18,13,12,0,0,0,0,1,0
270530059011005,77,Elliot Park,33,33,1000000US270530059011005,"Block 1005, Block Group 1, Census Tract 59.01, Hennepin County, Minnesota",0,0,0,0,0,0,0,0,0,0,0,0,0,0,0,0,0,0,0,0,0,0,0,0,0
270531054002010,77,Elliot Park,33,33,1000000US270531054002010,"Block 2010, Block Group 2, Census Tract 1054, Hennepin County, Minnesota",120,59,35,1,24,0,1,0,120,118,58,35,1,24,0,0,0,2,1,0,0,0,0,1,0
270530059011014,77,Elliot Park,33,33,1000000US270530059011014,"Block 1014, Block Group 1, Census Tract 59.01, Hennepin County, Minnesota",0,0,0,0,0,0,0,0,0,0,0,0,0,0,0,0,0,0,0,0,0,0,0,0,0
270531054002004,77,Elliot Park,33,33,1000000US270531054002004,"Block 2004, Block Group 2, Census Tract 1054, Hennepin County, Minnesota",86,20,61,1,0,0,1,3,86,81,18,59,1,0,0,0,3,5,2,2,0,0,0,1,0
270531054002007,77,Elliot Park,33,33,1000000US270531054002007,"Block 2007, Block Group 2, Census Tract 1054, Hennepin County, Minnesota",0,0,0,0,0,0,0,0,0,0,0,0,0,0,0,0,0,0,0,0,0,0,0,0,0
270530059011007,77,Elliot Park,33,33,1000000US270530059011007,"Block 1007, Block Group 1, Census Tract 59.01, Hennepin County, Minnesota",242,143,60,8,11,1,6,13,242,226,136,59,8,11,1,0,11,16,7,1,0,0,0,6,2
270531054001006,77,Elliot Park,33,33,1000000US270531054001006,"Block 1006, Block Group 1, Census Tract 1054, Hennepin County, Minnesota",0,0,0,0,0,0,0,0,0,0,0,0,0,0,0,0,0,0,0,0,0,0,0,0,0
270531054001012,77,Elliot Park,33,33,1000000US270531054001012,"Block 1012, Block Group 1, Census Tract 1054, Hennepin County, Minnesota",40,15,9,0,15,0,1,0,40,37,13,9,0,15,0,0,0,3,2,0,0,0,0,1,0
270531054001019,77,Elliot Park,33,33,1000000US270531054001019,"Block 1019, Block Group 1, Census Tract 1054, Hennepin County, Minnesota",123,84,32,0,5,0,0,2,123,119,80,32,0,5,0,0,2,4,4,0,0,0,0,0,0
270530059011002,77,Elliot Park,33,33,1000000US270530059011002,"Block 1002, Block Group 1, Census Tract 59.01, Hennepin County, Minnesota",343,46,256,17,11,0,3,10,343,338,44,256,17,11,0,2,8,5,2,0,0,0,0,1,2
270530059011008,77,Elliot Park,33,33,1000000US270530059011008,"Block 1008, Block Group 1, Census Tract 59.01, Hennepin County, Minnesota",223,64,128,15,0,1,2,13,223,214,61,126,14,0,1,1,11,9,3,2,1,0,0,1,2
270531054002000,77,Elliot Park,33,33,1000000US270531054002000,"Block 2000, Block Group 2, Census Tract 1054, Hennepin County, Minnesota",0,0,0,0,0,0,0,0,0,0,0,0,0,0,0,0,0,0,0,0,0,0,0,0,0
270530059011010,77,Elliot Park,33,33,1000000US270530059011010,"Block 1010, Block Group 1, Census Tract 59.01, Hennepin County, Minnesota",0,0,0,0,0,0,0,0,0,0,0,0,0,0,0,0,0,0,0,0,0,0,0,0,0
270531054001022,77,Elliot Park,33,33,1000000US270531054001022,"Block 1022, Block Group 1, Census Tract 1054, Hennepin County, Minnesota",67,62,0,1,3,0,1,0,67,65,61,0,1,3,0,0,0,2,1,0,0,0,0,1,0
270531054002001,77,Elliot Park,33,33,1000000US270531054002001,"Block 2001, Block Group 2, Census Tract 1054, Hennepin County, Minnesota",569,521,10,7,9,1,7,14,569,546,507,9,7,9,1,1,12,23,14,1,0,0,0,6,2
270531054001008,77,Elliot Park,33,33,1000000US270531054001008,"Block 1008, Block Group 1, Census Tract 1054, Hennepin County, Minnesota",255,110,130,1,3,0,4,7,255,240,100,129,1,3,0,1,6,15,10,1,0,0,0,3,1
270531054002011,77,Elliot Park,33,33,1000000US270531054002011,"Block 2011, Block Group 2, Census Tract 1054, Hennepin County, Minnesota",0,0,0,0,0,0,0,0,0,0,0,0,0,0,0,0,0,0,0,0,0,0,0,0,0
270531054001010,77,Elliot Park,33,33,1000000US270531054001010,"Block 1010, Block Group 1, Census Tract 1054, Hennepin County, Minnesota",189,65,98,1,6,1,4,14,189,181,63,96,1,6,1,0,14,8,2,2,0,0,0,4,0
270530059011004,77,Elliot Park,33,33,1000000US270530059011004,"Block 1004, Block Group 1, Census Tract 59.01, Hennepin County, Minnesota",170,1,161,2,0,2,4,0,170,166,1,161,2,0,2,0,0,4,0,0,0,0,0,4,0
270530059011003,77,Elliot Park,33,33,1000000US270530059011003,"Block 1003, Block Group 1, Census Tract 59.01, Hennepin County, Minnesota",202,87,73,7,5,0,25,5,202,161,73,73,7,5,0,0,3,41,14,0,0,0,0,25,2
270531054001003,77,Elliot Park,33,33,1000000US270531054001003,"Block 1003, Block Group 1, Census Tract 1054, Hennepin County, Minnesota",0,0,0,0,0,0,0,0,0,0,0,0,0,0,0,0,0,0,0,0,0,0,0,0,0
270531054001011,77,Elliot Park,33,33,1000000US270531054001011,"Block 1011, Block Group 1, Census Tract 1054, Hennepin County, Minnesota",66,45,19,0,2,0,0,0,66,66,45,19,0,2,0,0,0,0,0,0,0,0,0,0,0
270531054001002,77,Elliot Park,33,33,1000000US270531054001002,"Block 1002, Block Group 1, Census Tract 1054, Hennepin County, Minnesota",42,5,31,3,2,0,0,1,42,41,4,31,3,2,0,0,1,1,1,0,0,0,0,0,0
270531054001005,77,Elliot Park,33,33,1000000US270531054001005,"Block 1005, Block Group 1, Census Tract 1054, Hennepin County, Minnesota",0,0,0,0,0,0,0,0,0,0,0,0,0,0,0,0,0,0,0,0,0,0,0,0,0
270531054001015,77,Elliot Park,33,33,1000000US270531054001015,"Block 1015, Block Group 1, Census Tract 1054, Hennepin County, Minnesota",0,0,0,0,0,0,0,0,0,0,0,0,0,0,0,0,0,0,0,0,0,0,0,0,0
270530059011009,77,Elliot Park,33,33,1000000US270530059011009,"Block 1009, Block Group 1, Census Tract 59.01, Hennepin County, Minnesota",0,0,0,0,0,0,0,0,0,0,0,0,0,0,0,0,0,0,0,0,0,0,0,0,0
270531054002002,77,Elliot Park,33,33,1000000US270531054002002,"Block 2002, Block Group 2, Census Tract 1054, Hennepin County, Minnesota",0,0,0,0,0,0,0,0,0,0,0,0,0,0,0,0,0,0,0,0,0,0,0,0,0
270530059011001,77,Elliot Park,33,33,1000000US270530059011001,"Block 1001, Block Group 1, Census Tract 59.01, Hennepin County, Minnesota",127,43,65,4,5,0,1,9,127,120,42,65,3,5,0,0,5,7,1,0,1,0,0,1,4
270531054002012,77,Elliot Park,33,33,1000000US270531054002012,"Block 2012, Block Group 2, Census Tract 1054, Hennepin County, Minnesota",254,109,122,4,4,0,5,10,254,239,104,122,2,4,0,0,7,15,5,0,2,0,0,5,3
270530059011006,77,Elliot Park,33,33,1000000US270530059011006,"Block 1006, Block Group 1, Census Tract 59.01, Hennepin County, Minnesota",0,0,0,0,0,0,0,0,0,0,0,0,0,0,0,0,0,0,0,0,0,0,0,0,0
270530059011000,77,Elliot Park,33,33,1000000US270530059011000,"Block 1000, Block Group 1, Census Tract 59.01, Hennepin County, Minnesota",158,112,33,1,8,0,1,3,158,151,109,32,0,8,0,0,2,7,3,1,1,0,0,1,1
270530059011011,77,Elliot Park,33,33,1000000US270530059011011,"Block 1011, Block Group 1, Census Tract 59.01, Hennepin County, Minnesota",0,0,0,0,0,0,0,0,0,0,0,0,0,0,0,0,0,0,0,0,0,0,0,0,0
270530059012012,77,Elliot Park,33,33,1000000US270530059012012,"Block 2012, Block Group 2, Census Tract 59.01, Hennepin County, Minnesota",0,0,0,0,0,0,0,0,0,0,0,0,0,0,0,0,0,0,0,0,0,0,0,0,0
270530059012001,77,Elliot Park,33,33,1000000US270530059012001,"Block 2001, Block Group 2, Census Tract 59.01, Hennepin County, Minnesota",4,0,1,0,3,0,0,0,4,3,0,0,0,3,0,0,0,1,0,1,0,0,0,0,0
270530059012005,77,Elliot Park,33,33,1000000US270530059012005,"Block 2005, Block Group 2, Census Tract 59.01, Hennepin County, Minnesota",333,227,71,9,13,0,4,9,333,326,225,70,9,13,0,0,9,7,2,1,0,0,0,4,0
270530059012003,77,Elliot Park,33,33,1000000US270530059012003,"Block 2003, Block Group 2, Census Tract 59.01, Hennepin County, Minnesota",191,65,102,8,3,0,0,13,191,190,65,102,7,3,0,0,13,1,0,0,1,0,0,0,0
270530059012006,77,Elliot Park,33,33,1000000US270530059012006,"Block 2006, Block Group 2, Census Tract 59.01, Hennepin County, Minnesota",0,0,0,0,0,0,0,0,0,0,0,0,0,0,0,0,0,0,0,0,0,0,0,0,0
270530059012009,77,Elliot Park,33,33,1000000US270530059012009,"Block 2009, Block Group 2, Census Tract 59.01, Hennepin County, Minnesota",273,242,18,3,10,0,0,0,273,273,242,18,3,10,0,0,0,0,0,0,0,0,0,0,0
270531054001017,77,Elliot Park,33,33,1000000US270531054001017,"Block 1017, Block Group 1, Census Tract 1054, Hennepin County, Minnesota",0,0,0,0,0,0,0,0,0,0,0,0,0,0,0,0,0,0,0,0,0,0,0,0,0
270531054001014,77,Elliot Park,33,33,1000000US270531054001014,"Block 1014, Block Group 1, Census Tract 1054, Hennepin County, Minnesota",0,0,0,0,0,0,0,0,0,0,0,0,0,0,0,0,0,0,0,0,0,0,0,0,0
270530059012002,77,Elliot Park,33,33,1000000US270530059012002,"Block 2002, Block Group 2, Census Tract 59.01, Hennepin County, Minnesota",0,0,0,0,0,0,0,0,0,0,0,0,0,0,0,0,0,0,0,0,0,0,0,0,0
270530059012000,77,Elliot Park,33,33,1000000US270530059012000,"Block 2000, Block Group 2, Census Tract 59.01, Hennepin County, Minnesota",0,0,0,0,0,0,0,0,0,0,0,0,0,0,0,0,0,0,0,0,0,0,0,0,0
270531048002005,77,Elliot Park,33,33,1000000US270531048002005,"Block 2005, Block Group 2, Census Tract 1048, Hennepin County, Minnesota",0,0,0,0,0,0,0,0,0,0,0,0,0,0,0,0,0,0,0,0,0,0,0,0,0
270531048002004,77,Elliot Park,33,33,1000000US270531048002004,"Block 2004, Block Group 2, Census Tract 1048, Hennepin County, Minnesota",0,0,0,0,0,0,0,0,0,0,0,0,0,0,0,0,0,0,0,0,0,0,0,0,0
270530059012004,77,Elliot Park,33,33,1000000US270530059012004,"Block 2004, Block Group 2, Census Tract 59.01, Hennepin County, Minnesota",0,0,0,0,0,0,0,0,0,0,0,0,0,0,0,0,0,0,0,0,0,0,0,0,0
270531054001009,77,Elliot Park,33,33,1000000US270531054001009,"Block 1009, Block Group 1, Census Tract 1054, Hennepin County, Minnesota",0,0,0,0,0,0,0,0,0,0,0,0,0,0,0,0,0,0,0,0,0,0,0,0,0
270531054002009,77,Elliot Park,33,33,1000000US270531054002009,"Block 2009, Block Group 2, Census Tract 1054, Hennepin County, Minnesota",0,0,0,0,0,0,0,0,0,0,0,0,0,0,0,0,0,0,0,0,0,0,0,0,0
270531054002003,77,Elliot Park,33,33,1000000US270531054002003,"Block 2003, Block Group 2, Census Tract 1054, Hennepin County, Minnesota",193,168,6,1,0,1,7,10,193,179,164,5,1,0,1,0,8,14,4,1,0,0,0,7,2
270530059012010,77,Elliot Park,33,33,1000000US270530059012010,"Block 2010, Block Group 2, Census Tract 59.01, Hennepin County, Minnesota",0,0,0,0,0,0,0,0,0,0,0,0,0,0,0,0,0,0,0,0,0,0,0,0,0
270530059012011,77,Elliot Park,33,33,1000000US270530059012011,"Block 2011, Block Group 2, Census Tract 59.01, Hennepin County, Minnesota",0,0,0,0,0,0,0,0,0,0,0,0,0,0,0,0,0,0,0,0,0,0,0,0,0
270531054001004,77,Elliot Park,33,33,1000000US270531054001004,"Block 1004, Block Group 1, Census Tract 1054, Hennepin County, Minnesota",0,0,0,0,0,0,0,0,0,0,0,0,0,0,0,0,0,0,0,0,0,0,0,0,0
270531054001013,77,Elliot Park,33,33,1000000US270531054001013,"Block 1013, Block Group 1, Census Tract 1054, Hennepin County, Minnesota",20,8,11,0,1,0,0,0,20,20,8,11,0,1,0,0,0,0,0,0,0,0,0,0,0
270531054001018,77,Elliot Park,33,33,1000000US270531054001018,"Block 1018, Block Group 1, Census Tract 1054, Hennepin County, Minnesota",0,0,0,0,0,0,0,0,0,0,0,0,0,0,0,0,0,0,0,0,0,0,0,0,0
270530059011012,77,Elliot Park,33,33,1000000US270530059011012,"Block 1012, Block Group 1, Census Tract 59.01, Hennepin County, Minnesota",0,0,0,0,0,0,0,0,0,0,0,0,0,0,0,0,0,0,0,0,0,0,0,0,0
270531054002008,77,Elliot Park,33,33,1000000US270531054002008,"Block 2008, Block Group 2, Census Tract 1054, Hennepin County, Minnesota",62,39,15,2,5,0,0,1,62,59,39,14,2,4,0,0,0,3,0,1,0,1,0,0,1
270531036002002,78,Nicollet Island - East Bank,34,34,1000000US270531036002002,"Block 2002, Block Group 2, Census Tract 1036, Hennepin County, Minnesota",51,46,0,1,2,0,0,2,51,49,45,0,1,2,0,0,1,2,1,0,0,0,0,0,1
270531036002041,78,Nicollet Island - East Bank,34,34,1000000US270531036002041,"Block 2041, Block Group 2, Census Tract 1036, Hennepin County, Minnesota",0,0,0,0,0,0,0,0,0,0,0,0,0,0,0,0,0,0,0,0,0,0,0,0,0
270531036002033,78,Nicollet Island - East Bank,34,34,1000000US270531036002033,"Block 2033, Block Group 2, Census Tract 1036, Hennepin County, Minnesota",0,0,0,0,0,0,0,0,0,0,0,0,0,0,0,0,0,0,0,0,0,0,0,0,0
270531036002014,78,Nicollet Island - East Bank,34,34,1000000US270531036002014,"Block 2014, Block Group 2, Census Tract 1036, Hennepin County, Minnesota",23,21,2,0,0,0,0,0,23,22,20,2,0,0,0,0,0,1,1,0,0,0,0,0,0
270531036002000,78,Nicollet Island - East Bank,34,34,1000000US270531036002000,"Block 2000, Block Group 2, Census Tract 1036, Hennepin County, Minnesota",0,0,0,0,0,0,0,0,0,0,0,0,0,0,0,0,0,0,0,0,0,0,0,0,0
270531036002021,78,Nicollet Island - East Bank,34,34,1000000US270531036002021,"Block 2021, Block Group 2, Census Tract 1036, Hennepin County, Minnesota",121,103,6,0,8,0,0,4,121,118,100,6,0,8,0,0,4,3,3,0,0,0,0,0,0
270531036002044,78,Nicollet Island - East Bank,34,34,1000000US270531036002044,"Block 2044, Block Group 2, Census Tract 1036, Hennepin County, Minnesota",0,0,0,0,0,0,0,0,0,0,0,0,0,0,0,0,0,0,0,0,0,0,0,0,0
270531036002043,78,Nicollet Island - East Bank,34,34,1000000US270531036002043,"Block 2043, Block Group 2, Census Tract 1036, Hennepin County, Minnesota",0,0,0,0,0,0,0,0,0,0,0,0,0,0,0,0,0,0,0,0,0,0,0,0,0
270531036002008,78,Nicollet Island - East Bank,34,34,1000000US270531036002008,"Block 2008, Block Group 2, Census Tract 1036, Hennepin County, Minnesota",0,0,0,0,0,0,0,0,0,0,0,0,0,0,0,0,0,0,0,0,0,0,0,0,0
270531036002029,78,Nicollet Island - East Bank,34,34,1000000US270531036002029,"Block 2029, Block Group 2, Census Tract 1036, Hennepin County, Minnesota",0,0,0,0,0,0,0,0,0,0,0,0,0,0,0,0,0,0,0,0,0,0,0,0,0
270531036002034,78,Nicollet Island - East Bank,34,34,1000000US270531036002034,"Block 2034, Block Group 2, Census Tract 1036, Hennepin County, Minnesota",207,186,6,1,12,0,0,2,207,202,181,6,1,12,0,0,2,5,5,0,0,0,0,0,0
270531036002025,78,Nicollet Island - East Bank,34,34,1000000US270531036002025,"Block 2025, Block Group 2, Census Tract 1036, Hennepin County, Minnesota",48,46,0,0,0,0,0,2,48,44,42,0,0,0,0,0,2,4,4,0,0,0,0,0,0
270531036002026,78,Nicollet Island - East Bank,34,34,1000000US270531036002026,"Block 2026, Block Group 2, Census Tract 1036, Hennepin County, Minnesota",0,0,0,0,0,0,0,0,0,0,0,0,0,0,0,0,0,0,0,0,0,0,0,0,0
270531036002007,78,Nicollet Island - East Bank,34,34,1000000US270531036002007,"Block 2007, Block Group 2, Census Tract 1036, Hennepin County, Minnesota",0,0,0,0,0,0,0,0,0,0,0,0,0,0,0,0,0,0,0,0,0,0,0,0,0
270531036002013,78,Nicollet Island - East Bank,34,34,1000000US270531036002013,"Block 2013, Block Group 2, Census Tract 1036, Hennepin County, Minnesota",24,20,0,0,0,0,2,2,24,23,19,0,0,0,0,2,2,1,1,0,0,0,0,0,0
270531036002040,78,Nicollet Island - East Bank,34,34,1000000US270531036002040,"Block 2040, Block Group 2, Census Tract 1036, Hennepin County, Minnesota",0,0,0,0,0,0,0,0,0,0,0,0,0,0,0,0,0,0,0,0,0,0,0,0,0
270531036002012,78,Nicollet Island - East Bank,34,34,1000000US270531036002012,"Block 2012, Block Group 2, Census Tract 1036, Hennepin County, Minnesota",16,16,0,0,0,0,0,0,16,16,16,0,0,0,0,0,0,0,0,0,0,0,0,0,0
270531036002024,78,Nicollet Island - East Bank,34,34,1000000US270531036002024,"Block 2024, Block Group 2, Census Tract 1036, Hennepin County, Minnesota",0,0,0,0,0,0,0,0,0,0,0,0,0,0,0,0,0,0,0,0,0,0,0,0,0
270531036002010,78,Nicollet Island - East Bank,34,34,1000000US270531036002010,"Block 2010, Block Group 2, Census Tract 1036, Hennepin County, Minnesota",0,0,0,0,0,0,0,0,0,0,0,0,0,0,0,0,0,0,0,0,0,0,0,0,0
270531036002037,78,Nicollet Island - East Bank,34,34,1000000US270531036002037,"Block 2037, Block Group 2, Census Tract 1036, Hennepin County, Minnesota",0,0,0,0,0,0,0,0,0,0,0,0,0,0,0,0,0,0,0,0,0,0,0,0,0
270531036002006,78,Nicollet Island - East Bank,34,34,1000000US270531036002006,"Block 2006, Block Group 2, Census Tract 1036, Hennepin County, Minnesota",192,181,2,0,7,0,0,2,192,189,178,2,0,7,0,0,2,3,3,0,0,0,0,0,0
270531036002004,78,Nicollet Island - East Bank,34,34,1000000US270531036002004,"Block 2004, Block Group 2, Census Tract 1036, Hennepin County, Minnesota",0,0,0,0,0,0,0,0,0,0,0,0,0,0,0,0,0,0,0,0,0,0,0,0,0
270531036002017,78,Nicollet Island - East Bank,34,34,1000000US270531036002017,"Block 2017, Block Group 2, Census Tract 1036, Hennepin County, Minnesota",1,1,0,0,0,0,0,0,1,1,1,0,0,0,0,0,0,0,0,0,0,0,0,0,0
270531036002022,78,Nicollet Island - East Bank,34,34,1000000US270531036002022,"Block 2022, Block Group 2, Census Tract 1036, Hennepin County, Minnesota",2,2,0,0,0,0,0,0,2,2,2,0,0,0,0,0,0,0,0,0,0,0,0,0,0
270531036002001,78,Nicollet Island - East Bank,34,34,1000000US270531036002001,"Block 2001, Block Group 2, Census Tract 1036, Hennepin County, Minnesota",0,0,0,0,0,0,0,0,0,0,0,0,0,0,0,0,0,0,0,0,0,0,0,0,0
270531036002003,78,Nicollet Island - East Bank,34,34,1000000US270531036002003,"Block 2003, Block Group 2, Census Tract 1036, Hennepin County, Minnesota",0,0,0,0,0,0,0,0,0,0,0,0,0,0,0,0,0,0,0,0,0,0,0,0,0
270531036002015,78,Nicollet Island - East Bank,34,34,1000000US270531036002015,"Block 2015, Block Group 2, Census Tract 1036, Hennepin County, Minnesota",391,294,49,2,21,0,6,19,391,370,283,49,2,21,0,0,15,21,11,0,0,0,0,6,4
270531036002005,78,Nicollet Island - East Bank,34,34,1000000US270531036002005,"Block 2005, Block Group 2, Census Tract 1036, Hennepin County, Minnesota",87,81,0,0,4,0,0,2,87,83,77,0,0,4,0,0,2,4,4,0,0,0,0,0,0
270531036002018,78,Nicollet Island - East Bank,34,34,1000000US270531036002018,"Block 2018, Block Group 2, Census Tract 1036, Hennepin County, Minnesota",34,34,0,0,0,0,0,0,34,33,33,0,0,0,0,0,0,1,1,0,0,0,0,0,0
270531036002016,78,Nicollet Island - East Bank,34,34,1000000US270531036002016,"Block 2016, Block Group 2, Census Tract 1036, Hennepin County, Minnesota",0,0,0,0,0,0,0,0,0,0,0,0,0,0,0,0,0,0,0,0,0,0,0,0,0
270531036002027,78,Nicollet Island - East Bank,34,34,1000000US270531036002027,"Block 2027, Block Group 2, Census Tract 1036, Hennepin County, Minnesota",6,5,1,0,0,0,0,0,6,6,5,1,0,0,0,0,0,0,0,0,0,0,0,0,0
270531036002038,78,Nicollet Island - East Bank,34,34,1000000US270531036002038,"Block 2038, Block Group 2, Census Tract 1036, Hennepin County, Minnesota",0,0,0,0,0,0,0,0,0,0,0,0,0,0,0,0,0,0,0,0,0,0,0,0,0
270531036002011,78,Nicollet Island - East Bank,34,34,1000000US270531036002011,"Block 2011, Block Group 2, Census Tract 1036, Hennepin County, Minnesota",34,32,0,0,0,0,2,0,34,33,32,0,0,0,0,1,0,1,0,0,0,0,0,1,0
270531036002039,78,Nicollet Island - East Bank,34,34,1000000US270531036002039,"Block 2039, Block Group 2, Census Tract 1036, Hennepin County, Minnesota",0,0,0,0,0,0,0,0,0,0,0,0,0,0,0,0,0,0,0,0,0,0,0,0,0
270531036002030,78,Nicollet Island - East Bank,34,34,1000000US270531036002030,"Block 2030, Block Group 2, Census Tract 1036, Hennepin County, Minnesota",0,0,0,0,0,0,0,0,0,0,0,0,0,0,0,0,0,0,0,0,0,0,0,0,0
270531036002032,78,Nicollet Island - East Bank,34,34,1000000US270531036002032,"Block 2032, Block Group 2, Census Tract 1036, Hennepin County, Minnesota",0,0,0,0,0,0,0,0,0,0,0,0,0,0,0,0,0,0,0,0,0,0,0,0,0
270531036002036,78,Nicollet Island - East Bank,34,34,1000000US270531036002036,"Block 2036, Block Group 2, Census Tract 1036, Hennepin County, Minnesota",0,0,0,0,0,0,0,0,0,0,0,0,0,0,0,0,0,0,0,0,0,0,0,0,0
270531036002019,78,Nicollet Island - East Bank,34,34,1000000US270531036002019,"Block 2019, Block Group 2, Census Tract 1036, Hennepin County, Minnesota",4,3,0,1,0,0,0,0,4,4,3,0,1,0,0,0,0,0,0,0,0,0,0,0,0
270531036002023,78,Nicollet Island - East Bank,34,34,1000000US270531036002023,"Block 2023, Block Group 2, Census Tract 1036, Hennepin County, Minnesota",0,0,0,0,0,0,0,0,0,0,0,0,0,0,0,0,0,0,0,0,0,0,0,0,0
270531036002028,78,Nicollet Island - East Bank,34,34,1000000US270531036002028,"Block 2028, Block Group 2, Census Tract 1036, Hennepin County, Minnesota",0,0,0,0,0,0,0,0,0,0,0,0,0,0,0,0,0,0,0,0,0,0,0,0,0
270531036002035,78,Nicollet Island - East Bank,34,34,1000000US270531036002035,"Block 2035, Block Group 2, Census Tract 1036, Hennepin County, Minnesota",9,7,2,0,0,0,0,0,9,9,7,2,0,0,0,0,0,0,0,0,0,0,0,0,0
270531036002020,78,Nicollet Island - East Bank,34,34,1000000US270531036002020,"Block 2020, Block Group 2, Census Tract 1036, Hennepin County, Minnesota",59,56,1,0,1,0,1,0,59,57,55,1,0,1,0,0,0,2,1,0,0,0,0,1,0
270531036002009,78,Nicollet Island - East Bank,34,34,1000000US270531036002009,"Block 2009, Block Group 2, Census Tract 1036, Hennepin County, Minnesota",0,0,0,0,0,0,0,0,0,0,0,0,0,0,0,0,0,0,0,0,0,0,0,0,0
270531036002031,78,Nicollet Island - East Bank,34,34,1000000US270531036002031,"Block 2031, Block Group 2, Census Tract 1036, Hennepin County, Minnesota",0,0,0,0,0,0,0,0,0,0,0,0,0,0,0,0,0,0,0,0,0,0,0,0,0
270531036002042,78,Nicollet Island - East Bank,34,34,1000000US270531036002042,"Block 2042, Block Group 2, Census Tract 1036, Hennepin County, Minnesota",0,0,0,0,0,0,0,0,0,0,0,0,0,0,0,0,0,0,0,0,0,0,0,0,0
270531037001009,79,Marcy Holmes,35,35,1000000US270531037001009,"Block 1009, Block Group 1, Census Tract 1037, Hennepin County, Minnesota",374,275,18,8,52,0,8,13,374,358,269,18,8,52,0,0,11,16,6,0,0,0,0,8,2
270531037001012,79,Marcy Holmes,35,35,1000000US270531037001012,"Block 1012, Block Group 1, Census Tract 1037, Hennepin County, Minnesota",0,0,0,0,0,0,0,0,0,0,0,0,0,0,0,0,0,0,0,0,0,0,0,0,0
270531037003011,79,Marcy Holmes,35,35,1000000US270531037003011,"Block 3011, Block Group 3, Census Tract 1037, Hennepin County, Minnesota",0,0,0,0,0,0,0,0,0,0,0,0,0,0,0,0,0,0,0,0,0,0,0,0,0
270531037002005,79,Marcy Holmes,35,35,1000000US270531037002005,"Block 2005, Block Group 2, Census Tract 1037, Hennepin County, Minnesota",23,19,0,0,3,0,0,1,23,23,19,0,0,3,0,0,1,0,0,0,0,0,0,0,0
270531037001003,79,Marcy Holmes,35,35,1000000US270531037001003,"Block 1003, Block Group 1, Census Tract 1037, Hennepin County, Minnesota",0,0,0,0,0,0,0,0,0,0,0,0,0,0,0,0,0,0,0,0,0,0,0,0,0
270531037001001,79,Marcy Holmes,35,35,1000000US270531037001001,"Block 1001, Block Group 1, Census Tract 1037, Hennepin County, Minnesota",0,0,0,0,0,0,0,0,0,0,0,0,0,0,0,0,0,0,0,0,0,0,0,0,0
270531037003019,79,Marcy Holmes,35,35,1000000US270531037003019,"Block 3019, Block Group 3, Census Tract 1037, Hennepin County, Minnesota",0,0,0,0,0,0,0,0,0,0,0,0,0,0,0,0,0,0,0,0,0,0,0,0,0
270530038003007,79,Marcy Holmes,35,35,1000000US270530038003007,"Block 3007, Block Group 3, Census Tract 38, Hennepin County, Minnesota",49,32,4,0,11,0,0,2,49,49,32,4,0,11,0,0,2,0,0,0,0,0,0,0,0
270531037001006,79,Marcy Holmes,35,35,1000000US270531037001006,"Block 1006, Block Group 1, Census Tract 1037, Hennepin County, Minnesota",54,33,0,0,18,0,3,0,54,49,31,0,0,18,0,0,0,5,2,0,0,0,0,3,0
270530038003009,79,Marcy Holmes,35,35,1000000US270530038003009,"Block 3009, Block Group 3, Census Tract 38, Hennepin County, Minnesota",331,283,12,3,16,0,2,15,331,317,274,12,3,16,0,0,12,14,9,0,0,0,0,2,3
270530038001004,79,Marcy Holmes,35,35,1000000US270530038001004,"Block 1004, Block Group 1, Census Tract 38, Hennepin County, Minnesota",151,82,14,13,26,0,12,4,151,120,71,12,7,26,0,0,4,31,11,2,6,0,0,12,0
270530038003000,79,Marcy Holmes,35,35,1000000US270530038003000,"Block 3000, Block Group 3, Census Tract 38, Hennepin County, Minnesota",17,14,0,0,2,0,0,1,17,17,14,0,0,2,0,0,1,0,0,0,0,0,0,0,0
270530038002014,79,Marcy Holmes,35,35,1000000US270530038002014,"Block 2014, Block Group 2, Census Tract 38, Hennepin County, Minnesota",156,123,3,1,21,0,1,7,156,146,115,3,0,21,0,0,7,10,8,0,1,0,0,1,0
270530038002005,79,Marcy Holmes,35,35,1000000US270530038002005,"Block 2005, Block Group 2, Census Tract 38, Hennepin County, Minnesota",371,312,8,2,43,0,1,5,371,368,310,8,2,43,0,0,5,3,2,0,0,0,0,1,0
270530038002006,79,Marcy Holmes,35,35,1000000US270530038002006,"Block 2006, Block Group 2, Census Tract 38, Hennepin County, Minnesota",106,64,3,2,33,0,0,4,106,106,64,3,2,33,0,0,4,0,0,0,0,0,0,0,0
270531039001005,79,Marcy Holmes,35,35,1000000US270531039001005,"Block 1005, Block Group 1, Census Tract 1039, Hennepin County, Minnesota",351,309,10,0,23,1,1,7,351,347,306,10,0,23,1,0,7,4,3,0,0,0,0,1,0
270531037003002,79,Marcy Holmes,35,35,1000000US270531037003002,"Block 3002, Block Group 3, Census Tract 1037, Hennepin County, Minnesota",132,84,10,0,23,0,11,4,132,120,83,10,0,23,0,0,4,12,1,0,0,0,0,11,0
270530038003005,79,Marcy Holmes,35,35,1000000US270530038003005,"Block 3005, Block Group 3, Census Tract 38, Hennepin County, Minnesota",0,0,0,0,0,0,0,0,0,0,0,0,0,0,0,0,0,0,0,0,0,0,0,0,0
270530038003006,79,Marcy Holmes,35,35,1000000US270530038003006,"Block 3006, Block Group 3, Census Tract 38, Hennepin County, Minnesota",178,120,5,3,43,1,1,5,178,172,118,5,1,42,1,1,4,6,2,0,2,1,0,0,1
270531037001004,79,Marcy Holmes,35,35,1000000US270531037001004,"Block 1004, Block Group 1, Census Tract 1037, Hennepin County, Minnesota",0,0,0,0,0,0,0,0,0,0,0,0,0,0,0,0,0,0,0,0,0,0,0,0,0
270531037001000,79,Marcy Holmes,35,35,1000000US270531037001000,"Block 1000, Block Group 1, Census Tract 1037, Hennepin County, Minnesota",0,0,0,0,0,0,0,0,0,0,0,0,0,0,0,0,0,0,0,0,0,0,0,0,0
270531037001008,79,Marcy Holmes,35,35,1000000US270531037001008,"Block 1008, Block Group 1, Census Tract 1037, Hennepin County, Minnesota",73,65,0,0,7,0,0,1,73,71,64,0,0,7,0,0,0,2,1,0,0,0,0,0,1
270530038003011,79,Marcy Holmes,35,35,1000000US270530038003011,"Block 3011, Block Group 3, Census Tract 38, Hennepin County, Minnesota",0,0,0,0,0,0,0,0,0,0,0,0,0,0,0,0,0,0,0,0,0,0,0,0,0
270530038002018,79,Marcy Holmes,35,35,1000000US270530038002018,"Block 2018, Block Group 2, Census Tract 38, Hennepin County, Minnesota",2,2,0,0,0,0,0,0,2,2,2,0,0,0,0,0,0,0,0,0,0,0,0,0,0
270531037001005,79,Marcy Holmes,35,35,1000000US270531037001005,"Block 1005, Block Group 1, Census Tract 1037, Hennepin County, Minnesota",182,151,5,3,19,0,1,3,182,178,148,5,3,19,0,0,3,4,3,0,0,0,0,1,0
270531037002003,79,Marcy Holmes,35,35,1000000US270531037002003,"Block 2003, Block Group 2, Census Tract 1037, Hennepin County, Minnesota",78,59,8,1,6,0,0,4,78,76,59,8,1,6,0,0,2,2,0,0,0,0,0,0,2
270531037002009,79,Marcy Holmes,35,35,1000000US270531037002009,"Block 2009, Block Group 2, Census Tract 1037, Hennepin County, Minnesota",90,58,8,4,15,0,5,0,90,80,52,8,4,15,0,1,0,10,6,0,0,0,0,4,0
270531037003016,79,Marcy Holmes,35,35,1000000US270531037003016,"Block 3016, Block Group 3, Census Tract 1037, Hennepin County, Minnesota",0,0,0,0,0,0,0,0,0,0,0,0,0,0,0,0,0,0,0,0,0,0,0,0,0
270530038002019,79,Marcy Holmes,35,35,1000000US270530038002019,"Block 2019, Block Group 2, Census Tract 38, Hennepin County, Minnesota",0,0,0,0,0,0,0,0,0,0,0,0,0,0,0,0,0,0,0,0,0,0,0,0,0
270531037001002,79,Marcy Holmes,35,35,1000000US270531037001002,"Block 1002, Block Group 1, Census Tract 1037, Hennepin County, Minnesota",1,0,0,0,0,0,1,0,1,0,0,0,0,0,0,0,0,1,0,0,0,0,0,1,0
270531037001011,79,Marcy Holmes,35,35,1000000US270531037001011,"Block 1011, Block Group 1, Census Tract 1037, Hennepin County, Minnesota",13,13,0,0,0,0,0,0,13,13,13,0,0,0,0,0,0,0,0,0,0,0,0,0,0
270531037002004,79,Marcy Holmes,35,35,1000000US270531037002004,"Block 2004, Block Group 2, Census Tract 1037, Hennepin County, Minnesota",178,131,9,1,33,0,0,4,178,176,129,9,1,33,0,0,4,2,2,0,0,0,0,0,0
270531037003013,79,Marcy Holmes,35,35,1000000US270531037003013,"Block 3013, Block Group 3, Census Tract 1037, Hennepin County, Minnesota",0,0,0,0,0,0,0,0,0,0,0,0,0,0,0,0,0,0,0,0,0,0,0,0,0
270531037003003,79,Marcy Holmes,35,35,1000000US270531037003003,"Block 3003, Block Group 3, Census Tract 1037, Hennepin County, Minnesota",184,96,70,4,0,0,0,14,184,181,94,70,4,0,0,0,13,3,2,0,0,0,0,0,1
270530038002010,79,Marcy Holmes,35,35,1000000US270530038002010,"Block 2010, Block Group 2, Census Tract 38, Hennepin County, Minnesota",187,159,6,1,8,0,3,10,187,183,158,6,1,8,0,1,9,4,1,0,0,0,0,2,1
270530038002011,79,Marcy Holmes,35,35,1000000US270530038002011,"Block 2011, Block Group 2, Census Tract 38, Hennepin County, Minnesota",186,139,27,1,13,1,0,5,186,181,136,26,1,13,0,0,5,5,3,1,0,0,1,0,0
270531039001001,79,Marcy Holmes,35,35,1000000US270531039001001,"Block 1001, Block Group 1, Census Tract 1039, Hennepin County, Minnesota",141,127,3,1,6,0,0,4,141,136,124,2,1,5,0,0,4,5,3,1,0,1,0,0,0
270531039002000,79,Marcy Holmes,35,35,1000000US270531039002000,"Block 2000, Block Group 2, Census Tract 1039, Hennepin County, Minnesota",244,183,3,0,53,1,1,3,244,240,180,3,0,53,1,0,3,4,3,0,0,0,0,1,0
270530038001000,79,Marcy Holmes,35,35,1000000US270530038001000,"Block 1000, Block Group 1, Census Tract 38, Hennepin County, Minnesota",67,62,2,0,2,0,1,0,67,64,60,2,0,2,0,0,0,3,2,0,0,0,0,1,0
270530038003002,79,Marcy Holmes,35,35,1000000US270530038003002,"Block 3002, Block Group 3, Census Tract 38, Hennepin County, Minnesota",186,134,9,0,37,0,2,4,186,170,122,8,0,36,0,0,4,16,12,1,0,1,0,2,0
270530038002017,79,Marcy Holmes,35,35,1000000US270530038002017,"Block 2017, Block Group 2, Census Tract 38, Hennepin County, Minnesota",54,45,0,0,6,0,2,1,54,52,45,0,0,6,0,0,1,2,0,0,0,0,0,2,0
270530038002020,79,Marcy Holmes,35,35,1000000US270530038002020,"Block 2020, Block Group 2, Census Tract 38, Hennepin County, Minnesota",0,0,0,0,0,0,0,0,0,0,0,0,0,0,0,0,0,0,0,0,0,0,0,0,0
270531039002001,79,Marcy Holmes,35,35,1000000US270531039002001,"Block 2001, Block Group 2, Census Tract 1039, Hennepin County, Minnesota",57,47,0,0,6,1,0,3,57,56,47,0,0,5,1,0,3,1,0,0,0,1,0,0,0
270530038001003,79,Marcy Holmes,35,35,1000000US270530038001003,"Block 1003, Block Group 1, Census Tract 38, Hennepin County, Minnesota",66,62,0,0,3,0,0,1,66,64,60,0,0,3,0,0,1,2,2,0,0,0,0,0,0
270531049005016,79,Marcy Holmes,35,35,1000000US270531049005016,"Block 5016, Block Group 5, Census Tract 1049, Hennepin County, Minnesota",0,0,0,0,0,0,0,0,0,0,0,0,0,0,0,0,0,0,0,0,0,0,0,0,0
270530038002013,79,Marcy Holmes,35,35,1000000US270530038002013,"Block 2013, Block Group 2, Census Tract 38, Hennepin County, Minnesota",88,87,0,0,1,0,0,0,88,87,86,0,0,1,0,0,0,1,1,0,0,0,0,0,0
270530038002000,79,Marcy Holmes,35,35,1000000US270530038002000,"Block 2000, Block Group 2, Census Tract 38, Hennepin County, Minnesota",0,0,0,0,0,0,0,0,0,0,0,0,0,0,0,0,0,0,0,0,0,0,0,0,0
270530038002009,79,Marcy Holmes,35,35,1000000US270530038002009,"Block 2009, Block Group 2, Census Tract 38, Hennepin County, Minnesota",65,33,4,1,25,0,0,2,65,61,29,4,1,25,0,0,2,4,4,0,0,0,0,0,0
270531039002007,79,Marcy Holmes,35,35,1000000US270531039002007,"Block 2007, Block Group 2, Census Tract 1039, Hennepin County, Minnesota",0,0,0,0,0,0,0,0,0,0,0,0,0,0,0,0,0,0,0,0,0,0,0,0,0
270530038001006,79,Marcy Holmes,35,35,1000000US270530038001006,"Block 1006, Block Group 1, Census Tract 38, Hennepin County, Minnesota",108,89,8,0,11,0,0,0,108,96,77,8,0,11,0,0,0,12,12,0,0,0,0,0,0
270530038001010,79,Marcy Holmes,35,35,1000000US270530038001010,"Block 1010, Block Group 1, Census Tract 38, Hennepin County, Minnesota",67,53,0,0,10,0,1,3,67,63,52,0,0,10,0,0,1,4,1,0,0,0,0,1,2
270531049005017,79,Marcy Holmes,35,35,1000000US270531049005017,"Block 5017, Block Group 5, Census Tract 1049, Hennepin County, Minnesota",0,0,0,0,0,0,0,0,0,0,0,0,0,0,0,0,0,0,0,0,0,0,0,0,0
270531039001004,79,Marcy Holmes,35,35,1000000US270531039001004,"Block 1004, Block Group 1, Census Tract 1039, Hennepin County, Minnesota",192,159,8,1,8,1,12,3,192,178,158,8,1,8,1,0,2,14,1,0,0,0,0,12,1
270531039002003,79,Marcy Holmes,35,35,1000000US270531039002003,"Block 2003, Block Group 2, Census Tract 1039, Hennepin County, Minnesota",16,14,1,1,0,0,0,0,16,16,14,1,1,0,0,0,0,0,0,0,0,0,0,0,0
270530038001009,79,Marcy Holmes,35,35,1000000US270530038001009,"Block 1009, Block Group 1, Census Tract 38, Hennepin County, Minnesota",78,74,1,0,1,0,0,2,78,75,72,1,0,1,0,0,1,3,2,0,0,0,0,0,1
270530038001005,79,Marcy Holmes,35,35,1000000US270530038001005,"Block 1005, Block Group 1, Census Tract 38, Hennepin County, Minnesota",160,134,9,0,15,0,0,2,160,157,131,9,0,15,0,0,2,3,3,0,0,0,0,0,0
270530038002015,79,Marcy Holmes,35,35,1000000US270530038002015,"Block 2015, Block Group 2, Census Tract 38, Hennepin County, Minnesota",173,157,2,0,10,0,1,3,173,171,155,2,0,10,0,1,3,2,2,0,0,0,0,0,0
270530038002003,79,Marcy Holmes,35,35,1000000US270530038002003,"Block 2003, Block Group 2, Census Tract 38, Hennepin County, Minnesota",40,37,0,0,2,0,1,0,40,39,37,0,0,2,0,0,0,1,0,0,0,0,0,1,0
270531039001002,79,Marcy Holmes,35,35,1000000US270531039001002,"Block 1002, Block Group 1, Census Tract 1039, Hennepin County, Minnesota",101,86,4,1,5,0,2,3,101,98,85,4,1,5,0,0,3,3,1,0,0,0,0,2,0
270531039002002,79,Marcy Holmes,35,35,1000000US270531039002002,"Block 2002, Block Group 2, Census Tract 1039, Hennepin County, Minnesota",326,115,11,0,190,0,3,7,326,321,113,11,0,190,0,0,7,5,2,0,0,0,0,3,0
270531039002004,79,Marcy Holmes,35,35,1000000US270531039002004,"Block 2004, Block Group 2, Census Tract 1039, Hennepin County, Minnesota",27,25,0,0,1,0,1,0,27,26,25,0,0,1,0,0,0,1,0,0,0,0,0,1,0
270531037003007,79,Marcy Holmes,35,35,1000000US270531037003007,"Block 3007, Block Group 3, Census Tract 1037, Hennepin County, Minnesota",0,0,0,0,0,0,0,0,0,0,0,0,0,0,0,0,0,0,0,0,0,0,0,0,0
270531037001013,79,Marcy Holmes,35,35,1000000US270531037001013,"Block 1013, Block Group 1, Census Tract 1037, Hennepin County, Minnesota",0,0,0,0,0,0,0,0,0,0,0,0,0,0,0,0,0,0,0,0,0,0,0,0,0
270531037003004,79,Marcy Holmes,35,35,1000000US270531037003004,"Block 3004, Block Group 3, Census Tract 1037, Hennepin County, Minnesota",85,75,2,4,2,0,1,1,85,84,75,2,4,2,0,0,1,1,0,0,0,0,0,1,0
270531037003008,79,Marcy Holmes,35,35,1000000US270531037003008,"Block 3008, Block Group 3, Census Tract 1037, Hennepin County, Minnesota",149,144,4,0,0,0,0,1,149,146,141,4,0,0,0,0,1,3,3,0,0,0,0,0,0
270531037003005,79,Marcy Holmes,35,35,1000000US270531037003005,"Block 3005, Block Group 3, Census Tract 1037, Hennepin County, Minnesota",0,0,0,0,0,0,0,0,0,0,0,0,0,0,0,0,0,0,0,0,0,0,0,0,0
270531037002007,79,Marcy Holmes,35,35,1000000US270531037002007,"Block 2007, Block Group 2, Census Tract 1037, Hennepin County, Minnesota",81,70,9,0,0,0,1,1,81,81,70,9,0,0,0,1,1,0,0,0,0,0,0,0,0
270531037003009,79,Marcy Holmes,35,35,1000000US270531037003009,"Block 3009, Block Group 3, Census Tract 1037, Hennepin County, Minnesota",0,0,0,0,0,0,0,0,0,0,0,0,0,0,0,0,0,0,0,0,0,0,0,0,0
270530038003008,79,Marcy Holmes,35,35,1000000US270530038003008,"Block 3008, Block Group 3, Census Tract 38, Hennepin County, Minnesota",0,0,0,0,0,0,0,0,0,0,0,0,0,0,0,0,0,0,0,0,0,0,0,0,0
270530038001001,79,Marcy Holmes,35,35,1000000US270530038001001,"Block 1001, Block Group 1, Census Tract 38, Hennepin County, Minnesota",117,86,4,0,15,0,5,7,117,108,83,4,0,15,0,1,5,9,3,0,0,0,0,4,2
270531037002008,79,Marcy Holmes,35,35,1000000US270531037002008,"Block 2008, Block Group 2, Census Tract 1037, Hennepin County, Minnesota",0,0,0,0,0,0,0,0,0,0,0,0,0,0,0,0,0,0,0,0,0,0,0,0,0
270531037003001,79,Marcy Holmes,35,35,1000000US270531037003001,"Block 3001, Block Group 3, Census Tract 1037, Hennepin County, Minnesota",174,120,19,1,22,0,2,10,174,169,117,19,1,22,0,0,10,5,3,0,0,0,0,2,0
270531037002000,79,Marcy Holmes,35,35,1000000US270531037002000,"Block 2000, Block Group 2, Census Tract 1037, Hennepin County, Minnesota",50,43,5,2,0,0,0,0,50,47,41,4,2,0,0,0,0,3,2,1,0,0,0,0,0
270530038003004,79,Marcy Holmes,35,35,1000000US270530038003004,"Block 3004, Block Group 3, Census Tract 38, Hennepin County, Minnesota",85,64,1,0,17,0,2,1,85,79,60,1,0,17,0,0,1,6,4,0,0,0,0,2,0
270531037003015,79,Marcy Holmes,35,35,1000000US270531037003015,"Block 3015, Block Group 3, Census Tract 1037, Hennepin County, Minnesota",0,0,0,0,0,0,0,0,0,0,0,0,0,0,0,0,0,0,0,0,0,0,0,0,0
270531039001006,79,Marcy Holmes,35,35,1000000US270531039001006,"Block 1006, Block Group 1, Census Tract 1039, Hennepin County, Minnesota",141,106,7,1,24,0,0,3,141,136,102,6,1,24,0,0,3,5,4,1,0,0,0,0,0
270531037001010,79,Marcy Holmes,35,35,1000000US270531037001010,"Block 1010, Block Group 1, Census Tract 1037, Hennepin County, Minnesota",33,22,3,0,7,0,1,0,33,33,22,3,0,7,0,1,0,0,0,0,0,0,0,0,0
270531037003000,79,Marcy Holmes,35,35,1000000US270531037003000,"Block 3000, Block Group 3, Census Tract 1037, Hennepin County, Minnesota",174,139,3,1,18,0,6,7,174,158,130,3,1,18,0,1,5,16,9,0,0,0,0,5,2
270531037003006,79,Marcy Holmes,35,35,1000000US270531037003006,"Block 3006, Block Group 3, Census Tract 1037, Hennepin County, Minnesota",0,0,0,0,0,0,0,0,0,0,0,0,0,0,0,0,0,0,0,0,0,0,0,0,0
270531037003018,79,Marcy Holmes,35,35,1000000US270531037003018,"Block 3018, Block Group 3, Census Tract 1037, Hennepin County, Minnesota",174,155,9,1,7,0,1,1,174,172,154,9,1,7,0,0,1,2,1,0,0,0,0,1,0
270530038003003,79,Marcy Holmes,35,35,1000000US270530038003003,"Block 3003, Block Group 3, Census Tract 38, Hennepin County, Minnesota",163,120,3,5,31,0,1,3,163,159,117,3,5,31,0,0,3,4,3,0,0,0,0,1,0
270530038002016,79,Marcy Holmes,35,35,1000000US270530038002016,"Block 2016, Block Group 2, Census Tract 38, Hennepin County, Minnesota",0,0,0,0,0,0,0,0,0,0,0,0,0,0,0,0,0,0,0,0,0,0,0,0,0
270530038003010,79,Marcy Holmes,35,35,1000000US270530038003010,"Block 3010, Block Group 3, Census Tract 38, Hennepin County, Minnesota",0,0,0,0,0,0,0,0,0,0,0,0,0,0,0,0,0,0,0,0,0,0,0,0,0
270531039001000,79,Marcy Holmes,35,35,1000000US270531039001000,"Block 1000, Block Group 1, Census Tract 1039, Hennepin County, Minnesota",288,258,4,0,20,0,1,5,288,283,253,4,0,20,0,1,5,5,5,0,0,0,0,0,0
270531037001007,79,Marcy Holmes,35,35,1000000US270531037001007,"Block 1007, Block Group 1, Census Tract 1037, Hennepin County, Minnesota",53,44,4,1,1,0,0,3,53,51,43,4,1,1,0,0,2,2,1,0,0,0,0,0,1
270531037002006,79,Marcy Holmes,35,35,1000000US270531037002006,"Block 2006, Block Group 2, Census Tract 1037, Hennepin County, Minnesota",0,0,0,0,0,0,0,0,0,0,0,0,0,0,0,0,0,0,0,0,0,0,0,0,0
270531037003014,79,Marcy Holmes,35,35,1000000US270531037003014,"Block 3014, Block Group 3, Census Tract 1037, Hennepin County, Minnesota",0,0,0,0,0,0,0,0,0,0,0,0,0,0,0,0,0,0,0,0,0,0,0,0,0
270531037003010,79,Marcy Holmes,35,35,1000000US270531037003010,"Block 3010, Block Group 3, Census Tract 1037, Hennepin County, Minnesota",0,0,0,0,0,0,0,0,0,0,0,0,0,0,0,0,0,0,0,0,0,0,0,0,0
270530038001012,79,Marcy Holmes,35,35,1000000US270530038001012,"Block 1012, Block Group 1, Census Tract 38, Hennepin County, Minnesota",48,46,0,0,2,0,0,0,48,46,44,0,0,2,0,0,0,2,2,0,0,0,0,0,0
270530038002001,79,Marcy Holmes,35,35,1000000US270530038002001,"Block 2001, Block Group 2, Census Tract 38, Hennepin County, Minnesota",49,46,0,0,2,0,0,1,49,49,46,0,0,2,0,0,1,0,0,0,0,0,0,0,0
270530038003001,79,Marcy Holmes,35,35,1000000US270530038003001,"Block 3001, Block Group 3, Census Tract 38, Hennepin County, Minnesota",174,137,3,1,23,0,5,5,174,162,131,3,1,23,0,0,4,12,6,0,0,0,0,5,1
270530038002004,79,Marcy Holmes,35,35,1000000US270530038002004,"Block 2004, Block Group 2, Census Tract 38, Hennepin County, Minnesota",89,46,5,0,36,0,0,2,89,87,45,5,0,36,0,0,1,2,1,0,0,0,0,0,1
270530038002008,79,Marcy Holmes,35,35,1000000US270530038002008,"Block 2008, Block Group 2, Census Tract 38, Hennepin County, Minnesota",194,92,7,1,85,0,1,8,194,192,91,7,1,85,0,0,8,2,1,0,0,0,0,1,0
270530038002002,79,Marcy Holmes,35,35,1000000US270530038002002,"Block 2002, Block Group 2, Census Tract 38, Hennepin County, Minnesota",121,97,3,0,20,0,0,1,121,119,95,3,0,20,0,0,1,2,2,0,0,0,0,0,0
270530038002007,79,Marcy Holmes,35,35,1000000US270530038002007,"Block 2007, Block Group 2, Census Tract 38, Hennepin County, Minnesota",113,100,4,0,7,0,2,0,113,112,100,4,0,7,0,1,0,1,0,0,0,0,0,1,0
270530038002012,79,Marcy Holmes,35,35,1000000US270530038002012,"Block 2012, Block Group 2, Census Tract 38, Hennepin County, Minnesota",203,165,5,0,23,0,7,3,203,198,161,5,0,23,0,6,3,5,4,0,0,0,0,1,0
270531039002005,79,Marcy Holmes,35,35,1000000US270531039002005,"Block 2005, Block Group 2, Census Tract 1039, Hennepin County, Minnesota",236,218,2,0,8,0,2,6,236,230,216,1,0,8,0,0,5,6,2,1,0,0,0,2,1
270531039001003,79,Marcy Holmes,35,35,1000000US270531039001003,"Block 1003, Block Group 1, Census Tract 1039, Hennepin County, Minnesota",26,24,0,0,1,0,0,1,26,25,23,0,0,1,0,0,1,1,1,0,0,0,0,0,0
270531039002006,79,Marcy Holmes,35,35,1000000US270531039002006,"Block 2006, Block Group 2, Census Tract 1039, Hennepin County, Minnesota",58,47,2,0,9,0,0,0,58,56,45,2,0,9,0,0,0,2,2,0,0,0,0,0,0
270531037003012,79,Marcy Holmes,35,35,1000000US270531037003012,"Block 3012, Block Group 3, Census Tract 1037, Hennepin County, Minnesota",0,0,0,0,0,0,0,0,0,0,0,0,0,0,0,0,0,0,0,0,0,0,0,0,0
270530038001007,79,Marcy Holmes,35,35,1000000US270530038001007,"Block 1007, Block Group 1, Census Tract 38, Hennepin County, Minnesota",119,96,12,0,11,0,0,0,119,116,94,12,0,10,0,0,0,3,2,0,0,1,0,0,0
270530038001008,79,Marcy Holmes,35,35,1000000US270530038001008,"Block 1008, Block Group 1, Census Tract 38, Hennepin County, Minnesota",204,73,23,9,43,0,36,20,204,132,52,22,4,43,0,0,11,72,21,1,5,0,0,36,9
270530038001002,79,Marcy Holmes,35,35,1000000US270530038001002,"Block 1002, Block Group 1, Census Tract 38, Hennepin County, Minnesota",106,92,1,0,10,0,0,3,106,100,88,1,0,10,0,0,1,6,4,0,0,0,0,0,2
270531039001007,79,Marcy Holmes,35,35,1000000US270531039001007,"Block 1007, Block Group 1, Census Tract 1039, Hennepin County, Minnesota",28,20,0,0,8,0,0,0,28,27,19,0,0,8,0,0,0,1,1,0,0,0,0,0,0
270531037002002,79,Marcy Holmes,35,35,1000000US270531037002002,"Block 2002, Block Group 2, Census Tract 1037, Hennepin County, Minnesota",138,105,11,0,18,0,2,2,138,135,103,11,0,18,0,1,2,3,2,0,0,0,0,1,0
270531037002001,79,Marcy Holmes,35,35,1000000US270531037002001,"Block 2001, Block Group 2, Census Tract 1037, Hennepin County, Minnesota",165,118,8,2,25,0,2,10,165,156,115,8,0,25,0,0,8,9,3,0,2,0,0,2,2
270531037002010,79,Marcy Holmes,35,35,1000000US270531037002010,"Block 2010, Block Group 2, Census Tract 1037, Hennepin County, Minnesota",156,111,9,3,23,0,7,3,156,137,99,9,3,23,0,0,3,19,12,0,0,0,0,7,0
270531037002012,79,Marcy Holmes,35,35,1000000US270531037002012,"Block 2012, Block Group 2, Census Tract 1037, Hennepin County, Minnesota",120,105,2,4,4,0,2,3,120,117,105,2,4,4,0,0,2,3,0,0,0,0,0,2,1
270531037002011,79,Marcy Holmes,35,35,1000000US270531037002011,"Block 2011, Block Group 2, Census Tract 1037, Hennepin County, Minnesota",81,67,3,2,0,0,0,9,81,78,65,3,2,0,0,0,8,3,2,0,0,0,0,0,1
270530038001011,79,Marcy Holmes,35,35,1000000US270530038001011,"Block 1011, Block Group 1, Census Tract 38, Hennepin County, Minnesota",97,79,1,0,12,0,3,2,97,94,79,1,0,12,0,1,1,3,0,0,0,0,0,2,1
270531037003017,79,Marcy Holmes,35,35,1000000US270531037003017,"Block 3017, Block Group 3, Census Tract 1037, Hennepin County, Minnesota",0,0,0,0,0,0,0,0,0,0,0,0,0,0,0,0,0,0,0,0,0,0,0,0,0
270531008004004,80,Folwell,6,6,1000000US270531008004004,"Block 4004, Block Group 4, Census Tract 1008, Hennepin County, Minnesota",132,11,103,0,13,0,0,5,132,130,10,103,0,13,0,0,4,2,1,0,0,0,0,0,1
270531008004011,80,Folwell,6,6,1000000US270531008004011,"Block 4011, Block Group 4, Census Tract 1008, Hennepin County, Minnesota",122,24,68,4,0,0,9,17,122,102,17,68,4,0,0,0,13,20,7,0,0,0,0,9,4
270531008004000,80,Folwell,6,6,1000000US270531008004000,"Block 4000, Block Group 4, Census Tract 1008, Hennepin County, Minnesota",67,30,17,0,14,0,0,6,67,67,30,17,0,14,0,0,6,0,0,0,0,0,0,0,0
270531008002003,80,Folwell,6,6,1000000US270531008002003,"Block 2003, Block Group 2, Census Tract 1008, Hennepin County, Minnesota",79,37,22,0,18,0,0,2,79,78,37,21,0,18,0,0,2,1,0,1,0,0,0,0,0
270531008001006,80,Folwell,6,6,1000000US270531008001006,"Block 1006, Block Group 1, Census Tract 1008, Hennepin County, Minnesota",100,26,39,2,31,0,0,2,100,97,23,39,2,31,0,0,2,3,3,0,0,0,0,0,0
270531008002008,80,Folwell,6,6,1000000US270531008002008,"Block 2008, Block Group 2, Census Tract 1008, Hennepin County, Minnesota",77,19,31,14,5,0,7,1,77,60,16,31,7,5,0,0,1,17,3,0,7,0,0,7,0
270531008002013,80,Folwell,6,6,1000000US270531008002013,"Block 2013, Block Group 2, Census Tract 1008, Hennepin County, Minnesota",41,4,13,0,14,0,3,7,41,38,4,13,0,14,0,0,7,3,0,0,0,0,0,3,0
270531009005004,80,Folwell,6,6,1000000US270531009005004,"Block 5004, Block Group 5, Census Tract 1009, Hennepin County, Minnesota",75,16,36,1,0,0,9,13,75,65,16,35,1,0,0,0,13,10,0,1,0,0,0,9,0
270531009005009,80,Folwell,6,6,1000000US270531009005009,"Block 5009, Block Group 5, Census Tract 1009, Hennepin County, Minnesota",68,9,50,6,0,0,0,3,68,68,9,50,6,0,0,0,3,0,0,0,0,0,0,0,0
270531009005016,80,Folwell,6,6,1000000US270531009005016,"Block 5016, Block Group 5, Census Tract 1009, Hennepin County, Minnesota",98,72,22,2,0,0,1,1,98,93,69,21,2,0,0,0,1,5,3,1,0,0,0,1,0
270531008004009,80,Folwell,6,6,1000000US270531008004009,"Block 4009, Block Group 4, Census Tract 1008, Hennepin County, Minnesota",84,23,44,0,7,0,0,10,84,80,20,44,0,7,0,0,9,4,3,0,0,0,0,0,1
270531008004008,80,Folwell,6,6,1000000US270531008004008,"Block 4008, Block Group 4, Census Tract 1008, Hennepin County, Minnesota",91,50,18,1,7,0,9,6,91,59,33,18,1,1,0,0,6,32,17,0,0,6,0,9,0
270531008002006,80,Folwell,6,6,1000000US270531008002006,"Block 2006, Block Group 2, Census Tract 1008, Hennepin County, Minnesota",67,18,27,11,0,0,8,3,67,58,18,26,11,0,0,0,3,9,0,1,0,0,0,8,0
270531008001009,80,Folwell,6,6,1000000US270531008001009,"Block 1009, Block Group 1, Census Tract 1008, Hennepin County, Minnesota",67,20,25,1,10,0,0,11,67,67,20,25,1,10,0,0,11,0,0,0,0,0,0,0,0
270531008002009,80,Folwell,6,6,1000000US270531008002009,"Block 2009, Block Group 2, Census Tract 1008, Hennepin County, Minnesota",78,18,54,0,6,0,0,0,78,78,18,54,0,6,0,0,0,0,0,0,0,0,0,0,0
270531008004002,80,Folwell,6,6,1000000US270531008004002,"Block 4002, Block Group 4, Census Tract 1008, Hennepin County, Minnesota",71,49,10,1,7,0,2,2,71,65,45,10,1,7,0,0,2,6,4,0,0,0,0,2,0
270531008001004,80,Folwell,6,6,1000000US270531008001004,"Block 1004, Block Group 1, Census Tract 1008, Hennepin County, Minnesota",77,28,30,7,3,0,0,9,77,76,28,29,7,3,0,0,9,1,0,1,0,0,0,0,0
270531008003006,80,Folwell,6,6,1000000US270531008003006,"Block 3006, Block Group 3, Census Tract 1008, Hennepin County, Minnesota",73,28,32,1,12,0,0,0,73,72,28,32,0,12,0,0,0,1,0,0,1,0,0,0,0
270531008002002,80,Folwell,6,6,1000000US270531008002002,"Block 2002, Block Group 2, Census Tract 1008, Hennepin County, Minnesota",72,36,23,0,9,0,0,4,72,65,29,23,0,9,0,0,4,7,7,0,0,0,0,0,0
270531008003011,80,Folwell,6,6,1000000US270531008003011,"Block 3011, Block Group 3, Census Tract 1008, Hennepin County, Minnesota",73,16,42,2,7,0,0,6,73,71,16,42,2,7,0,0,4,2,0,0,0,0,0,0,2
270531008003010,80,Folwell,6,6,1000000US270531008003010,"Block 3010, Block Group 3, Census Tract 1008, Hennepin County, Minnesota",78,24,15,3,31,0,5,0,78,73,24,15,3,31,0,0,0,5,0,0,0,0,0,5,0
270531008004006,80,Folwell,6,6,1000000US270531008004006,"Block 4006, Block Group 4, Census Tract 1008, Hennepin County, Minnesota",82,26,37,0,7,0,0,12,82,78,23,37,0,7,0,0,11,4,3,0,0,0,0,0,1
270531008004007,80,Folwell,6,6,1000000US270531008004007,"Block 4007, Block Group 4, Census Tract 1008, Hennepin County, Minnesota",73,22,40,0,3,0,0,8,73,73,22,40,0,3,0,0,8,0,0,0,0,0,0,0,0
270531008002005,80,Folwell,6,6,1000000US270531008002005,"Block 2005, Block Group 2, Census Tract 1008, Hennepin County, Minnesota",94,22,39,0,10,0,2,21,94,92,20,39,0,10,0,2,21,2,2,0,0,0,0,0,0
270531008004010,80,Folwell,6,6,1000000US270531008004010,"Block 4010, Block Group 4, Census Tract 1008, Hennepin County, Minnesota",72,18,43,0,0,0,6,5,72,56,15,41,0,0,0,0,0,16,3,2,0,0,0,6,5
270531008003004,80,Folwell,6,6,1000000US270531008003004,"Block 3004, Block Group 3, Census Tract 1008, Hennepin County, Minnesota",104,15,65,3,9,0,2,10,104,93,10,65,3,9,0,0,6,11,5,0,0,0,0,2,4
270531008001001,80,Folwell,6,6,1000000US270531008001001,"Block 1001, Block Group 1, Census Tract 1008, Hennepin County, Minnesota",0,0,0,0,0,0,0,0,0,0,0,0,0,0,0,0,0,0,0,0,0,0,0,0,0
270531008001003,80,Folwell,6,6,1000000US270531008001003,"Block 1003, Block Group 1, Census Tract 1008, Hennepin County, Minnesota",80,35,16,3,13,0,8,5,80,71,35,16,3,13,0,0,4,9,0,0,0,0,0,8,1
270531008002001,80,Folwell,6,6,1000000US270531008002001,"Block 2001, Block Group 2, Census Tract 1008, Hennepin County, Minnesota",52,15,21,2,8,0,6,0,52,43,12,20,1,8,0,2,0,9,3,1,1,0,0,4,0
270531008002000,80,Folwell,6,6,1000000US270531008002000,"Block 2000, Block Group 2, Census Tract 1008, Hennepin County, Minnesota",76,19,32,0,20,0,0,5,76,71,18,28,0,20,0,0,5,5,1,4,0,0,0,0,0
270531008003009,80,Folwell,6,6,1000000US270531008003009,"Block 3009, Block Group 3, Census Tract 1008, Hennepin County, Minnesota",63,29,17,0,12,0,1,4,63,59,26,17,0,12,0,0,4,4,3,0,0,0,0,1,0
270531009005002,80,Folwell,6,6,1000000US270531009005002,"Block 5002, Block Group 5, Census Tract 1009, Hennepin County, Minnesota",102,25,58,0,0,0,7,12,102,90,20,58,0,0,0,0,12,12,5,0,0,0,0,7,0
270531009005000,80,Folwell,6,6,1000000US270531009005000,"Block 5000, Block Group 5, Census Tract 1009, Hennepin County, Minnesota",92,49,13,3,17,0,2,8,92,82,42,13,2,17,0,0,8,10,7,0,1,0,0,2,0
270531009005011,80,Folwell,6,6,1000000US270531009005011,"Block 5011, Block Group 5, Census Tract 1009, Hennepin County, Minnesota",83,14,62,0,3,0,0,4,83,83,14,62,0,3,0,0,4,0,0,0,0,0,0,0,0
270531009005012,80,Folwell,6,6,1000000US270531009005012,"Block 5012, Block Group 5, Census Tract 1009, Hennepin County, Minnesota",79,18,54,3,4,0,0,0,79,77,18,54,1,4,0,0,0,2,0,0,2,0,0,0,0
270531008003005,80,Folwell,6,6,1000000US270531008003005,"Block 3005, Block Group 3, Census Tract 1008, Hennepin County, Minnesota",94,46,40,0,1,0,0,7,94,94,46,40,0,1,0,0,7,0,0,0,0,0,0,0,0
270531008001000,80,Folwell,6,6,1000000US270531008001000,"Block 1000, Block Group 1, Census Tract 1008, Hennepin County, Minnesota",117,27,68,0,13,0,8,1,117,104,25,65,0,13,0,0,1,13,2,3,0,0,0,8,0
270531008002007,80,Folwell,6,6,1000000US270531008002007,"Block 2007, Block Group 2, Census Tract 1008, Hennepin County, Minnesota",81,36,40,4,0,0,0,1,81,65,23,37,4,0,0,0,1,16,13,3,0,0,0,0,0
270531008003008,80,Folwell,6,6,1000000US270531008003008,"Block 3008, Block Group 3, Census Tract 1008, Hennepin County, Minnesota",92,28,46,0,5,0,12,1,92,74,25,43,0,5,0,0,1,18,3,3,0,0,0,12,0
270531008002012,80,Folwell,6,6,1000000US270531008002012,"Block 2012, Block Group 2, Census Tract 1008, Hennepin County, Minnesota",111,30,35,0,26,0,8,12,111,103,30,35,0,26,0,0,12,8,0,0,0,0,0,8,0
270531009005001,80,Folwell,6,6,1000000US270531009005001,"Block 5001, Block Group 5, Census Tract 1009, Hennepin County, Minnesota",56,20,23,0,7,0,5,1,56,49,19,23,0,7,0,0,0,7,1,0,0,0,0,5,1
270531009005006,80,Folwell,6,6,1000000US270531009005006,"Block 5006, Block Group 5, Census Tract 1009, Hennepin County, Minnesota",68,19,46,0,1,0,0,2,68,61,13,46,0,1,0,0,1,7,6,0,0,0,0,0,1
270531008004005,80,Folwell,6,6,1000000US270531008004005,"Block 4005, Block Group 4, Census Tract 1008, Hennepin County, Minnesota",80,23,32,0,21,0,0,4,80,79,22,32,0,21,0,0,4,1,1,0,0,0,0,0,0
270531009005005,80,Folwell,6,6,1000000US270531009005005,"Block 5005, Block Group 5, Census Tract 1009, Hennepin County, Minnesota",99,31,45,4,8,0,7,4,99,92,31,45,4,8,0,0,4,7,0,0,0,0,0,7,0
270531009005008,80,Folwell,6,6,1000000US270531009005008,"Block 5008, Block Group 5, Census Tract 1009, Hennepin County, Minnesota",70,29,38,0,0,0,0,3,70,67,28,37,0,0,0,0,2,3,1,1,0,0,0,0,1
270531009005014,80,Folwell,6,6,1000000US270531009005014,"Block 5014, Block Group 5, Census Tract 1009, Hennepin County, Minnesota",81,24,28,0,26,0,2,1,81,80,24,28,0,26,0,2,0,1,0,0,0,0,0,0,1
270531008004001,80,Folwell,6,6,1000000US270531008004001,"Block 4001, Block Group 4, Census Tract 1008, Hennepin County, Minnesota",64,31,17,2,11,0,1,2,64,62,29,17,2,11,0,1,2,2,2,0,0,0,0,0,0
270531008002010,80,Folwell,6,6,1000000US270531008002010,"Block 2010, Block Group 2, Census Tract 1008, Hennepin County, Minnesota",91,24,50,0,10,0,0,7,91,90,24,49,0,10,0,0,7,1,0,1,0,0,0,0,0
270531008003002,80,Folwell,6,6,1000000US270531008003002,"Block 3002, Block Group 3, Census Tract 1008, Hennepin County, Minnesota",74,27,22,0,22,0,1,2,74,73,27,22,0,22,0,0,2,1,0,0,0,0,0,1,0
270531008003001,80,Folwell,6,6,1000000US270531008003001,"Block 3001, Block Group 3, Census Tract 1008, Hennepin County, Minnesota",72,32,18,0,0,0,12,10,72,52,24,18,0,0,0,0,10,20,8,0,0,0,0,12,0
270531008001002,80,Folwell,6,6,1000000US270531008001002,"Block 1002, Block Group 1, Census Tract 1008, Hennepin County, Minnesota",55,36,14,1,2,0,0,2,55,55,36,14,1,2,0,0,2,0,0,0,0,0,0,0,0
270531008003007,80,Folwell,6,6,1000000US270531008003007,"Block 3007, Block Group 3, Census Tract 1008, Hennepin County, Minnesota",76,26,26,1,20,0,3,0,76,74,26,26,1,20,0,1,0,2,0,0,0,0,0,2,0
270531008001005,80,Folwell,6,6,1000000US270531008001005,"Block 1005, Block Group 1, Census Tract 1008, Hennepin County, Minnesota",76,29,18,8,9,0,0,12,76,69,28,18,3,9,0,0,11,7,1,0,5,0,0,0,1
270531008001007,80,Folwell,6,6,1000000US270531008001007,"Block 1007, Block Group 1, Census Tract 1008, Hennepin County, Minnesota",81,34,23,0,16,0,0,8,81,79,33,23,0,16,0,0,7,2,1,0,0,0,0,0,1
270531008002011,80,Folwell,6,6,1000000US270531008002011,"Block 2011, Block Group 2, Census Tract 1008, Hennepin County, Minnesota",82,33,42,1,0,0,1,5,82,77,29,42,1,0,0,0,5,5,4,0,0,0,0,1,0
270531009005003,80,Folwell,6,6,1000000US270531009005003,"Block 5003, Block Group 5, Census Tract 1009, Hennepin County, Minnesota",90,28,46,0,12,0,0,4,90,85,23,46,0,12,0,0,4,5,5,0,0,0,0,0,0
270531009005007,80,Folwell,6,6,1000000US270531009005007,"Block 5007, Block Group 5, Census Tract 1009, Hennepin County, Minnesota",94,22,53,0,13,0,0,6,94,92,21,52,0,13,0,0,6,2,1,1,0,0,0,0,0
270531009005010,80,Folwell,6,6,1000000US270531009005010,"Block 5010, Block Group 5, Census Tract 1009, Hennepin County, Minnesota",85,20,52,0,8,0,0,5,85,84,20,51,0,8,0,0,5,1,0,1,0,0,0,0,0
270531008003003,80,Folwell,6,6,1000000US270531008003003,"Block 3003, Block Group 3, Census Tract 1008, Hennepin County, Minnesota",82,24,52,1,0,0,5,0,82,77,24,52,1,0,0,0,0,5,0,0,0,0,0,5,0
270531008003000,80,Folwell,6,6,1000000US270531008003000,"Block 3000, Block Group 3, Census Tract 1008, Hennepin County, Minnesota",87,38,31,0,6,0,10,2,87,76,38,31,0,5,0,0,2,11,0,0,0,1,0,10,0
270531008002004,80,Folwell,6,6,1000000US270531008002004,"Block 2004, Block Group 2, Census Tract 1008, Hennepin County, Minnesota",64,22,32,0,0,0,4,6,64,60,22,32,0,0,0,0,6,4,0,0,0,0,0,4,0
270531008001008,80,Folwell,6,6,1000000US270531008001008,"Block 1008, Block Group 1, Census Tract 1008, Hennepin County, Minnesota",65,32,24,0,9,0,0,0,65,60,27,24,0,9,0,0,0,5,5,0,0,0,0,0,0
270531008002014,80,Folwell,6,6,1000000US270531008002014,"Block 2014, Block Group 2, Census Tract 1008, Hennepin County, Minnesota",79,28,48,0,0,0,0,3,79,73,23,47,0,0,0,0,3,6,5,1,0,0,0,0,0
270531009005013,80,Folwell,6,6,1000000US270531009005013,"Block 5013, Block Group 5, Census Tract 1009, Hennepin County, Minnesota",89,22,48,1,13,0,1,4,89,89,22,48,1,13,0,1,4,0,0,0,0,0,0,0,0
270531009005015,80,Folwell,6,6,1000000US270531009005015,"Block 5015, Block Group 5, Census Tract 1009, Hennepin County, Minnesota",69,14,45,0,5,0,0,5,69,67,12,45,0,5,0,0,5,2,2,0,0,0,0,0,0
270531009005017,80,Folwell,6,6,1000000US270531009005017,"Block 5017, Block Group 5, Census Tract 1009, Hennepin County, Minnesota",100,30,47,0,22,0,0,1,100,100,30,47,0,22,0,0,1,0,0,0,0,0,0,0,0
270531008004003,80,Folwell,6,6,1000000US270531008004003,"Block 4003, Block Group 4, Census Tract 1008, Hennepin County, Minnesota",78,26,47,2,0,0,3,0,78,74,25,47,2,0,0,0,0,4,1,0,0,0,0,3,0
270531009002008,81,McKinley,7,7,1000000US270531009002008,"Block 2008, Block Group 2, Census Tract 1009, Hennepin County, Minnesota",99,13,62,4,18,0,0,2,99,97,11,62,4,18,0,0,2,2,2,0,0,0,0,0,0
270531009001005,81,McKinley,7,7,1000000US270531009001005,"Block 1005, Block Group 1, Census Tract 1009, Hennepin County, Minnesota",0,0,0,0,0,0,0,0,0,0,0,0,0,0,0,0,0,0,0,0,0,0,0,0,0
270531009001014,81,McKinley,7,7,1000000US270531009001014,"Block 1014, Block Group 1, Census Tract 1009, Hennepin County, Minnesota",0,0,0,0,0,0,0,0,0,0,0,0,0,0,0,0,0,0,0,0,0,0,0,0,0
270531009001004,81,McKinley,7,7,1000000US270531009001004,"Block 1004, Block Group 1, Census Tract 1009, Hennepin County, Minnesota",0,0,0,0,0,0,0,0,0,0,0,0,0,0,0,0,0,0,0,0,0,0,0,0,0
270531009001012,81,McKinley,7,7,1000000US270531009001012,"Block 1012, Block Group 1, Census Tract 1009, Hennepin County, Minnesota",25,18,0,4,3,0,0,0,25,25,18,0,4,3,0,0,0,0,0,0,0,0,0,0,0
270531009001013,81,McKinley,7,7,1000000US270531009001013,"Block 1013, Block Group 1, Census Tract 1009, Hennepin County, Minnesota",0,0,0,0,0,0,0,0,0,0,0,0,0,0,0,0,0,0,0,0,0,0,0,0,0
270531009001015,81,McKinley,7,7,1000000US270531009001015,"Block 1015, Block Group 1, Census Tract 1009, Hennepin County, Minnesota",13,13,0,0,0,0,0,0,13,6,6,0,0,0,0,0,0,7,7,0,0,0,0,0,0
270531009001003,81,McKinley,7,7,1000000US270531009001003,"Block 1003, Block Group 1, Census Tract 1009, Hennepin County, Minnesota",0,0,0,0,0,0,0,0,0,0,0,0,0,0,0,0,0,0,0,0,0,0,0,0,0
270531009001000,81,McKinley,7,7,1000000US270531009001000,"Block 1000, Block Group 1, Census Tract 1009, Hennepin County, Minnesota",0,0,0,0,0,0,0,0,0,0,0,0,0,0,0,0,0,0,0,0,0,0,0,0,0
270531009003004,81,McKinley,7,7,1000000US270531009003004,"Block 3004, Block Group 3, Census Tract 1009, Hennepin County, Minnesota",86,29,41,9,1,0,1,5,86,67,20,34,9,1,0,0,3,19,9,7,0,0,0,1,2
270531009004006,81,McKinley,7,7,1000000US270531009004006,"Block 4006, Block Group 4, Census Tract 1009, Hennepin County, Minnesota",104,17,71,0,4,0,0,12,104,104,17,71,0,4,0,0,12,0,0,0,0,0,0,0,0
270531009001006,81,McKinley,7,7,1000000US270531009001006,"Block 1006, Block Group 1, Census Tract 1009, Hennepin County, Minnesota",134,42,60,0,28,0,0,4,134,132,41,60,0,27,0,0,4,2,1,0,0,1,0,0,0
270531009003007,81,McKinley,7,7,1000000US270531009003007,"Block 3007, Block Group 3, Census Tract 1009, Hennepin County, Minnesota",83,34,34,1,3,0,5,6,83,71,28,30,1,3,0,3,6,12,6,4,0,0,0,2,0
270531009002001,81,McKinley,7,7,1000000US270531009002001,"Block 2001, Block Group 2, Census Tract 1009, Hennepin County, Minnesota",76,17,12,2,20,0,16,9,76,53,17,12,1,20,0,0,3,23,0,0,1,0,0,16,6
270531009002007,81,McKinley,7,7,1000000US270531009002007,"Block 2007, Block Group 2, Census Tract 1009, Hennepin County, Minnesota",68,18,49,0,0,1,0,0,68,67,17,49,0,0,1,0,0,1,1,0,0,0,0,0,0
270531009001011,81,McKinley,7,7,1000000US270531009001011,"Block 1011, Block Group 1, Census Tract 1009, Hennepin County, Minnesota",6,5,1,0,0,0,0,0,6,6,5,1,0,0,0,0,0,0,0,0,0,0,0,0,0
270531009001002,81,McKinley,7,7,1000000US270531009001002,"Block 1002, Block Group 1, Census Tract 1009, Hennepin County, Minnesota",18,5,13,0,0,0,0,0,18,18,5,13,0,0,0,0,0,0,0,0,0,0,0,0,0
270531009002005,81,McKinley,7,7,1000000US270531009002005,"Block 2005, Block Group 2, Census Tract 1009, Hennepin County, Minnesota",24,3,17,0,2,0,0,2,24,24,3,17,0,2,0,0,2,0,0,0,0,0,0,0,0
270531009004004,81,McKinley,7,7,1000000US270531009004004,"Block 4004, Block Group 4, Census Tract 1009, Hennepin County, Minnesota",73,34,26,0,9,0,0,4,73,72,33,26,0,9,0,0,4,1,1,0,0,0,0,0,0
270531009004003,81,McKinley,7,7,1000000US270531009004003,"Block 4003, Block Group 4, Census Tract 1009, Hennepin County, Minnesota",55,15,19,1,15,0,0,5,55,55,15,19,1,15,0,0,5,0,0,0,0,0,0,0,0
270531009004002,81,McKinley,7,7,1000000US270531009004002,"Block 4002, Block Group 4, Census Tract 1009, Hennepin County, Minnesota",61,24,29,0,0,0,5,3,61,55,23,29,0,0,0,0,3,6,1,0,0,0,0,5,0
270531009003000,81,McKinley,7,7,1000000US270531009003000,"Block 3000, Block Group 3, Census Tract 1009, Hennepin County, Minnesota",88,29,37,1,9,0,6,6,88,71,18,37,1,9,0,0,6,17,11,0,0,0,0,6,0
270531009002000,81,McKinley,7,7,1000000US270531009002000,"Block 2000, Block Group 2, Census Tract 1009, Hennepin County, Minnesota",90,17,36,0,13,0,24,0,90,69,12,36,0,13,0,8,0,21,5,0,0,0,0,16,0
270531009004001,81,McKinley,7,7,1000000US270531009004001,"Block 4001, Block Group 4, Census Tract 1009, Hennepin County, Minnesota",78,28,38,0,0,0,4,8,78,67,24,38,0,0,0,1,4,11,4,0,0,0,0,3,4
270531009003001,81,McKinley,7,7,1000000US270531009003001,"Block 3001, Block Group 3, Census Tract 1009, Hennepin County, Minnesota",76,22,46,0,0,0,6,2,76,68,21,45,0,0,0,0,2,8,1,1,0,0,0,6,0
270531009004009,81,McKinley,7,7,1000000US270531009004009,"Block 4009, Block Group 4, Census Tract 1009, Hennepin County, Minnesota",67,30,22,0,15,0,0,0,67,67,30,22,0,15,0,0,0,0,0,0,0,0,0,0,0
270531009002009,81,McKinley,7,7,1000000US270531009002009,"Block 2009, Block Group 2, Census Tract 1009, Hennepin County, Minnesota",106,14,36,4,17,0,21,14,106,84,14,36,4,17,0,0,13,22,0,0,0,0,0,21,1
270531009001010,81,McKinley,7,7,1000000US270531009001010,"Block 1010, Block Group 1, Census Tract 1009, Hennepin County, Minnesota",52,15,15,0,19,0,0,3,52,49,12,15,0,19,0,0,3,3,3,0,0,0,0,0,0
270531009003003,81,McKinley,7,7,1000000US270531009003003,"Block 3003, Block Group 3, Census Tract 1009, Hennepin County, Minnesota",61,17,23,4,7,0,6,4,61,54,16,23,4,7,0,0,4,7,1,0,0,0,0,6,0
270531009002004,81,McKinley,7,7,1000000US270531009002004,"Block 2004, Block Group 2, Census Tract 1009, Hennepin County, Minnesota",104,19,34,0,46,0,0,5,104,103,18,34,0,46,0,0,5,1,1,0,0,0,0,0,0
270531009004007,81,McKinley,7,7,1000000US270531009004007,"Block 4007, Block Group 4, Census Tract 1009, Hennepin County, Minnesota",67,24,29,0,10,0,0,4,67,67,24,29,0,10,0,0,4,0,0,0,0,0,0,0,0
270531009003002,81,McKinley,7,7,1000000US270531009003002,"Block 3002, Block Group 3, Census Tract 1009, Hennepin County, Minnesota",106,23,46,2,12,0,10,13,106,96,22,46,2,12,0,1,13,10,1,0,0,0,0,9,0
270531009001016,81,McKinley,7,7,1000000US270531009001016,"Block 1016, Block Group 1, Census Tract 1009, Hennepin County, Minnesota",41,9,29,0,0,0,3,0,41,38,9,29,0,0,0,0,0,3,0,0,0,0,0,3,0
270531009001017,81,McKinley,7,7,1000000US270531009001017,"Block 1017, Block Group 1, Census Tract 1009, Hennepin County, Minnesota",93,13,44,0,27,0,5,4,93,85,12,43,0,27,0,0,3,8,1,1,0,0,0,5,1
270531009003005,81,McKinley,7,7,1000000US270531009003005,"Block 3005, Block Group 3, Census Tract 1009, Hennepin County, Minnesota",88,21,34,0,27,0,0,6,88,82,16,34,0,27,0,0,5,6,5,0,0,0,0,0,1
270531009003006,81,McKinley,7,7,1000000US270531009003006,"Block 3006, Block Group 3, Census Tract 1009, Hennepin County, Minnesota",93,20,35,0,27,0,3,8,93,81,13,35,0,27,0,0,6,12,7,0,0,0,0,3,2
270531009004000,81,McKinley,7,7,1000000US270531009004000,"Block 4000, Block Group 4, Census Tract 1009, Hennepin County, Minnesota",110,23,79,0,1,0,0,7,110,110,23,79,0,1,0,0,7,0,0,0,0,0,0,0,0
270531009004008,81,McKinley,7,7,1000000US270531009004008,"Block 4008, Block Group 4, Census Tract 1009, Hennepin County, Minnesota",69,25,14,13,0,0,12,5,69,45,13,14,13,0,0,0,5,24,12,0,0,0,0,12,0
270531009002002,81,McKinley,7,7,1000000US270531009002002,"Block 2002, Block Group 2, Census Tract 1009, Hennepin County, Minnesota",91,28,34,0,9,0,18,2,91,72,28,34,0,9,0,0,1,19,0,0,0,0,0,18,1
270531009001018,81,McKinley,7,7,1000000US270531009001018,"Block 1018, Block Group 1, Census Tract 1009, Hennepin County, Minnesota",74,18,32,1,0,0,10,13,74,66,18,32,1,0,0,3,12,8,0,0,0,0,0,7,1
270531009001009,81,McKinley,7,7,1000000US270531009001009,"Block 1009, Block Group 1, Census Tract 1009, Hennepin County, Minnesota",56,27,18,0,7,0,2,2,56,53,27,17,0,7,0,0,2,3,0,1,0,0,0,2,0
270531009002006,81,McKinley,7,7,1000000US270531009002006,"Block 2006, Block Group 2, Census Tract 1009, Hennepin County, Minnesota",76,18,50,1,3,0,0,4,76,74,17,50,1,3,0,0,3,2,1,0,0,0,0,0,1
270531009002003,81,McKinley,7,7,1000000US270531009002003,"Block 2003, Block Group 2, Census Tract 1009, Hennepin County, Minnesota",74,17,38,2,12,0,0,5,74,74,17,38,2,12,0,0,5,0,0,0,0,0,0,0,0
270531009003008,81,McKinley,7,7,1000000US270531009003008,"Block 3008, Block Group 3, Census Tract 1009, Hennepin County, Minnesota",79,23,51,0,1,0,2,2,79,76,23,51,0,1,0,0,1,3,0,0,0,0,0,2,1
270531009001001,81,McKinley,7,7,1000000US270531009001001,"Block 1001, Block Group 1, Census Tract 1009, Hennepin County, Minnesota",0,0,0,0,0,0,0,0,0,0,0,0,0,0,0,0,0,0,0,0,0,0,0,0,0
270531009004005,81,McKinley,7,7,1000000US270531009004005,"Block 4005, Block Group 4, Census Tract 1009, Hennepin County, Minnesota",72,42,17,5,0,1,2,5,72,60,37,15,5,0,1,0,2,12,5,2,0,0,0,2,3
270531009001007,81,McKinley,7,7,1000000US270531009001007,"Block 1007, Block Group 1, Census Tract 1009, Hennepin County, Minnesota",101,21,21,0,38,0,13,8,101,86,21,21,0,36,0,0,8,15,0,0,0,2,0,13,0
270531009003009,81,McKinley,7,7,1000000US270531009003009,"Block 3009, Block Group 3, Census Tract 1009, Hennepin County, Minnesota",88,28,27,1,23,0,3,6,88,83,28,25,1,23,0,0,6,5,0,2,0,0,0,3,0
270531009001008,81,McKinley,7,7,1000000US270531009001008,"Block 1008, Block Group 1, Census Tract 1009, Hennepin County, Minnesota",107,21,22,3,55,0,0,6,107,104,21,22,3,55,0,0,3,3,0,0,0,0,0,0,3
270531004001013,82,Camden Industrial,9,9,1000000US270531004001013,"Block 1013, Block Group 1, Census Tract 1004, Hennepin County, Minnesota",0,0,0,0,0,0,0,0,0,0,0,0,0,0,0,0,0,0,0,0,0,0,0,0,0
270530001021019,82,Camden Industrial,9,9,1000000US270530001021019,"Block 1019, Block Group 1, Census Tract 1.02, Hennepin County, Minnesota",0,0,0,0,0,0,0,0,0,0,0,0,0,0,0,0,0,0,0,0,0,0,0,0,0
270531004001002,82,Camden Industrial,9,9,1000000US270531004001002,"Block 1002, Block Group 1, Census Tract 1004, Hennepin County, Minnesota",0,0,0,0,0,0,0,0,0,0,0,0,0,0,0,0,0,0,0,0,0,0,0,0,0
270530001021015,82,Camden Industrial,9,9,1000000US270530001021015,"Block 1015, Block Group 1, Census Tract 1.02, Hennepin County, Minnesota",0,0,0,0,0,0,0,0,0,0,0,0,0,0,0,0,0,0,0,0,0,0,0,0,0
270530001021021,82,Camden Industrial,9,9,1000000US270530001021021,"Block 1021, Block Group 1, Census Tract 1.02, Hennepin County, Minnesota",0,0,0,0,0,0,0,0,0,0,0,0,0,0,0,0,0,0,0,0,0,0,0,0,0
270530001021020,82,Camden Industrial,9,9,1000000US270530001021020,"Block 1020, Block Group 1, Census Tract 1.02, Hennepin County, Minnesota",0,0,0,0,0,0,0,0,0,0,0,0,0,0,0,0,0,0,0,0,0,0,0,0,0
270530001021016,82,Camden Industrial,9,9,1000000US270530001021016,"Block 1016, Block Group 1, Census Tract 1.02, Hennepin County, Minnesota",0,0,0,0,0,0,0,0,0,0,0,0,0,0,0,0,0,0,0,0,0,0,0,0,0
270530001021018,82,Camden Industrial,9,9,1000000US270530001021018,"Block 1018, Block Group 1, Census Tract 1.02, Hennepin County, Minnesota",0,0,0,0,0,0,0,0,0,0,0,0,0,0,0,0,0,0,0,0,0,0,0,0,0
270531004001011,82,Camden Industrial,9,9,1000000US270531004001011,"Block 1011, Block Group 1, Census Tract 1004, Hennepin County, Minnesota",0,0,0,0,0,0,0,0,0,0,0,0,0,0,0,0,0,0,0,0,0,0,0,0,0
270531004001001,82,Camden Industrial,9,9,1000000US270531004001001,"Block 1001, Block Group 1, Census Tract 1004, Hennepin County, Minnesota",0,0,0,0,0,0,0,0,0,0,0,0,0,0,0,0,0,0,0,0,0,0,0,0,0
270531004001014,82,Camden Industrial,9,9,1000000US270531004001014,"Block 1014, Block Group 1, Census Tract 1004, Hennepin County, Minnesota",0,0,0,0,0,0,0,0,0,0,0,0,0,0,0,0,0,0,0,0,0,0,0,0,0
270531004001000,82,Camden Industrial,9,9,1000000US270531004001000,"Block 1000, Block Group 1, Census Tract 1004, Hennepin County, Minnesota",0,0,0,0,0,0,0,0,0,0,0,0,0,0,0,0,0,0,0,0,0,0,0,0,0
270531005001011,83,Columbia Park,11,11,1000000US270531005001011,"Block 1011, Block Group 1, Census Tract 1005, Hennepin County, Minnesota",62,54,0,2,3,0,0,3,62,61,53,0,2,3,0,0,3,1,1,0,0,0,0,0,0
270531005001004,83,Columbia Park,11,11,1000000US270531005001004,"Block 1004, Block Group 1, Census Tract 1005, Hennepin County, Minnesota",59,38,4,0,8,0,6,3,59,50,36,4,0,8,0,1,1,9,2,0,0,0,0,5,2
270531005001016,83,Columbia Park,11,11,1000000US270531005001016,"Block 1016, Block Group 1, Census Tract 1005, Hennepin County, Minnesota",1,1,0,0,0,0,0,0,1,1,1,0,0,0,0,0,0,0,0,0,0,0,0,0,0
270531005001021,83,Columbia Park,11,11,1000000US270531005001021,"Block 1021, Block Group 1, Census Tract 1005, Hennepin County, Minnesota",0,0,0,0,0,0,0,0,0,0,0,0,0,0,0,0,0,0,0,0,0,0,0,0,0
270531005001029,83,Columbia Park,11,11,1000000US270531005001029,"Block 1029, Block Group 1, Census Tract 1005, Hennepin County, Minnesota",0,0,0,0,0,0,0,0,0,0,0,0,0,0,0,0,0,0,0,0,0,0,0,0,0
270531005001008,83,Columbia Park,11,11,1000000US270531005001008,"Block 1008, Block Group 1, Census Tract 1005, Hennepin County, Minnesota",0,0,0,0,0,0,0,0,0,0,0,0,0,0,0,0,0,0,0,0,0,0,0,0,0
270531005001013,83,Columbia Park,11,11,1000000US270531005001013,"Block 1013, Block Group 1, Census Tract 1005, Hennepin County, Minnesota",77,49,11,2,4,0,1,10,77,65,45,11,1,4,0,0,4,12,4,0,1,0,0,1,6
270531005001007,83,Columbia Park,11,11,1000000US270531005001007,"Block 1007, Block Group 1, Census Tract 1005, Hennepin County, Minnesota",0,0,0,0,0,0,0,0,0,0,0,0,0,0,0,0,0,0,0,0,0,0,0,0,0
270531005001015,83,Columbia Park,11,11,1000000US270531005001015,"Block 1015, Block Group 1, Census Tract 1005, Hennepin County, Minnesota",57,51,4,0,1,0,1,0,57,54,49,4,0,1,0,0,0,3,2,0,0,0,0,1,0
270530006014020,83,Columbia Park,11,11,1000000US270530006014020,"Block 4020, Block Group 4, Census Tract 6.01, Hennepin County, Minnesota",0,0,0,0,0,0,0,0,0,0,0,0,0,0,0,0,0,0,0,0,0,0,0,0,0
270530006014021,83,Columbia Park,11,11,1000000US270530006014021,"Block 4021, Block Group 4, Census Tract 6.01, Hennepin County, Minnesota",71,57,12,1,0,0,0,1,71,69,55,12,1,0,0,0,1,2,2,0,0,0,0,0,0
270530006014022,83,Columbia Park,11,11,1000000US270530006014022,"Block 4022, Block Group 4, Census Tract 6.01, Hennepin County, Minnesota",0,0,0,0,0,0,0,0,0,0,0,0,0,0,0,0,0,0,0,0,0,0,0,0,0
270531005001023,83,Columbia Park,11,11,1000000US270531005001023,"Block 1023, Block Group 1, Census Tract 1005, Hennepin County, Minnesota",0,0,0,0,0,0,0,0,0,0,0,0,0,0,0,0,0,0,0,0,0,0,0,0,0
270530006014011,83,Columbia Park,11,11,1000000US270530006014011,"Block 4011, Block Group 4, Census Tract 6.01, Hennepin County, Minnesota",0,0,0,0,0,0,0,0,0,0,0,0,0,0,0,0,0,0,0,0,0,0,0,0,0
270531005001017,83,Columbia Park,11,11,1000000US270531005001017,"Block 1017, Block Group 1, Census Tract 1005, Hennepin County, Minnesota",0,0,0,0,0,0,0,0,0,0,0,0,0,0,0,0,0,0,0,0,0,0,0,0,0
270530006014026,83,Columbia Park,11,11,1000000US270530006014026,"Block 4026, Block Group 4, Census Tract 6.01, Hennepin County, Minnesota",0,0,0,0,0,0,0,0,0,0,0,0,0,0,0,0,0,0,0,0,0,0,0,0,0
270530006014013,83,Columbia Park,11,11,1000000US270530006014013,"Block 4013, Block Group 4, Census Tract 6.01, Hennepin County, Minnesota",92,71,9,2,1,0,0,9,92,92,71,9,2,1,0,0,9,0,0,0,0,0,0,0,0
270530006014015,83,Columbia Park,11,11,1000000US270530006014015,"Block 4015, Block Group 4, Census Tract 6.01, Hennepin County, Minnesota",0,0,0,0,0,0,0,0,0,0,0,0,0,0,0,0,0,0,0,0,0,0,0,0,0
270530006014009,83,Columbia Park,11,11,1000000US270530006014009,"Block 4009, Block Group 4, Census Tract 6.01, Hennepin County, Minnesota",28,26,0,0,1,0,1,0,28,27,26,0,0,1,0,0,0,1,0,0,0,0,0,1,0
270530006014012,83,Columbia Park,11,11,1000000US270530006014012,"Block 4012, Block Group 4, Census Tract 6.01, Hennepin County, Minnesota",69,64,0,1,0,0,4,0,69,65,64,0,1,0,0,0,0,4,0,0,0,0,0,4,0
270530006014014,83,Columbia Park,11,11,1000000US270530006014014,"Block 4014, Block Group 4, Census Tract 6.01, Hennepin County, Minnesota",108,80,19,1,0,0,2,6,108,104,77,19,1,0,0,2,5,4,3,0,0,0,0,0,1
270530006014005,83,Columbia Park,11,11,1000000US270530006014005,"Block 4005, Block Group 4, Census Tract 6.01, Hennepin County, Minnesota",94,36,48,0,2,0,1,7,94,91,34,48,0,2,0,0,7,3,2,0,0,0,0,1,0
270531005001020,83,Columbia Park,11,11,1000000US270531005001020,"Block 1020, Block Group 1, Census Tract 1005, Hennepin County, Minnesota",1,1,0,0,0,0,0,0,1,1,1,0,0,0,0,0,0,0,0,0,0,0,0,0,0
270530006014010,83,Columbia Park,11,11,1000000US270530006014010,"Block 4010, Block Group 4, Census Tract 6.01, Hennepin County, Minnesota",94,79,3,1,3,0,0,8,94,94,79,3,1,3,0,0,8,0,0,0,0,0,0,0,0
270530006014006,83,Columbia Park,11,11,1000000US270530006014006,"Block 4006, Block Group 4, Census Tract 6.01, Hennepin County, Minnesota",42,27,2,6,0,0,7,0,42,34,26,2,6,0,0,0,0,8,1,0,0,0,0,7,0
270530006014000,83,Columbia Park,11,11,1000000US270530006014000,"Block 4000, Block Group 4, Census Tract 6.01, Hennepin County, Minnesota",0,0,0,0,0,0,0,0,0,0,0,0,0,0,0,0,0,0,0,0,0,0,0,0,0
270530006014018,83,Columbia Park,11,11,1000000US270530006014018,"Block 4018, Block Group 4, Census Tract 6.01, Hennepin County, Minnesota",0,0,0,0,0,0,0,0,0,0,0,0,0,0,0,0,0,0,0,0,0,0,0,0,0
270530006014003,83,Columbia Park,11,11,1000000US270530006014003,"Block 4003, Block Group 4, Census Tract 6.01, Hennepin County, Minnesota",51,40,1,0,0,0,1,9,51,40,36,1,0,0,0,0,3,11,4,0,0,0,0,1,6
270531005001018,83,Columbia Park,11,11,1000000US270531005001018,"Block 1018, Block Group 1, Census Tract 1005, Hennepin County, Minnesota",0,0,0,0,0,0,0,0,0,0,0,0,0,0,0,0,0,0,0,0,0,0,0,0,0
270531005001030,83,Columbia Park,11,11,1000000US270531005001030,"Block 1030, Block Group 1, Census Tract 1005, Hennepin County, Minnesota",0,0,0,0,0,0,0,0,0,0,0,0,0,0,0,0,0,0,0,0,0,0,0,0,0
270531005001006,83,Columbia Park,11,11,1000000US270531005001006,"Block 1006, Block Group 1, Census Tract 1005, Hennepin County, Minnesota",57,46,0,6,3,0,0,2,57,55,46,0,4,3,0,0,2,2,0,0,2,0,0,0,0
270531005001022,83,Columbia Park,11,11,1000000US270531005001022,"Block 1022, Block Group 1, Census Tract 1005, Hennepin County, Minnesota",0,0,0,0,0,0,0,0,0,0,0,0,0,0,0,0,0,0,0,0,0,0,0,0,0
270531005001005,83,Columbia Park,11,11,1000000US270531005001005,"Block 1005, Block Group 1, Census Tract 1005, Hennepin County, Minnesota",59,48,7,0,2,0,1,1,59,55,45,7,0,2,0,0,1,4,3,0,0,0,0,1,0
270531005001002,83,Columbia Park,11,11,1000000US270531005001002,"Block 1002, Block Group 1, Census Tract 1005, Hennepin County, Minnesota",10,0,0,0,10,0,0,0,10,10,0,0,0,10,0,0,0,0,0,0,0,0,0,0,0
270531005001019,83,Columbia Park,11,11,1000000US270531005001019,"Block 1019, Block Group 1, Census Tract 1005, Hennepin County, Minnesota",0,0,0,0,0,0,0,0,0,0,0,0,0,0,0,0,0,0,0,0,0,0,0,0,0
270531005001009,83,Columbia Park,11,11,1000000US270531005001009,"Block 1009, Block Group 1, Census Tract 1005, Hennepin County, Minnesota",0,0,0,0,0,0,0,0,0,0,0,0,0,0,0,0,0,0,0,0,0,0,0,0,0
270530006014025,83,Columbia Park,11,11,1000000US270530006014025,"Block 4025, Block Group 4, Census Tract 6.01, Hennepin County, Minnesota",0,0,0,0,0,0,0,0,0,0,0,0,0,0,0,0,0,0,0,0,0,0,0,0,0
270531005001003,83,Columbia Park,11,11,1000000US270531005001003,"Block 1003, Block Group 1, Census Tract 1005, Hennepin County, Minnesota",46,42,0,2,0,0,2,0,46,43,41,0,2,0,0,0,0,3,1,0,0,0,0,2,0
270530006014007,83,Columbia Park,11,11,1000000US270530006014007,"Block 4007, Block Group 4, Census Tract 6.01, Hennepin County, Minnesota",99,86,1,0,0,0,7,5,99,92,85,1,0,0,0,1,5,7,1,0,0,0,0,6,0
270530006014019,83,Columbia Park,11,11,1000000US270530006014019,"Block 4019, Block Group 4, Census Tract 6.01, Hennepin County, Minnesota",0,0,0,0,0,0,0,0,0,0,0,0,0,0,0,0,0,0,0,0,0,0,0,0,0
270530006014001,83,Columbia Park,11,11,1000000US270530006014001,"Block 4001, Block Group 4, Census Tract 6.01, Hennepin County, Minnesota",37,31,6,0,0,0,0,0,37,37,31,6,0,0,0,0,0,0,0,0,0,0,0,0,0
270531005001031,83,Columbia Park,11,11,1000000US270531005001031,"Block 1031, Block Group 1, Census Tract 1005, Hennepin County, Minnesota",1,1,0,0,0,0,0,0,1,1,1,0,0,0,0,0,0,0,0,0,0,0,0,0,0
270531005001027,83,Columbia Park,11,11,1000000US270531005001027,"Block 1027, Block Group 1, Census Tract 1005, Hennepin County, Minnesota",3,3,0,0,0,0,0,0,3,3,3,0,0,0,0,0,0,0,0,0,0,0,0,0,0
270531005001010,83,Columbia Park,11,11,1000000US270531005001010,"Block 1010, Block Group 1, Census Tract 1005, Hennepin County, Minnesota",0,0,0,0,0,0,0,0,0,0,0,0,0,0,0,0,0,0,0,0,0,0,0,0,0
270531005001026,83,Columbia Park,11,11,1000000US270531005001026,"Block 1026, Block Group 1, Census Tract 1005, Hennepin County, Minnesota",0,0,0,0,0,0,0,0,0,0,0,0,0,0,0,0,0,0,0,0,0,0,0,0,0
270531005001025,83,Columbia Park,11,11,1000000US270531005001025,"Block 1025, Block Group 1, Census Tract 1005, Hennepin County, Minnesota",0,0,0,0,0,0,0,0,0,0,0,0,0,0,0,0,0,0,0,0,0,0,0,0,0
270530006014016,83,Columbia Park,11,11,1000000US270530006014016,"Block 4016, Block Group 4, Census Tract 6.01, Hennepin County, Minnesota",0,0,0,0,0,0,0,0,0,0,0,0,0,0,0,0,0,0,0,0,0,0,0,0,0
270530006014017,83,Columbia Park,11,11,1000000US270530006014017,"Block 4017, Block Group 4, Census Tract 6.01, Hennepin County, Minnesota",0,0,0,0,0,0,0,0,0,0,0,0,0,0,0,0,0,0,0,0,0,0,0,0,0
270531005001001,83,Columbia Park,11,11,1000000US270531005001001,"Block 1001, Block Group 1, Census Tract 1005, Hennepin County, Minnesota",0,0,0,0,0,0,0,0,0,0,0,0,0,0,0,0,0,0,0,0,0,0,0,0,0
270531005001000,83,Columbia Park,11,11,1000000US270531005001000,"Block 1000, Block Group 1, Census Tract 1005, Hennepin County, Minnesota",0,0,0,0,0,0,0,0,0,0,0,0,0,0,0,0,0,0,0,0,0,0,0,0,0
270531005001012,83,Columbia Park,11,11,1000000US270531005001012,"Block 1012, Block Group 1, Census Tract 1005, Hennepin County, Minnesota",57,53,0,0,2,0,0,2,57,56,52,0,0,2,0,0,2,1,1,0,0,0,0,0,0
270531005001014,83,Columbia Park,11,11,1000000US270531005001014,"Block 1014, Block Group 1, Census Tract 1005, Hennepin County, Minnesota",47,38,1,0,0,0,0,8,47,38,29,1,0,0,0,0,8,9,9,0,0,0,0,0,0
270531005001024,83,Columbia Park,11,11,1000000US270531005001024,"Block 1024, Block Group 1, Census Tract 1005, Hennepin County, Minnesota",3,3,0,0,0,0,0,0,3,3,3,0,0,0,0,0,0,0,0,0,0,0,0,0,0
270530006014004,83,Columbia Park,11,11,1000000US270530006014004,"Block 4004, Block Group 4, Census Tract 6.01, Hennepin County, Minnesota",104,85,14,0,0,0,0,5,104,102,84,14,0,0,0,0,4,2,1,0,0,0,0,0,1
270530006014008,83,Columbia Park,11,11,1000000US270530006014008,"Block 4008, Block Group 4, Census Tract 6.01, Hennepin County, Minnesota",54,46,1,0,5,0,0,2,54,53,45,1,0,5,0,0,2,1,1,0,0,0,0,0,0
270530006014002,83,Columbia Park,11,11,1000000US270530006014002,"Block 4002, Block Group 4, Census Tract 6.01, Hennepin County, Minnesota",80,72,1,0,5,0,2,0,80,78,72,1,0,5,0,0,0,2,0,0,0,0,0,2,0
270530006031006,84,Waite Park,12,12,1000000US270530006031006,"Block 1006, Block Group 1, Census Tract 6.03, Hennepin County, Minnesota",153,135,0,0,8,0,3,7,153,149,134,0,0,8,0,0,7,4,1,0,0,0,0,3,0
270530006011019,84,Waite Park,12,12,1000000US270530006011019,"Block 1019, Block Group 1, Census Tract 6.01, Hennepin County, Minnesota",56,52,3,0,1,0,0,0,56,49,45,3,0,1,0,0,0,7,7,0,0,0,0,0,0
270530006011011,84,Waite Park,12,12,1000000US270530006011011,"Block 1011, Block Group 1, Census Tract 6.01, Hennepin County, Minnesota",58,49,0,0,0,0,8,1,58,47,46,0,0,0,0,0,1,11,3,0,0,0,0,8,0
270530006012001,84,Waite Park,12,12,1000000US270530006012001,"Block 2001, Block Group 2, Census Tract 6.01, Hennepin County, Minnesota",52,43,3,0,1,0,0,5,52,52,43,3,0,1,0,0,5,0,0,0,0,0,0,0,0
270530006032004,84,Waite Park,12,12,1000000US270530006032004,"Block 2004, Block Group 2, Census Tract 6.03, Hennepin County, Minnesota",58,50,0,0,0,0,7,1,58,49,48,0,0,0,0,0,1,9,2,0,0,0,0,7,0
270530006032011,84,Waite Park,12,12,1000000US270530006032011,"Block 2011, Block Group 2, Census Tract 6.03, Hennepin County, Minnesota",47,38,2,0,5,0,1,1,47,46,38,2,0,5,0,0,1,1,0,0,0,0,0,1,0
270530006033013,84,Waite Park,12,12,1000000US270530006033013,"Block 3013, Block Group 3, Census Tract 6.03, Hennepin County, Minnesota",56,53,0,0,0,0,1,2,56,56,53,0,0,0,0,1,2,0,0,0,0,0,0,0,0
270530006032001,84,Waite Park,12,12,1000000US270530006032001,"Block 2001, Block Group 2, Census Tract 6.03, Hennepin County, Minnesota",38,32,0,0,0,0,6,0,38,31,31,0,0,0,0,0,0,7,1,0,0,0,0,6,0
270530006032003,84,Waite Park,12,12,1000000US270530006032003,"Block 2003, Block Group 2, Census Tract 6.03, Hennepin County, Minnesota",78,65,0,1,8,0,0,4,78,77,64,0,1,8,0,0,4,1,1,0,0,0,0,0,0
270530006033003,84,Waite Park,12,12,1000000US270530006033003,"Block 3003, Block Group 3, Census Tract 6.03, Hennepin County, Minnesota",51,43,4,0,1,0,1,2,51,45,39,3,0,1,0,0,2,6,4,1,0,0,0,1,0
270530006031005,84,Waite Park,12,12,1000000US270530006031005,"Block 1005, Block Group 1, Census Tract 6.03, Hennepin County, Minnesota",40,37,0,1,0,0,2,0,40,38,37,0,1,0,0,0,0,2,0,0,0,0,0,2,0
270530006031007,84,Waite Park,12,12,1000000US270530006031007,"Block 1007, Block Group 1, Census Tract 6.03, Hennepin County, Minnesota",49,42,0,0,0,0,4,3,49,42,42,0,0,0,0,0,0,7,0,0,0,0,0,4,3
270530006031004,84,Waite Park,12,12,1000000US270530006031004,"Block 1004, Block Group 1, Census Tract 6.03, Hennepin County, Minnesota",35,31,0,0,4,0,0,0,35,35,31,0,0,4,0,0,0,0,0,0,0,0,0,0,0
270530006031008,84,Waite Park,12,12,1000000US270530006031008,"Block 1008, Block Group 1, Census Tract 6.03, Hennepin County, Minnesota",39,38,0,0,0,0,0,1,39,39,38,0,0,0,0,0,1,0,0,0,0,0,0,0,0
270530006033002,84,Waite Park,12,12,1000000US270530006033002,"Block 3002, Block Group 3, Census Tract 6.03, Hennepin County, Minnesota",61,52,8,0,0,0,0,1,61,61,52,8,0,0,0,0,1,0,0,0,0,0,0,0,0
270530006031000,84,Waite Park,12,12,1000000US270530006031000,"Block 1000, Block Group 1, Census Tract 6.03, Hennepin County, Minnesota",47,38,6,0,3,0,0,0,47,36,27,6,0,3,0,0,0,11,11,0,0,0,0,0,0
270530006031003,84,Waite Park,12,12,1000000US270530006031003,"Block 1003, Block Group 1, Census Tract 6.03, Hennepin County, Minnesota",43,43,0,0,0,0,0,0,43,42,42,0,0,0,0,0,0,1,1,0,0,0,0,0,0
270530006033004,84,Waite Park,12,12,1000000US270530006033004,"Block 3004, Block Group 3, Census Tract 6.03, Hennepin County, Minnesota",45,41,3,1,0,0,0,0,45,44,40,3,1,0,0,0,0,1,1,0,0,0,0,0,0
270530006033012,84,Waite Park,12,12,1000000US270530006033012,"Block 3012, Block Group 3, Census Tract 6.03, Hennepin County, Minnesota",69,65,0,0,0,0,0,4,69,62,61,0,0,0,0,0,1,7,4,0,0,0,0,0,3
270530006034016,84,Waite Park,12,12,1000000US270530006034016,"Block 4016, Block Group 4, Census Tract 6.03, Hennepin County, Minnesota",29,29,0,0,0,0,0,0,29,29,29,0,0,0,0,0,0,0,0,0,0,0,0,0,0
270530006033015,84,Waite Park,12,12,1000000US270530006033015,"Block 3015, Block Group 3, Census Tract 6.03, Hennepin County, Minnesota",65,55,1,0,0,0,7,2,65,55,51,1,0,0,0,1,2,10,4,0,0,0,0,6,0
270530006034008,84,Waite Park,12,12,1000000US270530006034008,"Block 4008, Block Group 4, Census Tract 6.03, Hennepin County, Minnesota",28,28,0,0,0,0,0,0,28,28,28,0,0,0,0,0,0,0,0,0,0,0,0,0,0
270530006034003,84,Waite Park,12,12,1000000US270530006034003,"Block 4003, Block Group 4, Census Tract 6.03, Hennepin County, Minnesota",55,54,0,0,0,0,0,1,55,55,54,0,0,0,0,0,1,0,0,0,0,0,0,0,0
270530006034012,84,Waite Park,12,12,1000000US270530006034012,"Block 4012, Block Group 4, Census Tract 6.03, Hennepin County, Minnesota",12,12,0,0,0,0,0,0,12,12,12,0,0,0,0,0,0,0,0,0,0,0,0,0,0
270530006034014,84,Waite Park,12,12,1000000US270530006034014,"Block 4014, Block Group 4, Census Tract 6.03, Hennepin County, Minnesota",2,1,0,0,0,0,1,0,2,1,1,0,0,0,0,0,0,1,0,0,0,0,0,1,0
270530006034010,84,Waite Park,12,12,1000000US270530006034010,"Block 4010, Block Group 4, Census Tract 6.03, Hennepin County, Minnesota",56,56,0,0,0,0,0,0,56,56,56,0,0,0,0,0,0,0,0,0,0,0,0,0,0
270530006033005,84,Waite Park,12,12,1000000US270530006033005,"Block 3005, Block Group 3, Census Tract 6.03, Hennepin County, Minnesota",63,62,0,0,1,0,0,0,63,51,50,0,0,1,0,0,0,12,12,0,0,0,0,0,0
270530006034009,84,Waite Park,12,12,1000000US270530006034009,"Block 4009, Block Group 4, Census Tract 6.03, Hennepin County, Minnesota",7,7,0,0,0,0,0,0,7,7,7,0,0,0,0,0,0,0,0,0,0,0,0,0,0
270530006033010,84,Waite Park,12,12,1000000US270530006033010,"Block 3010, Block Group 3, Census Tract 6.03, Hennepin County, Minnesota",55,54,0,0,0,0,0,1,55,54,53,0,0,0,0,0,1,1,1,0,0,0,0,0,0
270530006033011,84,Waite Park,12,12,1000000US270530006033011,"Block 3011, Block Group 3, Census Tract 6.03, Hennepin County, Minnesota",47,45,0,0,1,0,0,1,47,47,45,0,0,1,0,0,1,0,0,0,0,0,0,0,0
270530006034001,84,Waite Park,12,12,1000000US270530006034001,"Block 4001, Block Group 4, Census Tract 6.03, Hennepin County, Minnesota",35,31,0,0,2,0,0,2,35,33,29,0,0,2,0,0,2,2,2,0,0,0,0,0,0
270530006034017,84,Waite Park,12,12,1000000US270530006034017,"Block 4017, Block Group 4, Census Tract 6.03, Hennepin County, Minnesota",37,29,0,0,0,0,8,0,37,29,29,0,0,0,0,0,0,8,0,0,0,0,0,8,0
270530006034000,84,Waite Park,12,12,1000000US270530006034000,"Block 4000, Block Group 4, Census Tract 6.03, Hennepin County, Minnesota",41,41,0,0,0,0,0,0,41,39,39,0,0,0,0,0,0,2,2,0,0,0,0,0,0
270530006034013,84,Waite Park,12,12,1000000US270530006034013,"Block 4013, Block Group 4, Census Tract 6.03, Hennepin County, Minnesota",0,0,0,0,0,0,0,0,0,0,0,0,0,0,0,0,0,0,0,0,0,0,0,0,0
270530006012011,84,Waite Park,12,12,1000000US270530006012011,"Block 2011, Block Group 2, Census Tract 6.01, Hennepin County, Minnesota",58,55,0,0,1,0,0,2,58,56,53,0,0,1,0,0,2,2,2,0,0,0,0,0,0
270530006012019,84,Waite Park,12,12,1000000US270530006012019,"Block 2019, Block Group 2, Census Tract 6.01, Hennepin County, Minnesota",62,47,0,0,6,0,9,0,62,52,46,0,0,6,0,0,0,10,1,0,0,0,0,9,0
270530006033007,84,Waite Park,12,12,1000000US270530006033007,"Block 3007, Block Group 3, Census Tract 6.03, Hennepin County, Minnesota",47,45,1,0,1,0,0,0,47,47,45,1,0,1,0,0,0,0,0,0,0,0,0,0,0
270530006012026,84,Waite Park,12,12,1000000US270530006012026,"Block 2026, Block Group 2, Census Tract 6.01, Hennepin County, Minnesota",0,0,0,0,0,0,0,0,0,0,0,0,0,0,0,0,0,0,0,0,0,0,0,0,0
270530006011020,84,Waite Park,12,12,1000000US270530006011020,"Block 1020, Block Group 1, Census Tract 6.01, Hennepin County, Minnesota",52,40,2,0,4,0,6,0,52,42,36,2,0,4,0,0,0,10,4,0,0,0,0,6,0
270530006011008,84,Waite Park,12,12,1000000US270530006011008,"Block 1008, Block Group 1, Census Tract 6.01, Hennepin County, Minnesota",43,39,3,0,0,0,1,0,43,42,39,3,0,0,0,0,0,1,0,0,0,0,0,1,0
270530006011024,84,Waite Park,12,12,1000000US270530006011024,"Block 1024, Block Group 1, Census Tract 6.01, Hennepin County, Minnesota",54,42,0,0,10,0,0,2,54,54,42,0,0,10,0,0,2,0,0,0,0,0,0,0,0
270530006011023,84,Waite Park,12,12,1000000US270530006011023,"Block 1023, Block Group 1, Census Tract 6.01, Hennepin County, Minnesota",47,40,2,0,1,0,0,4,47,47,40,2,0,1,0,0,4,0,0,0,0,0,0,0,0
270530006012004,84,Waite Park,12,12,1000000US270530006012004,"Block 2004, Block Group 2, Census Tract 6.01, Hennepin County, Minnesota",49,44,1,0,0,0,2,2,49,38,36,0,0,0,0,0,2,11,8,1,0,0,0,2,0
270530006011014,84,Waite Park,12,12,1000000US270530006011014,"Block 1014, Block Group 1, Census Tract 6.01, Hennepin County, Minnesota",56,45,5,0,1,0,5,0,56,49,43,5,0,1,0,0,0,7,2,0,0,0,0,5,0
270530006012000,84,Waite Park,12,12,1000000US270530006012000,"Block 2000, Block Group 2, Census Tract 6.01, Hennepin County, Minnesota",49,36,4,0,4,0,5,0,49,43,35,4,0,4,0,0,0,6,1,0,0,0,0,5,0
270530006011021,84,Waite Park,12,12,1000000US270530006011021,"Block 1021, Block Group 1, Census Tract 6.01, Hennepin County, Minnesota",263,157,88,1,2,0,1,14,263,260,154,88,1,2,0,1,14,3,3,0,0,0,0,0,0
270530006011026,84,Waite Park,12,12,1000000US270530006011026,"Block 1026, Block Group 1, Census Tract 6.01, Hennepin County, Minnesota",25,9,10,0,0,0,2,4,25,25,9,10,0,0,0,2,4,0,0,0,0,0,0,0,0
270530006011001,84,Waite Park,12,12,1000000US270530006011001,"Block 1001, Block Group 1, Census Tract 6.01, Hennepin County, Minnesota",18,15,0,0,3,0,0,0,18,18,15,0,0,3,0,0,0,0,0,0,0,0,0,0,0
270530006011016,84,Waite Park,12,12,1000000US270530006011016,"Block 1016, Block Group 1, Census Tract 6.01, Hennepin County, Minnesota",50,42,0,1,3,0,2,2,50,48,42,0,1,3,0,0,2,2,0,0,0,0,0,2,0
270530006012007,84,Waite Park,12,12,1000000US270530006012007,"Block 2007, Block Group 2, Census Tract 6.01, Hennepin County, Minnesota",51,42,0,0,6,0,1,2,51,44,36,0,0,6,0,0,2,7,6,0,0,0,0,1,0
270530006011000,84,Waite Park,12,12,1000000US270530006011000,"Block 1000, Block Group 1, Census Tract 6.01, Hennepin County, Minnesota",115,98,0,0,10,1,0,6,115,111,94,0,0,10,1,0,6,4,4,0,0,0,0,0,0
270530006011010,84,Waite Park,12,12,1000000US270530006011010,"Block 1010, Block Group 1, Census Tract 6.01, Hennepin County, Minnesota",54,51,0,2,0,0,0,1,54,51,48,0,2,0,0,0,1,3,3,0,0,0,0,0,0
270530006012002,84,Waite Park,12,12,1000000US270530006012002,"Block 2002, Block Group 2, Census Tract 6.01, Hennepin County, Minnesota",48,44,0,0,3,0,1,0,48,48,44,0,0,3,0,1,0,0,0,0,0,0,0,0,0
270530006032006,84,Waite Park,12,12,1000000US270530006032006,"Block 2006, Block Group 2, Census Tract 6.03, Hennepin County, Minnesota",34,30,0,0,3,0,0,1,34,34,30,0,0,3,0,0,1,0,0,0,0,0,0,0,0
270530006032009,84,Waite Park,12,12,1000000US270530006032009,"Block 2009, Block Group 2, Census Tract 6.03, Hennepin County, Minnesota",0,0,0,0,0,0,0,0,0,0,0,0,0,0,0,0,0,0,0,0,0,0,0,0,0
270530006011006,84,Waite Park,12,12,1000000US270530006011006,"Block 1006, Block Group 1, Census Tract 6.01, Hennepin County, Minnesota",39,29,2,0,5,0,3,0,39,31,24,2,0,5,0,0,0,8,5,0,0,0,0,3,0
270530006011005,84,Waite Park,12,12,1000000US270530006011005,"Block 1005, Block Group 1, Census Tract 6.01, Hennepin County, Minnesota",12,7,0,0,5,0,0,0,12,12,7,0,0,5,0,0,0,0,0,0,0,0,0,0,0
270530006011009,84,Waite Park,12,12,1000000US270530006011009,"Block 1009, Block Group 1, Census Tract 6.01, Hennepin County, Minnesota",25,22,2,0,0,0,0,1,25,25,22,2,0,0,0,0,1,0,0,0,0,0,0,0,0
270530006011017,84,Waite Park,12,12,1000000US270530006011017,"Block 1017, Block Group 1, Census Tract 6.01, Hennepin County, Minnesota",75,67,0,0,5,0,0,3,75,75,67,0,0,5,0,0,3,0,0,0,0,0,0,0,0
270530006012005,84,Waite Park,12,12,1000000US270530006012005,"Block 2005, Block Group 2, Census Tract 6.01, Hennepin County, Minnesota",54,42,2,1,3,0,0,6,54,40,33,1,1,3,0,0,2,14,9,1,0,0,0,0,4
270530006011003,84,Waite Park,12,12,1000000US270530006011003,"Block 1003, Block Group 1, Census Tract 6.01, Hennepin County, Minnesota",16,13,1,0,2,0,0,0,16,16,13,1,0,2,0,0,0,0,0,0,0,0,0,0,0
270530006032002,84,Waite Park,12,12,1000000US270530006032002,"Block 2002, Block Group 2, Census Tract 6.03, Hennepin County, Minnesota",47,40,0,5,0,0,0,2,47,47,40,0,5,0,0,0,2,0,0,0,0,0,0,0,0
270530006011015,84,Waite Park,12,12,1000000US270530006011015,"Block 1015, Block Group 1, Census Tract 6.01, Hennepin County, Minnesota",59,54,0,0,0,0,2,3,59,57,54,0,0,0,0,0,3,2,0,0,0,0,0,2,0
270530006032005,84,Waite Park,12,12,1000000US270530006032005,"Block 2005, Block Group 2, Census Tract 6.03, Hennepin County, Minnesota",14,11,0,0,1,0,0,2,14,14,11,0,0,1,0,0,2,0,0,0,0,0,0,0,0
270530006031001,84,Waite Park,12,12,1000000US270530006031001,"Block 1001, Block Group 1, Census Tract 6.03, Hennepin County, Minnesota",87,66,2,0,12,0,4,3,87,87,66,2,0,12,0,4,3,0,0,0,0,0,0,0,0
270530006011013,84,Waite Park,12,12,1000000US270530006011013,"Block 1013, Block Group 1, Census Tract 6.01, Hennepin County, Minnesota",46,43,1,2,0,0,0,0,46,43,41,1,1,0,0,0,0,3,2,0,1,0,0,0,0
270530006031002,84,Waite Park,12,12,1000000US270530006031002,"Block 1002, Block Group 1, Census Tract 6.03, Hennepin County, Minnesota",55,50,0,1,4,0,0,0,55,55,50,0,1,4,0,0,0,0,0,0,0,0,0,0,0
270530006033001,84,Waite Park,12,12,1000000US270530006033001,"Block 3001, Block Group 3, Census Tract 6.03, Hennepin County, Minnesota",54,51,0,0,3,0,0,0,54,51,48,0,0,3,0,0,0,3,3,0,0,0,0,0,0
270530006034011,84,Waite Park,12,12,1000000US270530006034011,"Block 4011, Block Group 4, Census Tract 6.03, Hennepin County, Minnesota",74,73,0,0,1,0,0,0,74,74,73,0,0,1,0,0,0,0,0,0,0,0,0,0,0
270530006034007,84,Waite Park,12,12,1000000US270530006034007,"Block 4007, Block Group 4, Census Tract 6.03, Hennepin County, Minnesota",50,48,0,1,0,0,0,1,50,49,48,0,0,0,0,0,1,1,0,0,1,0,0,0,0
270530006033000,84,Waite Park,12,12,1000000US270530006033000,"Block 3000, Block Group 3, Census Tract 6.03, Hennepin County, Minnesota",69,52,12,0,3,0,0,2,69,67,50,12,0,3,0,0,2,2,2,0,0,0,0,0,0
270530006012022,84,Waite Park,12,12,1000000US270530006012022,"Block 2022, Block Group 2, Census Tract 6.01, Hennepin County, Minnesota",0,0,0,0,0,0,0,0,0,0,0,0,0,0,0,0,0,0,0,0,0,0,0,0,0
270530006012009,84,Waite Park,12,12,1000000US270530006012009,"Block 2009, Block Group 2, Census Tract 6.01, Hennepin County, Minnesota",56,46,0,0,0,0,0,10,56,50,43,0,0,0,0,0,7,6,3,0,0,0,0,0,3
270530006012012,84,Waite Park,12,12,1000000US270530006012012,"Block 2012, Block Group 2, Census Tract 6.01, Hennepin County, Minnesota",48,45,2,0,1,0,0,0,48,48,45,2,0,1,0,0,0,0,0,0,0,0,0,0,0
270530006012018,84,Waite Park,12,12,1000000US270530006012018,"Block 2018, Block Group 2, Census Tract 6.01, Hennepin County, Minnesota",42,42,0,0,0,0,0,0,42,41,41,0,0,0,0,0,0,1,1,0,0,0,0,0,0
270530006012008,84,Waite Park,12,12,1000000US270530006012008,"Block 2008, Block Group 2, Census Tract 6.01, Hennepin County, Minnesota",83,39,12,1,7,0,17,7,83,67,39,12,1,7,0,1,7,16,0,0,0,0,0,16,0
270530006012017,84,Waite Park,12,12,1000000US270530006012017,"Block 2017, Block Group 2, Census Tract 6.01, Hennepin County, Minnesota",50,39,0,0,0,0,6,5,50,42,39,0,0,0,0,0,3,8,0,0,0,0,0,6,2
270530006012025,84,Waite Park,12,12,1000000US270530006012025,"Block 2025, Block Group 2, Census Tract 6.01, Hennepin County, Minnesota",0,0,0,0,0,0,0,0,0,0,0,0,0,0,0,0,0,0,0,0,0,0,0,0,0
270530006012010,84,Waite Park,12,12,1000000US270530006012010,"Block 2010, Block Group 2, Census Tract 6.01, Hennepin County, Minnesota",50,47,1,0,0,0,0,2,50,46,43,1,0,0,0,0,2,4,4,0,0,0,0,0,0
270530006012023,84,Waite Park,12,12,1000000US270530006012023,"Block 2023, Block Group 2, Census Tract 6.01, Hennepin County, Minnesota",0,0,0,0,0,0,0,0,0,0,0,0,0,0,0,0,0,0,0,0,0,0,0,0,0
270530006033009,84,Waite Park,12,12,1000000US270530006033009,"Block 3009, Block Group 3, Census Tract 6.03, Hennepin County, Minnesota",48,46,0,0,0,0,0,2,48,45,43,0,0,0,0,0,2,3,3,0,0,0,0,0,0
270530006012024,84,Waite Park,12,12,1000000US270530006012024,"Block 2024, Block Group 2, Census Tract 6.01, Hennepin County, Minnesota",0,0,0,0,0,0,0,0,0,0,0,0,0,0,0,0,0,0,0,0,0,0,0,0,0
270530006012016,84,Waite Park,12,12,1000000US270530006012016,"Block 2016, Block Group 2, Census Tract 6.01, Hennepin County, Minnesota",51,42,0,0,1,0,6,2,51,44,42,0,0,1,0,0,1,7,0,0,0,0,0,6,1
270530006033008,84,Waite Park,12,12,1000000US270530006033008,"Block 3008, Block Group 3, Census Tract 6.03, Hennepin County, Minnesota",56,44,1,2,3,0,2,4,56,50,43,1,0,3,0,0,3,6,1,0,2,0,0,2,1
270530006034006,84,Waite Park,12,12,1000000US270530006034006,"Block 4006, Block Group 4, Census Tract 6.03, Hennepin County, Minnesota",0,0,0,0,0,0,0,0,0,0,0,0,0,0,0,0,0,0,0,0,0,0,0,0,0
270530006012013,84,Waite Park,12,12,1000000US270530006012013,"Block 2013, Block Group 2, Census Tract 6.01, Hennepin County, Minnesota",51,48,0,2,0,0,0,1,51,51,48,0,2,0,0,0,1,0,0,0,0,0,0,0,0
270530006012015,84,Waite Park,12,12,1000000US270530006012015,"Block 2015, Block Group 2, Census Tract 6.01, Hennepin County, Minnesota",52,41,3,0,2,0,4,2,52,36,30,3,0,2,0,0,1,16,11,0,0,0,0,4,1
270530006034004,84,Waite Park,12,12,1000000US270530006034004,"Block 4004, Block Group 4, Census Tract 6.03, Hennepin County, Minnesota",93,81,1,1,6,0,1,3,93,91,80,1,1,6,0,0,3,2,1,0,0,0,0,1,0
270530006033014,84,Waite Park,12,12,1000000US270530006033014,"Block 3014, Block Group 3, Census Tract 6.03, Hennepin County, Minnesota",49,45,0,1,1,0,0,2,49,47,44,0,1,1,0,0,1,2,1,0,0,0,0,0,1
270530006034002,84,Waite Park,12,12,1000000US270530006034002,"Block 4002, Block Group 4, Census Tract 6.03, Hennepin County, Minnesota",60,55,2,0,0,0,0,3,60,60,55,2,0,0,0,0,3,0,0,0,0,0,0,0,0
270530006034015,84,Waite Park,12,12,1000000US270530006034015,"Block 4015, Block Group 4, Census Tract 6.03, Hennepin County, Minnesota",39,35,3,0,1,0,0,0,39,39,35,3,0,1,0,0,0,0,0,0,0,0,0,0,0
270530006011004,84,Waite Park,12,12,1000000US270530006011004,"Block 1004, Block Group 1, Census Tract 6.01, Hennepin County, Minnesota",35,29,0,0,0,0,4,2,35,25,25,0,0,0,0,0,0,10,4,0,0,0,0,4,2
270530006011007,84,Waite Park,12,12,1000000US270530006011007,"Block 1007, Block Group 1, Census Tract 6.01, Hennepin County, Minnesota",11,4,0,0,2,0,4,1,11,6,4,0,0,2,0,0,0,5,0,0,0,0,0,4,1
270530006011022,84,Waite Park,12,12,1000000US270530006011022,"Block 1022, Block Group 1, Census Tract 6.01, Hennepin County, Minnesota",63,50,7,0,0,0,4,2,63,56,47,7,0,0,0,0,2,7,3,0,0,0,0,4,0
270530006032000,84,Waite Park,12,12,1000000US270530006032000,"Block 2000, Block Group 2, Census Tract 6.03, Hennepin County, Minnesota",65,49,9,1,6,0,0,0,65,65,49,9,1,6,0,0,0,0,0,0,0,0,0,0,0
270530006011025,84,Waite Park,12,12,1000000US270530006011025,"Block 1025, Block Group 1, Census Tract 6.01, Hennepin County, Minnesota",0,0,0,0,0,0,0,0,0,0,0,0,0,0,0,0,0,0,0,0,0,0,0,0,0
270530006032010,84,Waite Park,12,12,1000000US270530006032010,"Block 2010, Block Group 2, Census Tract 6.03, Hennepin County, Minnesota",60,53,4,0,0,0,0,3,60,60,53,4,0,0,0,0,3,0,0,0,0,0,0,0,0
270530006032008,84,Waite Park,12,12,1000000US270530006032008,"Block 2008, Block Group 2, Census Tract 6.03, Hennepin County, Minnesota",196,175,0,3,6,0,5,7,196,177,168,0,2,6,0,0,1,19,7,0,1,0,0,5,6
270530006012021,84,Waite Park,12,12,1000000US270530006012021,"Block 2021, Block Group 2, Census Tract 6.01, Hennepin County, Minnesota",0,0,0,0,0,0,0,0,0,0,0,0,0,0,0,0,0,0,0,0,0,0,0,0,0
270530006012020,84,Waite Park,12,12,1000000US270530006012020,"Block 2020, Block Group 2, Census Tract 6.01, Hennepin County, Minnesota",0,0,0,0,0,0,0,0,0,0,0,0,0,0,0,0,0,0,0,0,0,0,0,0,0
270530006012014,84,Waite Park,12,12,1000000US270530006012014,"Block 2014, Block Group 2, Census Tract 6.01, Hennepin County, Minnesota",52,51,0,0,0,0,0,1,52,47,46,0,0,0,0,0,1,5,5,0,0,0,0,0,0
270530006033006,84,Waite Park,12,12,1000000US270530006033006,"Block 3006, Block Group 3, Census Tract 6.03, Hennepin County, Minnesota",55,47,0,0,5,0,0,3,55,55,47,0,0,5,0,0,3,0,0,0,0,0,0,0,0
270530006034005,84,Waite Park,12,12,1000000US270530006034005,"Block 4005, Block Group 4, Census Tract 6.03, Hennepin County, Minnesota",6,6,0,0,0,0,0,0,6,6,6,0,0,0,0,0,0,0,0,0,0,0,0,0,0
270530006012006,84,Waite Park,12,12,1000000US270530006012006,"Block 2006, Block Group 2, Census Tract 6.01, Hennepin County, Minnesota",65,54,3,0,0,0,0,8,65,57,54,3,0,0,0,0,0,8,0,0,0,0,0,0,8
270530006011018,84,Waite Park,12,12,1000000US270530006011018,"Block 1018, Block Group 1, Census Tract 6.01, Hennepin County, Minnesota",64,53,0,1,10,0,0,0,64,63,52,0,1,10,0,0,0,1,1,0,0,0,0,0,0
270530006011002,84,Waite Park,12,12,1000000US270530006011002,"Block 1002, Block Group 1, Census Tract 6.01, Hennepin County, Minnesota",14,9,0,0,5,0,0,0,14,14,9,0,0,5,0,0,0,0,0,0,0,0,0,0,0
270530006012003,84,Waite Park,12,12,1000000US270530006012003,"Block 2003, Block Group 2, Census Tract 6.01, Hennepin County, Minnesota",60,50,4,0,0,0,2,4,60,54,48,4,0,0,0,0,2,6,2,0,0,0,0,2,2
270530006011012,84,Waite Park,12,12,1000000US270530006011012,"Block 1012, Block Group 1, Census Tract 6.01, Hennepin County, Minnesota",62,52,4,0,0,0,4,2,62,57,51,4,0,0,0,0,2,5,1,0,0,0,0,4,0
270530006032007,84,Waite Park,12,12,1000000US270530006032007,"Block 2007, Block Group 2, Census Tract 6.03, Hennepin County, Minnesota",50,44,1,0,4,0,0,1,50,50,44,1,0,4,0,0,1,0,0,0,0,0,0,0,0
270531005002009,85,Marshall Terrace,13,13,1000000US270531005002009,"Block 2009, Block Group 2, Census Tract 1005, Hennepin County, Minnesota",0,0,0,0,0,0,0,0,0,0,0,0,0,0,0,0,0,0,0,0,0,0,0,0,0
270531005002002,85,Marshall Terrace,13,13,1000000US270531005002002,"Block 2002, Block Group 2, Census Tract 1005, Hennepin County, Minnesota",0,0,0,0,0,0,0,0,0,0,0,0,0,0,0,0,0,0,0,0,0,0,0,0,0
270531005001028,85,Marshall Terrace,13,13,1000000US270531005001028,"Block 1028, Block Group 1, Census Tract 1005, Hennepin County, Minnesota",0,0,0,0,0,0,0,0,0,0,0,0,0,0,0,0,0,0,0,0,0,0,0,0,0
270531005002004,85,Marshall Terrace,13,13,1000000US270531005002004,"Block 2004, Block Group 2, Census Tract 1005, Hennepin County, Minnesota",80,62,11,1,2,1,0,3,80,79,62,11,1,2,1,0,2,1,0,0,0,0,0,0,1
270531005002008,85,Marshall Terrace,13,13,1000000US270531005002008,"Block 2008, Block Group 2, Census Tract 1005, Hennepin County, Minnesota",0,0,0,0,0,0,0,0,0,0,0,0,0,0,0,0,0,0,0,0,0,0,0,0,0
270531005002006,85,Marshall Terrace,13,13,1000000US270531005002006,"Block 2006, Block Group 2, Census Tract 1005, Hennepin County, Minnesota",0,0,0,0,0,0,0,0,0,0,0,0,0,0,0,0,0,0,0,0,0,0,0,0,0
270531005002032,85,Marshall Terrace,13,13,1000000US270531005002032,"Block 2032, Block Group 2, Census Tract 1005, Hennepin County, Minnesota",57,31,3,4,0,0,15,4,57,41,31,3,4,0,0,2,1,16,0,0,0,0,0,13,3
270531005002023,85,Marshall Terrace,13,13,1000000US270531005002023,"Block 2023, Block Group 2, Census Tract 1005, Hennepin County, Minnesota",51,40,6,3,0,0,0,2,51,50,40,6,2,0,0,0,2,1,0,0,1,0,0,0,0
270531005002024,85,Marshall Terrace,13,13,1000000US270531005002024,"Block 2024, Block Group 2, Census Tract 1005, Hennepin County, Minnesota",88,55,7,4,0,0,18,4,88,57,42,7,4,0,0,0,4,31,13,0,0,0,0,18,0
270531005002005,85,Marshall Terrace,13,13,1000000US270531005002005,"Block 2005, Block Group 2, Census Tract 1005, Hennepin County, Minnesota",0,0,0,0,0,0,0,0,0,0,0,0,0,0,0,0,0,0,0,0,0,0,0,0,0
270531005002027,85,Marshall Terrace,13,13,1000000US270531005002027,"Block 2027, Block Group 2, Census Tract 1005, Hennepin County, Minnesota",0,0,0,0,0,0,0,0,0,0,0,0,0,0,0,0,0,0,0,0,0,0,0,0,0
270531005002003,85,Marshall Terrace,13,13,1000000US270531005002003,"Block 2003, Block Group 2, Census Tract 1005, Hennepin County, Minnesota",0,0,0,0,0,0,0,0,0,0,0,0,0,0,0,0,0,0,0,0,0,0,0,0,0
270531005002014,85,Marshall Terrace,13,13,1000000US270531005002014,"Block 2014, Block Group 2, Census Tract 1005, Hennepin County, Minnesota",46,39,7,0,0,0,0,0,46,40,33,7,0,0,0,0,0,6,6,0,0,0,0,0,0
270531005002012,85,Marshall Terrace,13,13,1000000US270531005002012,"Block 2012, Block Group 2, Census Tract 1005, Hennepin County, Minnesota",52,45,0,0,2,0,0,5,52,52,45,0,0,2,0,0,5,0,0,0,0,0,0,0,0
270531005002013,85,Marshall Terrace,13,13,1000000US270531005002013,"Block 2013, Block Group 2, Census Tract 1005, Hennepin County, Minnesota",45,35,3,0,0,0,4,3,45,41,35,3,0,0,0,0,3,4,0,0,0,0,0,4,0
270531005002029,85,Marshall Terrace,13,13,1000000US270531005002029,"Block 2029, Block Group 2, Census Tract 1005, Hennepin County, Minnesota",84,51,9,6,7,0,3,8,84,76,51,9,6,7,0,0,3,8,0,0,0,0,0,3,5
270530006014023,85,Marshall Terrace,13,13,1000000US270530006014023,"Block 4023, Block Group 4, Census Tract 6.01, Hennepin County, Minnesota",0,0,0,0,0,0,0,0,0,0,0,0,0,0,0,0,0,0,0,0,0,0,0,0,0
270531005002036,85,Marshall Terrace,13,13,1000000US270531005002036,"Block 2036, Block Group 2, Census Tract 1005, Hennepin County, Minnesota",56,32,1,5,8,0,10,0,56,45,31,1,5,8,0,0,0,11,1,0,0,0,0,10,0
270531005002000,85,Marshall Terrace,13,13,1000000US270531005002000,"Block 2000, Block Group 2, Census Tract 1005, Hennepin County, Minnesota",0,0,0,0,0,0,0,0,0,0,0,0,0,0,0,0,0,0,0,0,0,0,0,0,0
270531005002011,85,Marshall Terrace,13,13,1000000US270531005002011,"Block 2011, Block Group 2, Census Tract 1005, Hennepin County, Minnesota",63,41,11,2,2,0,0,7,63,63,41,11,2,2,0,0,7,0,0,0,0,0,0,0,0
270531005002030,85,Marshall Terrace,13,13,1000000US270531005002030,"Block 2030, Block Group 2, Census Tract 1005, Hennepin County, Minnesota",86,51,9,4,4,0,12,6,86,75,46,9,4,4,0,7,5,11,5,0,0,0,0,5,1
270530006014024,85,Marshall Terrace,13,13,1000000US270530006014024,"Block 4024, Block Group 4, Census Tract 6.01, Hennepin County, Minnesota",0,0,0,0,0,0,0,0,0,0,0,0,0,0,0,0,0,0,0,0,0,0,0,0,0
270531005002034,85,Marshall Terrace,13,13,1000000US270531005002034,"Block 2034, Block Group 2, Census Tract 1005, Hennepin County, Minnesota",50,28,9,0,6,0,0,7,50,41,20,9,0,6,0,0,6,9,8,0,0,0,0,0,1
270531005002028,85,Marshall Terrace,13,13,1000000US270531005002028,"Block 2028, Block Group 2, Census Tract 1005, Hennepin County, Minnesota",0,0,0,0,0,0,0,0,0,0,0,0,0,0,0,0,0,0,0,0,0,0,0,0,0
270531005002007,85,Marshall Terrace,13,13,1000000US270531005002007,"Block 2007, Block Group 2, Census Tract 1005, Hennepin County, Minnesota",0,0,0,0,0,0,0,0,0,0,0,0,0,0,0,0,0,0,0,0,0,0,0,0,0
270531005002031,85,Marshall Terrace,13,13,1000000US270531005002031,"Block 2031, Block Group 2, Census Tract 1005, Hennepin County, Minnesota",51,40,3,3,1,0,0,4,51,50,40,3,3,1,0,0,3,1,0,0,0,0,0,0,1
270531005002001,85,Marshall Terrace,13,13,1000000US270531005002001,"Block 2001, Block Group 2, Census Tract 1005, Hennepin County, Minnesota",0,0,0,0,0,0,0,0,0,0,0,0,0,0,0,0,0,0,0,0,0,0,0,0,0
270531005002021,85,Marshall Terrace,13,13,1000000US270531005002021,"Block 2021, Block Group 2, Census Tract 1005, Hennepin County, Minnesota",79,45,10,0,16,0,1,7,79,75,42,10,0,16,0,0,7,4,3,0,0,0,0,1,0
270531005002025,85,Marshall Terrace,13,13,1000000US270531005002025,"Block 2025, Block Group 2, Census Tract 1005, Hennepin County, Minnesota",0,0,0,0,0,0,0,0,0,0,0,0,0,0,0,0,0,0,0,0,0,0,0,0,0
270531005002010,85,Marshall Terrace,13,13,1000000US270531005002010,"Block 2010, Block Group 2, Census Tract 1005, Hennepin County, Minnesota",84,42,19,19,0,0,0,4,84,71,31,19,18,0,0,0,3,13,11,0,1,0,0,0,1
270531005002035,85,Marshall Terrace,13,13,1000000US270531005002035,"Block 2035, Block Group 2, Census Tract 1005, Hennepin County, Minnesota",63,48,6,0,6,0,0,3,63,54,40,5,0,6,0,0,3,9,8,1,0,0,0,0,0
270531005002015,85,Marshall Terrace,13,13,1000000US270531005002015,"Block 2015, Block Group 2, Census Tract 1005, Hennepin County, Minnesota",69,53,4,7,0,0,0,5,69,68,52,4,7,0,0,0,5,1,1,0,0,0,0,0,0
270531005002026,85,Marshall Terrace,13,13,1000000US270531005002026,"Block 2026, Block Group 2, Census Tract 1005, Hennepin County, Minnesota",0,0,0,0,0,0,0,0,0,0,0,0,0,0,0,0,0,0,0,0,0,0,0,0,0
270531005002019,85,Marshall Terrace,13,13,1000000US270531005002019,"Block 2019, Block Group 2, Census Tract 1005, Hennepin County, Minnesota",114,100,10,1,2,0,0,1,114,114,100,10,1,2,0,0,1,0,0,0,0,0,0,0,0
270531005002020,85,Marshall Terrace,13,13,1000000US270531005002020,"Block 2020, Block Group 2, Census Tract 1005, Hennepin County, Minnesota",27,20,5,1,0,0,0,1,27,27,20,5,1,0,0,0,1,0,0,0,0,0,0,0,0
270531005002022,85,Marshall Terrace,13,13,1000000US270531005002022,"Block 2022, Block Group 2, Census Tract 1005, Hennepin County, Minnesota",28,22,2,3,1,0,0,0,28,28,22,2,3,1,0,0,0,0,0,0,0,0,0,0,0
270531005002018,85,Marshall Terrace,13,13,1000000US270531005002018,"Block 2018, Block Group 2, Census Tract 1005, Hennepin County, Minnesota",24,23,0,0,0,0,0,1,24,24,23,0,0,0,0,0,1,0,0,0,0,0,0,0,0
270531005002017,85,Marshall Terrace,13,13,1000000US270531005002017,"Block 2017, Block Group 2, Census Tract 1005, Hennepin County, Minnesota",0,0,0,0,0,0,0,0,0,0,0,0,0,0,0,0,0,0,0,0,0,0,0,0,0
270531005002016,85,Marshall Terrace,13,13,1000000US270531005002016,"Block 2016, Block Group 2, Census Tract 1005, Hennepin County, Minnesota",54,33,21,0,0,0,0,0,54,51,30,21,0,0,0,0,0,3,3,0,0,0,0,0,0
270531005002033,85,Marshall Terrace,13,13,1000000US270531005002033,"Block 2033, Block Group 2, Census Tract 1005, Hennepin County, Minnesota",30,22,7,1,0,0,0,0,30,30,22,7,1,0,0,0,0,0,0,0,0,0,0,0,0
270531070003002,86,Whittier,51,51,1000000US270531070003002,"Block 3002, Block Group 3, Census Tract 1070, Hennepin County, Minnesota",192,99,47,1,2,0,32,11,192,135,79,47,1,2,0,0,6,57,20,0,0,0,0,32,5
270531069002004,86,Whittier,51,51,1000000US270531069002004,"Block 2004, Block Group 2, Census Tract 1069, Hennepin County, Minnesota",0,0,0,0,0,0,0,0,0,0,0,0,0,0,0,0,0,0,0,0,0,0,0,0,0
270530077001018,86,Whittier,51,51,1000000US270530077001018,"Block 1018, Block Group 1, Census Tract 77, Hennepin County, Minnesota",242,71,141,7,1,0,12,10,242,212,56,140,5,1,0,0,10,30,15,1,2,0,0,12,0
270530068001001,86,Whittier,51,51,1000000US270530068001001,"Block 1001, Block Group 1, Census Tract 68, Hennepin County, Minnesota",174,80,68,8,0,0,12,6,174,146,69,67,6,0,0,0,4,28,11,1,2,0,0,12,2
270530077001004,86,Whittier,51,51,1000000US270530077001004,"Block 1004, Block Group 1, Census Tract 77, Hennepin County, Minnesota",124,38,56,9,0,0,15,6,124,100,35,56,3,0,0,0,6,24,3,0,6,0,0,15,0
270531070001002,86,Whittier,51,51,1000000US270531070001002,"Block 1002, Block Group 1, Census Tract 1070, Hennepin County, Minnesota",203,119,47,9,3,0,19,6,203,170,112,47,5,3,0,0,3,33,7,0,4,0,0,19,3
270530077001000,86,Whittier,51,51,1000000US270530077001000,"Block 1000, Block Group 1, Census Tract 77, Hennepin County, Minnesota",29,6,8,7,5,0,1,2,29,28,6,8,7,5,0,0,2,1,0,0,0,0,0,1,0
270530078012001,86,Whittier,51,51,1000000US270530078012001,"Block 2001, Block Group 2, Census Tract 78.01, Hennepin County, Minnesota",187,24,143,3,1,0,3,13,187,176,16,143,3,1,0,0,13,11,8,0,0,0,0,3,0
270531069002001,86,Whittier,51,51,1000000US270531069002001,"Block 2001, Block Group 2, Census Tract 1069, Hennepin County, Minnesota",102,51,18,21,0,0,8,4,102,78,43,18,15,0,0,0,2,24,8,0,6,0,0,8,2
270531070003001,86,Whittier,51,51,1000000US270531070003001,"Block 3001, Block Group 3, Census Tract 1070, Hennepin County, Minnesota",81,53,17,1,3,0,4,3,81,74,51,16,1,3,0,0,3,7,2,1,0,0,0,4,0
270530068002003,86,Whittier,51,51,1000000US270530068002003,"Block 2003, Block Group 2, Census Tract 68, Hennepin County, Minnesota",37,35,0,1,0,0,0,1,37,37,35,0,1,0,0,0,1,0,0,0,0,0,0,0,0
270530068003004,86,Whittier,51,51,1000000US270530068003004,"Block 3004, Block Group 3, Census Tract 68, Hennepin County, Minnesota",133,114,2,5,5,0,1,6,133,127,114,2,0,5,0,0,6,6,0,0,5,0,0,1,0
270531070003003,86,Whittier,51,51,1000000US270531070003003,"Block 3003, Block Group 3, Census Tract 1070, Hennepin County, Minnesota",170,145,10,5,3,0,2,5,170,160,142,9,0,3,0,2,4,10,3,1,5,0,0,0,1
270531070002005,86,Whittier,51,51,1000000US270531070002005,"Block 2005, Block Group 2, Census Tract 1070, Hennepin County, Minnesota",113,85,15,2,4,0,5,2,113,105,83,14,2,4,0,0,2,8,2,1,0,0,0,5,0
270530077001007,86,Whittier,51,51,1000000US270530077001007,"Block 1007, Block Group 1, Census Tract 77, Hennepin County, Minnesota",112,68,4,5,2,0,28,5,112,80,65,4,5,2,0,0,4,32,3,0,0,0,0,28,1
270530077001005,86,Whittier,51,51,1000000US270530077001005,"Block 1005, Block Group 1, Census Tract 77, Hennepin County, Minnesota",93,47,39,1,1,0,3,2,93,89,46,39,1,1,0,0,2,4,1,0,0,0,0,3,0
270530068002007,86,Whittier,51,51,1000000US270530068002007,"Block 2007, Block Group 2, Census Tract 68, Hennepin County, Minnesota",106,98,2,1,0,0,0,5,106,101,94,2,1,0,0,0,4,5,4,0,0,0,0,0,1
270531070002006,86,Whittier,51,51,1000000US270531070002006,"Block 2006, Block Group 2, Census Tract 1070, Hennepin County, Minnesota",52,39,3,0,1,1,5,3,52,45,37,3,0,1,1,0,3,7,2,0,0,0,0,5,0
270530077001019,86,Whittier,51,51,1000000US270530077001019,"Block 1019, Block Group 1, Census Tract 77, Hennepin County, Minnesota",0,0,0,0,0,0,0,0,0,0,0,0,0,0,0,0,0,0,0,0,0,0,0,0,0
270530077001011,86,Whittier,51,51,1000000US270530077001011,"Block 1011, Block Group 1, Census Tract 77, Hennepin County, Minnesota",22,2,14,3,0,0,2,1,22,20,2,14,3,0,0,0,1,2,0,0,0,0,0,2,0
270530068002002,86,Whittier,51,51,1000000US270530068002002,"Block 2002, Block Group 2, Census Tract 68, Hennepin County, Minnesota",142,113,21,0,3,0,0,5,142,139,111,21,0,3,0,0,4,3,2,0,0,0,0,0,1
270530077001003,86,Whittier,51,51,1000000US270530077001003,"Block 1003, Block Group 1, Census Tract 77, Hennepin County, Minnesota",232,80,69,15,2,0,61,5,232,132,46,65,15,2,0,0,4,100,34,4,0,0,0,61,1
270531069002007,86,Whittier,51,51,1000000US270531069002007,"Block 2007, Block Group 2, Census Tract 1069, Hennepin County, Minnesota",213,181,12,3,13,0,2,2,213,191,165,11,3,10,0,0,2,22,16,1,0,3,0,2,0
270530078012002,86,Whittier,51,51,1000000US270530078012002,"Block 2002, Block Group 2, Census Tract 78.01, Hennepin County, Minnesota",131,33,11,1,19,0,55,12,131,50,17,10,0,19,0,1,3,81,16,1,1,0,0,54,9
270530068003001,86,Whittier,51,51,1000000US270530068003001,"Block 3001, Block Group 3, Census Tract 68, Hennepin County, Minnesota",165,137,7,4,10,0,4,3,165,154,130,7,4,10,0,0,3,11,7,0,0,0,0,4,0
270530068002006,86,Whittier,51,51,1000000US270530068002006,"Block 2006, Block Group 2, Census Tract 68, Hennepin County, Minnesota",213,184,15,1,4,0,2,7,213,201,174,15,1,4,0,0,7,12,10,0,0,0,0,2,0
270530068003006,86,Whittier,51,51,1000000US270530068003006,"Block 3006, Block Group 3, Census Tract 68, Hennepin County, Minnesota",121,98,9,0,2,0,7,5,121,112,95,8,0,2,0,2,5,9,3,1,0,0,0,5,0
270531070003004,86,Whittier,51,51,1000000US270531070003004,"Block 3004, Block Group 3, Census Tract 1070, Hennepin County, Minnesota",152,127,6,1,2,0,5,11,152,145,124,6,1,2,0,2,10,7,3,0,0,0,0,3,1
270530077001006,86,Whittier,51,51,1000000US270530077001006,"Block 1006, Block Group 1, Census Tract 77, Hennepin County, Minnesota",63,60,0,0,1,0,0,2,63,63,60,0,0,1,0,0,2,0,0,0,0,0,0,0,0
270531070003007,86,Whittier,51,51,1000000US270531070003007,"Block 3007, Block Group 3, Census Tract 1070, Hennepin County, Minnesota",189,107,6,0,3,0,69,4,189,96,83,6,0,3,0,0,4,93,24,0,0,0,0,69,0
270530068001002,86,Whittier,51,51,1000000US270530068001002,"Block 1002, Block Group 1, Census Tract 68, Hennepin County, Minnesota",207,168,21,3,3,0,2,10,207,197,163,21,2,2,0,0,9,10,5,0,1,1,0,2,1
270530068001005,86,Whittier,51,51,1000000US270530068001005,"Block 1005, Block Group 1, Census Tract 68, Hennepin County, Minnesota",215,117,47,14,3,0,19,15,215,158,91,44,9,3,0,1,10,57,26,3,5,0,0,18,5
270531070002001,86,Whittier,51,51,1000000US270531070002001,"Block 2001, Block Group 2, Census Tract 1070, Hennepin County, Minnesota",497,124,88,34,4,0,211,36,497,180,77,86,5,4,0,0,8,317,47,2,29,0,0,211,28
270531069001005,86,Whittier,51,51,1000000US270531069001005,"Block 1005, Block Group 1, Census Tract 1069, Hennepin County, Minnesota",78,71,2,0,3,0,0,2,78,68,63,2,0,3,0,0,0,10,8,0,0,0,0,0,2
270531069001008,86,Whittier,51,51,1000000US270531069001008,"Block 1008, Block Group 1, Census Tract 1069, Hennepin County, Minnesota",8,7,0,0,1,0,0,0,8,8,7,0,0,1,0,0,0,0,0,0,0,0,0,0,0
270531069001009,86,Whittier,51,51,1000000US270531069001009,"Block 1009, Block Group 1, Census Tract 1069, Hennepin County, Minnesota",7,4,2,1,0,0,0,0,7,7,4,2,1,0,0,0,0,0,0,0,0,0,0,0,0
270531070002000,86,Whittier,51,51,1000000US270531070002000,"Block 2000, Block Group 2, Census Tract 1070, Hennepin County, Minnesota",200,44,29,7,29,0,85,6,200,84,25,24,1,29,0,1,4,116,19,5,6,0,0,84,2
270530068002004,86,Whittier,51,51,1000000US270530068002004,"Block 2004, Block Group 2, Census Tract 68, Hennepin County, Minnesota",34,34,0,0,0,0,0,0,34,29,29,0,0,0,0,0,0,5,5,0,0,0,0,0,0
270531070002003,86,Whittier,51,51,1000000US270531070002003,"Block 2003, Block Group 2, Census Tract 1070, Hennepin County, Minnesota",253,96,66,18,2,0,57,14,253,147,68,60,9,2,0,0,8,106,28,6,9,0,0,57,6
270531070001005,86,Whittier,51,51,1000000US270531070001005,"Block 1005, Block Group 1, Census Tract 1070, Hennepin County, Minnesota",404,140,193,13,7,0,41,10,404,307,90,191,10,7,0,1,8,97,50,2,3,0,0,40,2
270530077001002,86,Whittier,51,51,1000000US270530077001002,"Block 1002, Block Group 1, Census Tract 77, Hennepin County, Minnesota",285,48,82,15,10,0,112,18,285,116,8,82,14,10,0,0,2,169,40,0,1,0,0,112,16
270531069001004,86,Whittier,51,51,1000000US270531069001004,"Block 1004, Block Group 1, Census Tract 1069, Hennepin County, Minnesota",148,123,17,3,0,0,0,5,148,145,120,17,3,0,0,0,5,3,3,0,0,0,0,0,0
270530078011004,86,Whittier,51,51,1000000US270530078011004,"Block 1004, Block Group 1, Census Tract 78.01, Hennepin County, Minnesota",102,43,37,1,2,0,18,1,102,57,18,33,1,2,0,2,1,45,25,4,0,0,0,16,0
270530068003005,86,Whittier,51,51,1000000US270530068003005,"Block 3005, Block Group 3, Census Tract 68, Hennepin County, Minnesota",254,231,8,1,9,0,0,5,254,247,225,8,1,9,0,0,4,7,6,0,0,0,0,0,1
270530068002005,86,Whittier,51,51,1000000US270530068002005,"Block 2005, Block Group 2, Census Tract 68, Hennepin County, Minnesota",140,127,7,0,2,0,0,4,140,137,124,7,0,2,0,0,4,3,3,0,0,0,0,0,0
270531070003005,86,Whittier,51,51,1000000US270531070003005,"Block 3005, Block Group 3, Census Tract 1070, Hennepin County, Minnesota",115,93,14,2,6,0,0,0,115,112,91,13,2,6,0,0,0,3,2,1,0,0,0,0,0
270531070003006,86,Whittier,51,51,1000000US270531070003006,"Block 3006, Block Group 3, Census Tract 1070, Hennepin County, Minnesota",192,148,19,0,11,0,10,4,192,168,134,18,0,11,0,1,4,24,14,1,0,0,0,9,0
270530077001008,86,Whittier,51,51,1000000US270530077001008,"Block 1008, Block Group 1, Census Tract 77, Hennepin County, Minnesota",13,11,0,0,0,0,0,2,13,13,11,0,0,0,0,0,2,0,0,0,0,0,0,0,0
270530068001003,86,Whittier,51,51,1000000US270530068001003,"Block 1003, Block Group 1, Census Tract 68, Hennepin County, Minnesota",201,158,18,1,7,0,8,9,201,187,152,18,1,7,0,0,9,14,6,0,0,0,0,8,0
270530068002001,86,Whittier,51,51,1000000US270530068002001,"Block 2001, Block Group 2, Census Tract 68, Hennepin County, Minnesota",239,138,79,2,10,0,2,8,239,230,131,79,2,10,0,0,8,9,7,0,0,0,0,2,0
270531070001003,86,Whittier,51,51,1000000US270531070001003,"Block 1003, Block Group 1, Census Tract 1070, Hennepin County, Minnesota",243,105,111,0,13,0,3,11,243,233,103,111,0,13,0,1,5,10,2,0,0,0,0,2,6
270531069002006,86,Whittier,51,51,1000000US270531069002006,"Block 2006, Block Group 2, Census Tract 1069, Hennepin County, Minnesota",167,95,31,5,19,0,3,14,167,157,93,31,4,19,0,0,10,10,2,0,1,0,0,3,4
270531069001002,86,Whittier,51,51,1000000US270531069001002,"Block 1002, Block Group 1, Census Tract 1069, Hennepin County, Minnesota",245,170,27,15,3,0,14,16,245,224,169,26,14,3,0,3,9,21,1,1,1,0,0,11,7
270530078011005,86,Whittier,51,51,1000000US270530078011005,"Block 1005, Block Group 1, Census Tract 78.01, Hennepin County, Minnesota",81,22,53,0,3,0,3,0,81,68,12,53,0,3,0,0,0,13,10,0,0,0,0,3,0
270530077001001,86,Whittier,51,51,1000000US270530077001001,"Block 1001, Block Group 1, Census Tract 77, Hennepin County, Minnesota",0,0,0,0,0,0,0,0,0,0,0,0,0,0,0,0,0,0,0,0,0,0,0,0,0
270530078012003,86,Whittier,51,51,1000000US270530078012003,"Block 2003, Block Group 2, Census Tract 78.01, Hennepin County, Minnesota",38,13,20,0,3,0,1,1,38,38,13,20,0,3,0,1,1,0,0,0,0,0,0,0,0
270531069001011,86,Whittier,51,51,1000000US270531069001011,"Block 1011, Block Group 1, Census Tract 1069, Hennepin County, Minnesota",85,30,44,3,0,0,1,7,85,82,28,44,3,0,0,0,7,3,2,0,0,0,0,1,0
270530068003000,86,Whittier,51,51,1000000US270530068003000,"Block 3000, Block Group 3, Census Tract 68, Hennepin County, Minnesota",200,145,22,2,17,0,2,12,200,190,138,22,2,17,0,0,11,10,7,0,0,0,0,2,1
270531069002008,86,Whittier,51,51,1000000US270531069002008,"Block 2008, Block Group 2, Census Tract 1069, Hennepin County, Minnesota",109,89,12,4,2,0,0,2,109,108,88,12,4,2,0,0,2,1,1,0,0,0,0,0,0
270530078012004,86,Whittier,51,51,1000000US270530078012004,"Block 2004, Block Group 2, Census Tract 78.01, Hennepin County, Minnesota",74,28,22,2,17,0,1,4,74,60,15,22,1,17,0,1,4,14,13,0,1,0,0,0,0
270530078012000,86,Whittier,51,51,1000000US270530078012000,"Block 2000, Block Group 2, Census Tract 78.01, Hennepin County, Minnesota",553,216,121,11,13,0,154,38,553,288,135,117,5,13,0,3,15,265,81,4,6,0,0,151,23
270530077001017,86,Whittier,51,51,1000000US270530077001017,"Block 1017, Block Group 1, Census Tract 77, Hennepin County, Minnesota",0,0,0,0,0,0,0,0,0,0,0,0,0,0,0,0,0,0,0,0,0,0,0,0,0
270531069001001,86,Whittier,51,51,1000000US270531069001001,"Block 1001, Block Group 1, Census Tract 1069, Hennepin County, Minnesota",113,36,26,26,4,0,11,10,113,87,27,25,25,4,0,0,6,26,9,1,1,0,0,11,4
270531069001000,86,Whittier,51,51,1000000US270531069001000,"Block 1000, Block Group 1, Census Tract 1069, Hennepin County, Minnesota",0,0,0,0,0,0,0,0,0,0,0,0,0,0,0,0,0,0,0,0,0,0,0,0,0
270531069002003,86,Whittier,51,51,1000000US270531069002003,"Block 2003, Block Group 2, Census Tract 1069, Hennepin County, Minnesota",258,231,8,1,9,0,0,9,258,247,220,8,1,9,0,0,9,11,11,0,0,0,0,0,0
270531069002002,86,Whittier,51,51,1000000US270531069002002,"Block 2002, Block Group 2, Census Tract 1069, Hennepin County, Minnesota",84,71,10,1,0,0,0,2,84,69,56,10,1,0,0,0,2,15,15,0,0,0,0,0,0
270530077001015,86,Whittier,51,51,1000000US270530077001015,"Block 1015, Block Group 1, Census Tract 77, Hennepin County, Minnesota",0,0,0,0,0,0,0,0,0,0,0,0,0,0,0,0,0,0,0,0,0,0,0,0,0
270530077001013,86,Whittier,51,51,1000000US270530077001013,"Block 1013, Block Group 1, Census Tract 77, Hennepin County, Minnesota",10,1,0,8,0,0,0,1,10,10,1,0,8,0,0,0,1,0,0,0,0,0,0,0,0
270530077001012,86,Whittier,51,51,1000000US270530077001012,"Block 1012, Block Group 1, Census Tract 77, Hennepin County, Minnesota",2,0,2,0,0,0,0,0,2,2,0,2,0,0,0,0,0,0,0,0,0,0,0,0,0
270530077001014,86,Whittier,51,51,1000000US270530077001014,"Block 1014, Block Group 1, Census Tract 77, Hennepin County, Minnesota",21,7,0,0,0,0,11,3,21,9,7,0,0,0,0,0,2,12,0,0,0,0,0,11,1
270530078012006,86,Whittier,51,51,1000000US270530078012006,"Block 2006, Block Group 2, Census Tract 78.01, Hennepin County, Minnesota",0,0,0,0,0,0,0,0,0,0,0,0,0,0,0,0,0,0,0,0,0,0,0,0,0
270531070003000,86,Whittier,51,51,1000000US270531070003000,"Block 3000, Block Group 3, Census Tract 1070, Hennepin County, Minnesota",71,65,4,0,0,0,2,0,71,63,59,4,0,0,0,0,0,8,6,0,0,0,0,2,0
270530078011001,86,Whittier,51,51,1000000US270530078011001,"Block 1001, Block Group 1, Census Tract 78.01, Hennepin County, Minnesota",95,74,3,3,3,0,9,3,95,70,61,3,1,3,0,0,2,25,13,0,2,0,0,9,1
270530077001016,86,Whittier,51,51,1000000US270530077001016,"Block 1016, Block Group 1, Census Tract 77, Hennepin County, Minnesota",0,0,0,0,0,0,0,0,0,0,0,0,0,0,0,0,0,0,0,0,0,0,0,0,0
270530068003003,86,Whittier,51,51,1000000US270530068003003,"Block 3003, Block Group 3, Census Tract 68, Hennepin County, Minnesota",153,135,6,1,5,0,4,2,153,145,129,6,1,5,0,2,2,8,6,0,0,0,0,2,0
270531070002004,86,Whittier,51,51,1000000US270531070002004,"Block 2004, Block Group 2, Census Tract 1070, Hennepin County, Minnesota",130,83,35,4,0,0,3,5,130,123,83,33,4,0,0,0,3,7,0,2,0,0,0,3,2
270530077001010,86,Whittier,51,51,1000000US270530077001010,"Block 1010, Block Group 1, Census Tract 77, Hennepin County, Minnesota",60,38,2,0,1,0,19,0,60,37,34,2,0,1,0,0,0,23,4,0,0,0,0,19,0
270530068001004,86,Whittier,51,51,1000000US270530068001004,"Block 1004, Block Group 1, Census Tract 68, Hennepin County, Minnesota",212,105,60,4,5,0,31,7,212,167,93,60,4,5,0,0,5,45,12,0,0,0,0,31,2
270531070002002,86,Whittier,51,51,1000000US270531070002002,"Block 2002, Block Group 2, Census Tract 1070, Hennepin County, Minnesota",347,170,18,10,7,0,97,45,347,140,100,18,4,7,0,0,11,207,70,0,6,0,0,97,34
270530068002000,86,Whittier,51,51,1000000US270530068002000,"Block 2000, Block Group 2, Census Tract 68, Hennepin County, Minnesota",110,97,5,0,2,0,0,6,110,106,93,5,0,2,0,0,6,4,4,0,0,0,0,0,0
270531070001000,86,Whittier,51,51,1000000US270531070001000,"Block 1000, Block Group 1, Census Tract 1070, Hennepin County, Minnesota",151,90,26,0,2,0,20,13,151,88,55,26,0,2,0,0,5,63,35,0,0,0,0,20,8
270531070001001,86,Whittier,51,51,1000000US270531070001001,"Block 1001, Block Group 1, Census Tract 1070, Hennepin County, Minnesota",190,52,54,6,18,0,39,21,190,115,23,54,6,18,0,0,14,75,29,0,0,0,0,39,7
270531069001007,86,Whittier,51,51,1000000US270531069001007,"Block 1007, Block Group 1, Census Tract 1069, Hennepin County, Minnesota",61,26,26,1,8,0,0,0,61,59,26,24,1,8,0,0,0,2,0,2,0,0,0,0,0
270531069001003,86,Whittier,51,51,1000000US270531069001003,"Block 1003, Block Group 1, Census Tract 1069, Hennepin County, Minnesota",95,49,10,5,3,0,19,9,95,61,44,10,0,3,0,0,4,34,5,0,5,0,0,19,5
270531069002005,86,Whittier,51,51,1000000US270531069002005,"Block 2005, Block Group 2, Census Tract 1069, Hennepin County, Minnesota",198,171,11,3,3,0,3,7,198,191,167,11,3,3,0,0,7,7,4,0,0,0,0,3,0
270531069002000,86,Whittier,51,51,1000000US270531069002000,"Block 2000, Block Group 2, Census Tract 1069, Hennepin County, Minnesota",132,48,58,1,11,0,6,8,132,120,47,56,1,11,0,0,5,12,1,2,0,0,0,6,3
270530068003002,86,Whittier,51,51,1000000US270530068003002,"Block 3002, Block Group 3, Census Tract 68, Hennepin County, Minnesota",223,178,14,1,10,0,6,14,223,206,168,14,1,10,0,3,10,17,10,0,0,0,0,3,4
270530068003007,86,Whittier,51,51,1000000US270530068003007,"Block 3007, Block Group 3, Census Tract 68, Hennepin County, Minnesota",232,169,25,1,14,0,13,10,232,209,161,25,1,12,0,0,10,23,8,0,0,2,0,13,0
270530068001000,86,Whittier,51,51,1000000US270530068001000,"Block 1000, Block Group 1, Census Tract 68, Hennepin County, Minnesota",317,162,70,2,47,0,22,14,317,291,160,70,2,47,0,0,12,26,2,0,0,0,0,22,2
270531070001004,86,Whittier,51,51,1000000US270531070001004,"Block 1004, Block Group 1, Census Tract 1070, Hennepin County, Minnesota",118,86,18,4,6,0,0,4,118,112,83,17,3,6,0,0,3,6,3,1,1,0,0,0,1
270531069001006,86,Whittier,51,51,1000000US270531069001006,"Block 1006, Block Group 1, Census Tract 1069, Hennepin County, Minnesota",147,112,20,2,3,0,5,5,147,136,107,19,2,3,0,1,4,11,5,1,0,0,0,4,1
270531069002009,86,Whittier,51,51,1000000US270531069002009,"Block 2009, Block Group 2, Census Tract 1069, Hennepin County, Minnesota",378,323,13,3,19,0,9,11,378,356,315,13,1,18,0,0,9,22,8,0,2,1,0,9,2
270531069001010,86,Whittier,51,51,1000000US270531069001010,"Block 1010, Block Group 1, Census Tract 1069, Hennepin County, Minnesota",96,35,52,0,9,0,0,0,96,96,35,52,0,9,0,0,0,0,0,0,0,0,0,0,0
270530078011003,86,Whittier,51,51,1000000US270530078011003,"Block 1003, Block Group 1, Census Tract 78.01, Hennepin County, Minnesota",242,50,116,2,63,0,0,11,242,233,48,113,2,63,0,0,7,9,2,3,0,0,0,0,4
270530078012005,86,Whittier,51,51,1000000US270530078012005,"Block 2005, Block Group 2, Census Tract 78.01, Hennepin County, Minnesota",0,0,0,0,0,0,0,0,0,0,0,0,0,0,0,0,0,0,0,0,0,0,0,0,0
270530078011002,86,Whittier,51,51,1000000US270530078011002,"Block 1002, Block Group 1, Census Tract 78.01, Hennepin County, Minnesota",190,94,77,7,0,0,9,3,190,158,79,72,4,0,0,1,2,32,15,5,3,0,0,8,1
270530078011000,86,Whittier,51,51,1000000US270530078011000,"Block 1000, Block Group 1, Census Tract 78.01, Hennepin County, Minnesota",0,0,0,0,0,0,0,0,0,0,0,0,0,0,0,0,0,0,0,0,0,0,0,0,0
270530077001009,86,Whittier,51,51,1000000US270530077001009,"Block 1009, Block Group 1, Census Tract 77, Hennepin County, Minnesota",73,34,16,2,0,0,19,2,73,38,21,16,0,0,0,0,1,35,13,0,2,0,0,19,1
270530082002002,87,Lyndale,53,53,1000000US270530082002002,"Block 2002, Block Group 2, Census Tract 82, Hennepin County, Minnesota",125,88,2,3,2,0,16,14,125,86,78,1,3,2,0,0,2,39,10,1,0,0,0,16,12
270530082004003,87,Lyndale,53,53,1000000US270530082004003,"Block 4003, Block Group 4, Census Tract 82, Hennepin County, Minnesota",43,37,5,0,0,1,0,0,43,43,37,5,0,0,1,0,0,0,0,0,0,0,0,0,0
270530082004004,87,Lyndale,53,53,1000000US270530082004004,"Block 4004, Block Group 4, Census Tract 82, Hennepin County, Minnesota",163,132,21,1,2,0,5,2,163,156,130,21,1,2,0,0,2,7,2,0,0,0,0,5,0
270530082004001,87,Lyndale,53,53,1000000US270530082004001,"Block 4001, Block Group 4, Census Tract 82, Hennepin County, Minnesota",123,65,14,2,0,0,28,14,123,92,63,14,1,0,0,0,14,31,2,0,1,0,0,28,0
270531093003002,87,Lyndale,53,53,1000000US270531093003002,"Block 3002, Block Group 3, Census Tract 1093, Hennepin County, Minnesota",85,68,6,2,5,0,0,4,85,83,68,6,1,5,0,0,3,2,0,0,1,0,0,0,1
270530082001003,87,Lyndale,53,53,1000000US270530082001003,"Block 1003, Block Group 1, Census Tract 82, Hennepin County, Minnesota",331,135,24,2,6,0,141,23,331,107,61,24,2,6,0,7,7,224,74,0,0,0,0,134,16
270530082003005,87,Lyndale,53,53,1000000US270530082003005,"Block 3005, Block Group 3, Census Tract 82, Hennepin County, Minnesota",88,74,0,2,6,0,3,3,88,81,71,0,2,6,0,0,2,7,3,0,0,0,0,3,1
270530083002000,87,Lyndale,53,53,1000000US270530083002000,"Block 2000, Block Group 2, Census Tract 83, Hennepin County, Minnesota",0,0,0,0,0,0,0,0,0,0,0,0,0,0,0,0,0,0,0,0,0,0,0,0,0
270530083002010,87,Lyndale,53,53,1000000US270530083002010,"Block 2010, Block Group 2, Census Tract 83, Hennepin County, Minnesota",171,70,35,0,3,1,37,25,171,100,46,35,0,3,1,2,13,71,24,0,0,0,0,35,12
270530083002006,87,Lyndale,53,53,1000000US270530083002006,"Block 2006, Block Group 2, Census Tract 83, Hennepin County, Minnesota",0,0,0,0,0,0,0,0,0,0,0,0,0,0,0,0,0,0,0,0,0,0,0,0,0
270531093005006,87,Lyndale,53,53,1000000US270531093005006,"Block 5006, Block Group 5, Census Tract 1093, Hennepin County, Minnesota",131,35,38,1,5,0,45,7,131,86,35,38,1,5,0,2,5,45,0,0,0,0,0,43,2
270530082003003,87,Lyndale,53,53,1000000US270530082003003,"Block 3003, Block Group 3, Census Tract 82, Hennepin County, Minnesota",0,0,0,0,0,0,0,0,0,0,0,0,0,0,0,0,0,0,0,0,0,0,0,0,0
270530082003004,87,Lyndale,53,53,1000000US270530082003004,"Block 3004, Block Group 3, Census Tract 82, Hennepin County, Minnesota",79,65,3,1,2,0,4,4,79,74,65,3,0,2,0,0,4,5,0,0,1,0,0,4,0
270531093003001,87,Lyndale,53,53,1000000US270531093003001,"Block 3001, Block Group 3, Census Tract 1093, Hennepin County, Minnesota",140,122,4,1,3,0,2,8,140,131,115,4,1,3,0,1,7,9,7,0,0,0,0,1,1
270531093003003,87,Lyndale,53,53,1000000US270531093003003,"Block 3003, Block Group 3, Census Tract 1093, Hennepin County, Minnesota",107,93,3,2,5,0,0,4,107,105,91,3,2,5,0,0,4,2,2,0,0,0,0,0,0
270531093003005,87,Lyndale,53,53,1000000US270531093003005,"Block 3005, Block Group 3, Census Tract 1093, Hennepin County, Minnesota",151,117,10,0,3,0,7,14,151,143,115,10,0,3,0,1,14,8,2,0,0,0,0,6,0
270531093003000,87,Lyndale,53,53,1000000US270531093003000,"Block 3000, Block Group 3, Census Tract 1093, Hennepin County, Minnesota",138,101,14,0,6,0,13,4,138,112,88,14,0,6,0,0,4,26,13,0,0,0,0,13,0
270530082003001,87,Lyndale,53,53,1000000US270530082003001,"Block 3001, Block Group 3, Census Tract 82, Hennepin County, Minnesota",88,77,9,0,1,0,0,1,88,81,70,9,0,1,0,0,1,7,7,0,0,0,0,0,0
270530082004002,87,Lyndale,53,53,1000000US270530082004002,"Block 4002, Block Group 4, Census Tract 82, Hennepin County, Minnesota",113,83,11,7,0,0,12,0,113,92,78,11,3,0,0,0,0,21,5,0,4,0,0,12,0
270530082004005,87,Lyndale,53,53,1000000US270530082004005,"Block 4005, Block Group 4, Census Tract 82, Hennepin County, Minnesota",90,63,10,1,7,0,0,9,90,85,62,10,1,7,0,0,5,5,1,0,0,0,0,0,4
270530082004006,87,Lyndale,53,53,1000000US270530082004006,"Block 4006, Block Group 4, Census Tract 82, Hennepin County, Minnesota",227,102,28,28,3,0,54,12,227,154,91,27,19,2,0,5,10,73,11,1,9,1,0,49,2
270530082002000,87,Lyndale,53,53,1000000US270530082002000,"Block 2000, Block Group 2, Census Tract 82, Hennepin County, Minnesota",236,92,73,14,8,0,27,22,236,166,61,72,14,1,0,0,18,70,31,1,0,7,0,27,4
270530083002003,87,Lyndale,53,53,1000000US270530083002003,"Block 2003, Block Group 2, Census Tract 83, Hennepin County, Minnesota",39,17,13,0,0,0,5,4,39,29,12,13,0,0,0,0,4,10,5,0,0,0,0,5,0
270530082001002,87,Lyndale,53,53,1000000US270530082001002,"Block 1002, Block Group 1, Census Tract 82, Hennepin County, Minnesota",304,73,32,7,0,0,182,10,304,55,19,32,2,0,0,0,2,249,54,0,5,0,0,182,8
270531093004000,87,Lyndale,53,53,1000000US270531093004000,"Block 4000, Block Group 4, Census Tract 1093, Hennepin County, Minnesota",105,73,20,0,1,0,7,4,105,96,70,20,0,1,0,1,4,9,3,0,0,0,0,6,0
270530082002006,87,Lyndale,53,53,1000000US270530082002006,"Block 2006, Block Group 2, Census Tract 82, Hennepin County, Minnesota",246,85,1,9,4,0,139,8,246,77,57,1,0,4,0,14,1,169,28,0,9,0,0,125,7
270530082001004,87,Lyndale,53,53,1000000US270530082001004,"Block 1004, Block Group 1, Census Tract 82, Hennepin County, Minnesota",586,102,430,12,19,0,2,21,586,570,100,428,10,14,0,1,17,16,2,2,2,5,0,1,4
270531093004002,87,Lyndale,53,53,1000000US270531093004002,"Block 4002, Block Group 4, Census Tract 1093, Hennepin County, Minnesota",97,89,2,0,1,0,4,1,97,88,85,2,0,1,0,0,0,9,4,0,0,0,0,4,1
270530082001001,87,Lyndale,53,53,1000000US270530082001001,"Block 1001, Block Group 1, Census Tract 82, Hennepin County, Minnesota",271,32,222,1,2,0,3,11,271,266,31,222,1,2,0,1,9,5,1,0,0,0,0,2,2
270530082001000,87,Lyndale,53,53,1000000US270530082001000,"Block 1000, Block Group 1, Census Tract 82, Hennepin County, Minnesota",99,46,36,1,7,0,6,3,99,93,46,36,0,7,0,1,3,6,0,0,1,0,0,5,0
270530082003006,87,Lyndale,53,53,1000000US270530082003006,"Block 3006, Block Group 3, Census Tract 82, Hennepin County, Minnesota",91,79,1,1,8,0,0,2,91,90,78,1,1,8,0,0,2,1,1,0,0,0,0,0,0
270530083002002,87,Lyndale,53,53,1000000US270530083002002,"Block 2002, Block Group 2, Census Tract 83, Hennepin County, Minnesota",0,0,0,0,0,0,0,0,0,0,0,0,0,0,0,0,0,0,0,0,0,0,0,0,0
270530083002004,87,Lyndale,53,53,1000000US270530083002004,"Block 2004, Block Group 2, Census Tract 83, Hennepin County, Minnesota",155,40,103,3,0,0,3,6,155,138,29,101,3,0,0,3,2,17,11,2,0,0,0,0,4
270531093005002,87,Lyndale,53,53,1000000US270531093005002,"Block 5002, Block Group 5, Census Tract 1093, Hennepin County, Minnesota",153,47,45,4,6,0,44,7,153,96,42,41,1,6,0,0,6,57,5,4,3,0,0,44,1
270530082002005,87,Lyndale,53,53,1000000US270530082002005,"Block 2005, Block Group 2, Census Tract 82, Hennepin County, Minnesota",197,131,26,1,2,0,33,4,197,164,130,25,1,2,0,3,3,33,1,1,0,0,0,30,1
270530082002001,87,Lyndale,53,53,1000000US270530082002001,"Block 2001, Block Group 2, Census Tract 82, Hennepin County, Minnesota",192,101,47,3,5,0,22,14,192,158,91,46,3,5,0,0,13,34,10,1,0,0,0,22,1
270531093005003,87,Lyndale,53,53,1000000US270531093005003,"Block 5003, Block Group 5, Census Tract 1093, Hennepin County, Minnesota",161,87,13,0,8,0,46,7,161,89,58,12,0,8,0,4,7,72,29,1,0,0,0,42,0
270531093004003,87,Lyndale,53,53,1000000US270531093004003,"Block 4003, Block Group 4, Census Tract 1093, Hennepin County, Minnesota",118,111,5,0,2,0,0,0,118,117,110,5,0,2,0,0,0,1,1,0,0,0,0,0,0
270531093005005,87,Lyndale,53,53,1000000US270531093005005,"Block 5005, Block Group 5, Census Tract 1093, Hennepin County, Minnesota",88,45,28,0,1,0,12,2,88,66,34,28,0,1,0,1,2,22,11,0,0,0,0,11,0
270530083002007,87,Lyndale,53,53,1000000US270530083002007,"Block 2007, Block Group 2, Census Tract 83, Hennepin County, Minnesota",136,79,17,0,3,0,34,3,136,76,59,13,0,3,0,1,0,60,20,4,0,0,0,33,3
270530082003002,87,Lyndale,53,53,1000000US270530082003002,"Block 3002, Block Group 3, Census Tract 82, Hennepin County, Minnesota",198,138,15,10,7,0,11,17,198,174,129,15,9,7,0,1,13,24,9,0,1,0,0,10,4
270530082002003,87,Lyndale,53,53,1000000US270530082002003,"Block 2003, Block Group 2, Census Tract 82, Hennepin County, Minnesota",100,63,10,1,5,4,10,7,100,88,63,10,0,5,4,1,5,12,0,0,1,0,0,9,2
270530082001005,87,Lyndale,53,53,1000000US270530082001005,"Block 1005, Block Group 1, Census Tract 82, Hennepin County, Minnesota",0,0,0,0,0,0,0,0,0,0,0,0,0,0,0,0,0,0,0,0,0,0,0,0,0
270531093004004,87,Lyndale,53,53,1000000US270531093004004,"Block 4004, Block Group 4, Census Tract 1093, Hennepin County, Minnesota",126,95,21,0,0,0,7,3,126,111,88,20,0,0,0,0,3,15,7,1,0,0,0,7,0
270531093004005,87,Lyndale,53,53,1000000US270531093004005,"Block 4005, Block Group 4, Census Tract 1093, Hennepin County, Minnesota",104,83,19,0,0,0,0,2,104,103,82,19,0,0,0,0,2,1,1,0,0,0,0,0,0
270530083002001,87,Lyndale,53,53,1000000US270530083002001,"Block 2001, Block Group 2, Census Tract 83, Hennepin County, Minnesota",0,0,0,0,0,0,0,0,0,0,0,0,0,0,0,0,0,0,0,0,0,0,0,0,0
270530083002005,87,Lyndale,53,53,1000000US270530083002005,"Block 2005, Block Group 2, Census Tract 83, Hennepin County, Minnesota",0,0,0,0,0,0,0,0,0,0,0,0,0,0,0,0,0,0,0,0,0,0,0,0,0
270531093005004,87,Lyndale,53,53,1000000US270531093005004,"Block 5004, Block Group 5, Census Tract 1093, Hennepin County, Minnesota",124,75,26,0,8,0,7,8,124,118,75,26,0,8,0,1,8,6,0,0,0,0,0,6,0
270531093005001,87,Lyndale,53,53,1000000US270531093005001,"Block 5001, Block Group 5, Census Tract 1093, Hennepin County, Minnesota",118,78,20,2,10,0,3,5,118,102,73,15,2,10,0,0,2,16,5,5,0,0,0,3,3
270531093005000,87,Lyndale,53,53,1000000US270531093005000,"Block 5000, Block Group 5, Census Tract 1093, Hennepin County, Minnesota",0,0,0,0,0,0,0,0,0,0,0,0,0,0,0,0,0,0,0,0,0,0,0,0,0
270531093005007,87,Lyndale,53,53,1000000US270531093005007,"Block 5007, Block Group 5, Census Tract 1093, Hennepin County, Minnesota",0,0,0,0,0,0,0,0,0,0,0,0,0,0,0,0,0,0,0,0,0,0,0,0,0
270531093003004,87,Lyndale,53,53,1000000US270531093003004,"Block 3004, Block Group 3, Census Tract 1093, Hennepin County, Minnesota",118,106,1,0,5,0,1,5,118,109,101,1,0,5,0,0,2,9,5,0,0,0,0,1,3
270531093004001,87,Lyndale,53,53,1000000US270531093004001,"Block 4001, Block Group 4, Census Tract 1093, Hennepin County, Minnesota",103,77,11,0,14,0,0,1,103,102,76,11,0,14,0,0,1,1,1,0,0,0,0,0,0
270530083002009,87,Lyndale,53,53,1000000US270530083002009,"Block 2009, Block Group 2, Census Tract 83, Hennepin County, Minnesota",94,69,6,0,0,0,13,6,94,73,62,6,0,0,0,0,5,21,7,0,0,0,0,13,1
270530082003000,87,Lyndale,53,53,1000000US270530082003000,"Block 3000, Block Group 3, Census Tract 82, Hennepin County, Minnesota",108,72,13,2,0,0,16,5,108,87,69,11,2,0,0,0,5,21,3,2,0,0,0,16,0
270530082004000,87,Lyndale,53,53,1000000US270530082004000,"Block 4000, Block Group 4, Census Tract 82, Hennepin County, Minnesota",257,86,36,1,6,0,110,18,257,102,51,34,1,6,0,0,10,155,35,2,0,0,0,110,8
270530083002008,87,Lyndale,53,53,1000000US270530083002008,"Block 2008, Block Group 2, Census Tract 83, Hennepin County, Minnesota",123,86,19,4,2,0,4,8,123,109,77,19,4,2,0,0,7,14,9,0,0,0,0,4,1
270530082002004,87,Lyndale,53,53,1000000US270530082002004,"Block 2004, Block Group 2, Census Tract 82, Hennepin County, Minnesota",179,97,16,4,4,0,52,6,179,105,77,15,4,4,0,1,4,74,20,1,0,0,0,51,2
